福州浩威金属制品有限公司	总经理：胡英	地址：福建闽侯县兰圃工业区318号
福建省九兴投资有限责任公司	总经理：陈	地址：闽侯县甘蔗街道校园路21号后
福建优建建筑科技有限公司	总经理：蔡	地址：福建省福州市闽侯县上街镇科技东路3号福州高新区海西高新技术产业园创新园一期10#楼1
闽侯县南通方敏生服装加工场	联系人：方	地址：福建省福州市闽侯县南通镇方庄村
闽侯县闽旺农业专业合作社	联系人：林	地址：福建省福州市闽侯县白沙镇上岐村上岐70号
闽侯县富城农业专业合作社	联系人：林	地址：闽侯县廷坪乡汶合村九里11号
闽侯县洋里德群家庭农场	联系人：陈	地址：福建省福州市闽侯县洋里乡绅带村桥里自然村水槽亭
闽侯县鸿尾耕慧家庭农场	联系人：陈	地址：福建省福州市闽侯县鸿尾乡南坑村
福建溪源种德生态农业有限公司	总经理：潘	地址：闽侯县上街镇溪源宫村罗丰片
福州宏华家居制造有限公司	总经理：黄	地址：福建省福州市闽侯县竹岐乡榕西村中埕67号厂房三层
福州鸿祥运输有限公司	总经理：卢	地址：福建省福州市闽侯县南屿镇忠观街3号旗山商贸街商住楼9号楼1层07店面
闽侯县大山里工艺品商行	联系人：黄	地址：福建省福州市闽侯县上街镇上街四房（林友钦宅）
福建华粮米业有限公司	总经理：林	地址：福建省福州市闽侯县荆溪镇福州市粮食批发交易市场1座19号
闽侯县南通镇洲头跳龙门锦鲤育苗场	联系人：黄	地址：福建省福州市闽侯县南通镇洲头村里洋
福州云众数据科技有限公司	总经理：林	地址：福建省福州市闽侯县科技东路3号福州高新区海西高新技术产业园创新园一期10#楼1层158室
福建蓝城信息科技有限公司	总经理：林	地址：福建省福州市闽侯县科技东路3号福州高新区海西高新技术产业园创新园一期10#楼1层166室
闽侯县五福茶叶有限公司	总经理：洪	地址：闽侯县五福茶叶有限公司
福建久策气体销售有限公司	总经理：何	地址：福建省福州市闽侯县南屿镇117县道新联村福州高新区两园安置房一期一标段裙楼三层3-002
福州海峡龙祥建设有限责任公司	总经理：彭	地址：闽侯县祥谦镇福厦公路（324）国道西侧21公里处
福建鑫善源农业开发有限公司	总经理：林	地址：福建省福州市闽侯县尚干镇后村村后埕1号
闽侯县丰达竹木制品有限公司	总经理：方	地址：闽侯县竹岐乡竹岐村
福州市闽侯县王府建材有限公司	总经理：陈	地址：福州市闽侯县祥谦镇辅翼村福建豪峰金属制品有限公司厂房三整座
福州迁旺家家居股份有限公司	总经理：李	地址：福建省福州市闽侯县上街镇马保村闽侯县艺根玻璃有限公司4#厂房3楼
闽侯县仙门山食用菌专业合作社	联系人：王	地址：福建省闽侯县洋里乡仙门村岩头4号
闽侯县墨轩教育咨询有限公司	总经理：洪	地址：福州市闽侯县上街镇蔗洲村学生街2号楼211室
闽侯县鸿尾紫藤家庭农场	联系人：罗	地址：福建省福州市闽侯县鸿尾乡南坑村
福州臻顺建筑劳务有限公司	总经理：陈	地址：闽侯县上街镇沙堤村中洲片
福建森朗贸易有限公司	总经理：林	地址：福建省福州市闽侯县甘蔗街道入城路东方花园6#501
闽侯县旭丰工艺品有限公司	总经理：方	地址：闽侯县南通镇方庄
福州兴诺机械工业有限公司	总经理：卢	地址：福建省福州市闽侯县南屿镇高岐村福州海量管道器材有限公司6#综合整座
福州博红森实业有限公司	总经理：陈	地址：福建省福州市闽侯县上街镇建平村金上大道博仕后家园1#06店
福州印象行天下汽车租赁有限公司	总经理：林	地址：福建省福州市闽侯县祥谦镇中院村中院47号
福州市邂逅巴黎餐饮管理有限公司	总经理：李小姐	地址：福州市闽侯县上街镇庄南村博仕后缘墅
福州经炜家居饰品有限公司	总经理：沈	地址：闽侯县甘蔗街道大元村
闽侯县鸿尾乡雪英农林综合场	联系人：谢	地址：福建省福州市闽侯县鸿尾乡南元村垄门池
福州泰茂机电科技有限公司	总经理：罗	地址：闽侯县青口镇新城西路58号博雅星城凯景大酒店910单元
闽侯县白沙后义洋农业综合开发示范场	联系人：张	地址：福建省福州市闽侯县白沙镇安平路67号
福州快捷快递有限公司	总经理：杨	地址：闽侯县祥谦镇辅澜路3号1#厂房整座
福州亚鼎汽车贸易有限公司	总经理：李	地址：福州市闽侯县青口镇宏四村马路街50号茂泰花园1#楼1层07店面
福州闽都网络技术工程有限公司	总经理：余	地址：闽侯县
闽侯县华盛农业专业合作社	联系人：聂	地址：闽侯县廷坪乡池坑村上弯37号
福州鑫时尚家纺有限公司	总经理：王	地址：闽侯县荆溪镇光明村
福州众行汽车销售有限公司	总经理：张	地址：福建省福州市闽侯县尚干镇祥通路11-2号
福州银宝汽车服务有限公司	总经理：许	地址：福州市闽侯县尚干镇良安路8号江浩尚景园5号楼806
闽侯县大邱坪生态种养殖专业合作社	联系人：朱	地址：闽侯县鸿尾乡古洋村外境16号
闽侯县新春医药有限公司	总经理：王	地址：闽侯县上街镇国宾大道2号博仕后公馆商业广场A12#楼一层24、25店面
福州贝林工艺品有限公司	总经理：肖	地址：闽侯县荆溪镇荆溪村
福建经帆建筑劳务有限公司	总经理：马	地址：福建省闽侯县上街镇沙堤村后街66号
福州佶盛典当行有限公司	总经理：周	地址：福建省福州市闽侯县甘蔗街道昙石山东大道10号综合楼一层
闽侯县新晖企业管理有限公司	总经理：郑	地址：闽侯县甘蔗街道昙石山西大道98号新城丽景B区10#楼2层212店面
福州阳光钱柜音乐会所有限公司	总经理：林	地址：福建省闽侯县青口镇付竹村富竹大厦三层
闽侯县上街美刻妆容美容中心（普通合伙）	联系人：杨	地址：福建省福州市闽侯县上街镇博仕后公馆3号楼3-4号店
闽侯县总部园房地产有限公司	总经理：林	地址：闽侯县甘蔗街道八一八西路185号
福建长大建设有限公司	总经理：林	地址：闽侯县甘蔗街道昙石山西大道98号新城丽景B区12#楼503单元
闽侯县如果电子商务有限公司	总经理：卢	地址：福建省福州市闽侯县南通镇街西排东起第六直
闽侯县益康生农业专业合作社	联系人：鄢	地址：闽侯县五都村榜尾洋
福州联亿汽车配件有限公司	总经理：林	地址：闽侯县祥谦镇兰圃村住宅小区
闽侯县富利民食品有限公司	总经理：吕	地址：闽侯县竹岐乡竹岐村
闽侯县峰龙山农业专业合作社	联系人：何	地址：闽侯县白沙镇白沙村
闽侯县肆年传媒有限公司	总经理：周	地址：闽侯县上街镇岐安村（福州地区大学新校区体育场地东南附属楼）
世纪民生（福州）蔬菜有限公司	总经理：林	地址：闽侯县南通镇福州市海峡蔬菜批发市场精品场位106号
闽侯县华烨工艺品有限公司	总经理：王	地址：闽侯县荆溪镇港头村坛山29号
福州市甲午农业开发有限公司	总经理：欧	地址：福州市闽侯县竹岐乡竹岐村虎鼻头
福州泓一金属制品有限公司	总经理：王	地址：闽侯县竹岐乡竹西溪口116号2号厂房
福州智能时代电子科技有限公司	总经理：赖	地址：福建省福州市闽侯县科技东路3号福州高新区海西高新技术产业园创新园10#楼1层142室
闽侯县宏丰达金属制品有限公司	总经理：郭	地址：闽侯县祥谦镇中院村（原祥谦中院中心小学内）
福州佳胜贸易有限公司	总经理：吴	地址：福建省福州市闽侯县青口镇宏四村
福州有聊影视文化有限公司	总经理：盘	地址：福建省福州市闽侯县科技东路8号福州高新区海西高新技术产业园创业大厦B区1层159室
闽侯县鑫瑞杰贸易有限公司	总经理：李	地址：闽侯县大湖乡珍山村1号
福州新竹科技园发展有限公司	总经理：何	地址：福建省福州市闽侯县科技东路8号福州高新区海西高新技术产业园创业大厦B区2层205室
闽侯县尚干鸿哲商务信息咨询服务部	老板：吴	地址：福建省福州市闽侯县尚干镇新榕路1号新榕小区02幢19号店铺
闽侯县若水生花生物科技有限公司	总经理：张	地址：闽侯县上街镇岐安村（福州地区大学新校区体育场地东南附属楼）
福州卓尔物流有限公司	总经理：杨	地址：福州市闽侯县祥谦镇辅澜路3号福州皇杰实业有限公司研发楼五层501室
闽侯县彦铭贸易有限公司	总经理：徐	地址：闽侯县甘蔗街道洽浦村洽浦193号
福州盛科计算机网络信息技术有限公司	总经理：叶	地址：闽侯县上街镇岐安村（福州地区大学城新校区体育场地东南附属楼）
福州鑫辉达设备租赁有限公司	总经理：林	地址：福州市闽侯县上街镇浦口村
福建荣捷万仕德汽车销售服务有限公司	总经理：姜	地址：福建省福州市闽侯县青口镇新城西路62号博雅星城16#楼16店面
福州上仟贸易有限公司	总经理：陈	地址：福州市闽侯县上街镇建平路99号福建高速物流园12#130-131
闽侯县永诚包装制品有限公司	总经理：宋	地址：福建省福州市闽侯县甘蔗街道大元巷102号
福州亚博天汽车贸易有限公司	总经理：念	地址：福建省闽侯县青口镇新城路62号博雅星城2#楼1层03店面
闽侯县野狼贸易有限公司	总经理：林	地址：闽侯县上街镇美岐小区二期5座107室
福州城森园林景观工程有限公司	总经理：唐	地址：福建省福州市闽侯县南屿镇南前村土溪厝3号
福州市情定依身贸易有限公司	总经理：王	地址：闽侯县上街镇岐头村5-6号
闽侯县洋里诗尧工艺品加工场	联系人：江	地址：福建省福州市闽侯县洋里乡洋里村洋里街西路107号
上海奉贤建设发展（集团）有限公司福州分公司	总经理：钱	地址：福建省福州市闽侯县南屿镇旗山集中工业区8号楼二层
闽侯县千家山农业专业合作社	联系人：林	地址：闽侯县甘蔗镇军民路12号五层楼房
闽侯县众彩广告传媒有限公司	总经理：林	地址：闽侯县祥谦镇枕峰村上塘125号
福州三友装修有限公司	总经理：畅	地址：福建省福州市闽侯县甘蔗街道入城路南侧
青峰（福州）传媒有限公司	总经理：林	地址：闽侯县青口镇升旗村青口街53号
福州市闽侯县圆柏贸易有限公司	总经理：毛	地址：福建省福州市闽侯县上街镇国宾大道338号英泰第一城B区商住楼5#619单元
闽侯县祥顺农林开发有限公司	总经理：邓	地址：福建省福州市闽侯县竹岐乡竹岐村
福州秋实园贸易有限公司	总经理：陈	地址：福州市闽侯县上街镇庄南路1号“博仕后缘墅“E2#103
闽侯县仙和祥原生态农业有限公司	总经理：王	地址：福建省福州市闽侯县洋里乡仙门村坝头自然村3号
福州三友和贸易有限公司	总经理：陈	地址：闽侯县甘蔗街道昙石山西大道98号新城丽景B区10#楼2层214店面
福建神州美景健康管理有限公司	总经理：陈	地址：福州市闽侯县科技东路8号福州高新区海西高新技术产业园创业大厦B区1层157室
福建根艺达工艺品有限公司	总经理：陈	地址：福建省闽侯县上街镇国宾大道1号闽都大庄园沿街商住9#楼1层147店面
福州市闽侯县科阳金属制品有限公司	总经理：陈	地址：福州市闽侯县上街镇沙堤村（闽侯县鑫龙寿五金机械有限公司）2#厂房4层405
福州九易传媒有限公司	总经理：林	地址：闽侯县甘蔗街道入城路横屿233号一楼店面
福建省煜景装饰设计有限公司	总经理：聂	地址：闽侯县上街镇国宾大道276号综合商场7层
福州菜鸟工艺品有限公司	总经理：蔡	地址：闽侯县上街镇闽都大庄园165号店面
闽侯县程湾农业专业合作社	联系人：杨	地址：福建省福州市闽侯县鸿尾乡元口村程湾38号
闽侯县敬轩企业管理有限公司	总经理：张	地址：闽侯县白沙镇呈元村
闽侯县兴农农业专业合作社	联系人：陈	地址：闽侯县大湖乡六锦村岭下11号
福建省金竹油品贸易有限公司	总经理：郑	地址：闽侯县尚干镇乌门村
福州都成贸易有限公司	总经理：林	地址：闽侯县南屿镇五都村留臂109号
福建斯泰克信息技术有限公司	总经理：黄	地址：福建省闽侯县科技东路福州高新区海西高新技术产业园创业大厦B区1层131室
福州营时通汽车服务有限公司	总经理：李	地址：闽侯县甘蔗街道入城路335号一楼店面
闽侯县福东装饰工程有限公司	总经理：张	地址：闽侯县甘蔗镇环城路157号
闽侯县盛华林竹种植专业合作社	联系人：邓	地址：福建省福州市闽侯县竹岐乡罗洋村过溪小组垅尾厝
福州市昶盛汽车服务有限公司	总经理：叶	地址：闽侯县祥谦镇兰圃村炮场
福州聚众隆鑫汽车贸易有限公司	总经理：邹	地址：闽侯县青口镇镜上村境江路138号
福建飞特实业有限公司	总经理：林	地址：福建省福州市闽侯县南屿镇南井村新桥头2号二层
闽侯县谷家族餐饮管理有限公司	总经理：陈	地址：闽侯县上街镇国宾大道338号英泰第一城B区商住2#楼410单元
闽侯县荆溪百益家庭农场	联系人：刘	地址：福建省福州市闽侯县荆溪镇关中村白石洋?仔山
福建福辉达贸易有限公司	总经理：宋	地址：福建省福州市闽侯县南屿镇江口村九石（宋德祥）整座
福建台福生物技术有限公司	总经理：陈	地址：福建省福州市高新区两园安置房一期一标段裙楼三层3-001商铺（位于：闽侯县南屿镇117县道新联村）
福建百泰汽车销售服务有限公司	总经理：洪	地址：福建省福州市闽侯县尚干镇良安路26号
福建省闽侯县农资公司南通泽洋经营部	老板：张	地址：福建省福州市闽侯县闽侯县
福州星光德邦物流有限公司闽侯南屿分公司	总经理：李	地址：福建省福州市闽侯县南屿镇江口村龙好公路中段
中建商品混凝土（福建）有限公司闽侯供应站	站长：叶	地址：福建省福州市闽侯县荆溪镇桐口村
江苏奇豆游乐设备有限公司福州第一分公司	总经理：陈	地址：福建省福州市闽侯县上街镇国宾大道268号2#楼附楼商业楼
海峡富民生实业发展有限公司	总经理：吴	地址：福建省福州市闽侯县青口镇吉山新村2#102、202
福建省福清市鑫辉建筑工程有限公司闽侯分公司	总经理：董	地址：福建省福州市闽侯县南屿镇五都村留臂59号
医工（福建）科技发展有限公司	总经理：林	地址：福建省福州市闽侯县上街镇科技东路福州高新区海西高新技术产业园创业大厦B区1层107室
福建源发电力勘察设计有限公司闽侯分公司	总经理：邱	地址：福建省福州市闽侯县南屿镇高岐工业区（高岐村安厦53号）4#综合楼
闽侯县闽云沥青混凝土有限公司	总经理：赵	地址：闽侯县竹岐乡苏洋村蓬草洲（南侧）
福州善博印刷有限公司	总经理：王	地址：闽侯县甘蔗街道闽侯经济技术开发区二期南区8号B#厂房三层
福建省天迹影视传媒有限公司	总经理：刘	地址：闽侯县白沙镇孔源村168号
闽侯县鑫固机械设备有限公司	总经理：连	地址：福建省福州市闽侯县荆溪镇铁岭工业区一期6号公路狮子山下老人福利会9号厂房
闽侯非凡财富贰投资合伙企业（有限合伙）	联系人：吴	地址：福建省福州市闽侯县高新区海西高新技术产业园创业大厦B区1层108室
闽侯白沙佳蓝果蔬农场	联系人：郑	地址：福建省福州市闽侯县白沙镇汤院村汤院126号
闽侯县孔元生态休闲农业专业合作社	联系人：危	地址：福建省福州市闽侯县白沙镇孔元村村部103号
闽侯县闽庆沥青混凝土有限公司	总经理：赵	地址：福建省福州市闽侯县
闽侯县翔华工艺品有限公司	总经理：王	地址：闽侯县竹岐乡白龙村（闽侯县鑫盛工艺品有限公司）8#厂房
福州市闽侯神华铝业有限公司	总经理：林	地址：闽侯县祥谦镇门口村
福州永兴隆汽车销售服务有限公司	总经理：鄢	地址：闽侯县尚干镇（福州市青口投资区内）汽车超市一层A-113号商铺
闽侯县成阳福禄源木雕有限公司	总经理：陈	地址：闽侯县上街镇中美村（距闽江学院大门口100米处地块综合楼）
闽侯县文峰生态农业发展有限公司	总经理：林	地址：闽侯县青口镇团结村青圃工业区?浦?
东朋（福建）能源科技有限公司	总经理：谢	地址：闽侯县青口镇农光村新城路博雅星城4#店面07
福州华荆光伏材料贸易有限公司	总经理：夏	地址：闽侯县荆溪镇影剧院
闽侯县舞林农业专业合作社	联系人：徐	地址：闽侯县荆溪镇埔前村洪坑里山
福州市鑫瑞鑫汽车贸易有限公司	总经理：邹	地址：闽侯县荆溪镇光明村42号
湖南万和建筑工程有限公司福州分公司	总经理：陈	地址：闽侯县荆溪镇古山洲村洲头268号5#楼
闽侯县鸿尾建筑工程有限公司	总经理：吴	地址：闽侯县鸿尾乡石佛头街115号
福闽高科（福建）环保新能源有限公司	总经理：林	地址：闽侯县鸿尾乡奎石村牛头山58号
闽侯营辉贸易有限公司	总经理：陈	地址：闽侯县鸿尾乡埕头村
福州恒信财富投资有限公司	总经理：周	地址：闽侯县甘蔗街道员工公寓6#D-05-06店面
福建省睿城规划设计院有限公司	总经理：吴	地址：福州市闽侯县青口镇农光村新城路博雅星城13#106号
闽侯县英诚教育咨询有限公司	总经理：黄	地址：福建省福州市闽侯县上街镇红峰村华佗路北侧（黄炳剑住宅）第二层
闽侯县恒明建材加工厂	厂长：洪	地址：福建省福州市闽侯县甘蔗镇青岐村叶洋10号
闽侯县启航工艺品厂	厂长：程	地址：福建省福州市闽侯县白沙镇孔元92号
闽侯县白沙陈明理工艺品加工场	联系人：陈	地址：福建省福州市闽侯县白沙镇洋石村新浦101号
闽侯县守安保安服务有限公司	总经理：刘	地址：福建省福州市闽侯县甘蔗街道长江村
福州天昱电子科技有限公司	总经理：吴	地址：福建省福州市闽侯县甘蔗街道大元村
闽侯县锦绣家园商务酒店	老板：鲁	地址：福建省福州市闽侯县荆溪镇洪甘路文山里217号（空军94635部队中龙大厦2#楼5-7层98间）
福州市福灿环保科技有限公司	总经理：陈	地址：福建省福州市闽侯县青口镇联丰村相思岭脚下
福建省康辉国际旅行社股份有限公司甘蔗营业部	老板：林	地址：闽侯县甘蔗街道榕洲路3号滨江苑8#楼1层05店面
福建汇洋建设发展有限公司闽侯分公司	总经理：林	地址：闽侯县荆溪镇关口村
闽侯县绿之源林业专业合作社	联系人：陈	地址：闽侯县荆溪镇关中村里洋
福州长旭贸易有限公司	总经理：林	地址：闽侯县南屿镇江口村青洲
福州科翔建筑材料有限公司	总经理：陈	地址：闽侯县南屿镇忠观街3号旗山商贸街商住楼8#楼1层09店面
福州顺意金属工业有限公司	总经理：纪	地址：闽侯县青口镇青口投资区（福州易建工业有限公司内）
福州永梁众森劳务派遣有限公司	总经理：李	地址：闽侯县青口镇溪东村寨田16号
闽侯县志强汽车维修有限公司	总经理：万	地址：闽侯县青口镇义溪路11号三号厂房
深圳市万科物业服务有限公司福州分公司	总经理：林	地址：闽侯县上街镇人民政府125号二楼
福州开视商贸有限公司	总经理：康	地址：闽侯县上街镇上街村（赵华金）自用房整座三楼
福州尚平食品有限公司	总经理：陈	地址：闽侯县上街镇新商业街第五幢204
福建中交乾达重工有限公司	总经理：高	地址：闽侯县铁岭工业集中区二期（福建乾达重型机械有限公司内）
福州祥农牧业有限公司	总经理：陈	地址：闽侯县祥谦镇兰圃村
闽侯县翰翰农业专业合作社	联系人：郑	地址：福建省福州市闽侯县荆溪镇古山洲村
闽侯县旺利达农业专业合作社	联系人：黄	地址：闽侯县青口镇梅岭村
闽侯县甘蔗洪萍油漆经营部	老板：洪	地址：福建省福州市闽侯县甘蔗街道军民路2号
闽侯县广技广告设计有限公司	总经理：方	地址：闽侯县甘蔗街道化龙村
闽侯非凡财富壹投资合伙企业（有限合伙）	联系人：黄	地址：福建省福州市闽侯县高新区海西高新技术产业园创业大厦B区1层108室
闽侯县瑞丰农林开发有限公司	总经理：江	地址：福建省福州市闽侯县白沙镇新坡村2号
福州甬吉贸易有限公司	总经理：刘	地址：福州市闽侯县上街镇源通东路59号尚书耕天下花园6#楼302单元
福州通和物流有限公司	总经理：吴	地址：福建省福州市闽侯县青口镇宏三村马路边3排
闽侯县云堡里苗木种植专业合作社	联系人：吴	地址：福建省福州市闽侯县白沙镇林柄村云堡里9号
闽侯县三十六计装饰有限公司	总经理：占	地址：福建省福州市闽侯县上街镇新峰村梧洋11号
闽侯双顺贸易有限公司	总经理：吴	地址：闽侯县甘蔗街道闽都民俗园商业街第11号楼
闽侯县薇莲娜贸易有限公司	总经理：倪	地址：闽侯县上街镇浦口新村岐安小区3号楼103室
福州天之艺木雕有限公司	总经理：沈	地址：闽侯县上街镇建平村金上大道博仕后家园1#07店
福州千叶一品工艺品有限公司	总经理：叶	地址：闽侯县上街镇新峰村上街商贸中心1#02号店
福建省中科天成产业发展有限公司	总经理：赵	地址：闽侯县荆溪镇厚屿村（福州大世界橄榄有限公司办公楼三楼）
福州御泰贸易有限公司	总经理：林	地址：福州市闽侯县荆溪镇荆溪村
福州丰登生物科技有限责任公司	总经理：陈	地址：福建省福州市闽侯县高新区海西创新园10号楼1层111室
福州海日升贸易有限公司闽侯第一分店	老板：王	地址：闽侯县上街镇国宾大道2号博仕后公馆A12#楼一层21、22号店面
福州鑫煌根艺有限公司	总经理：徐	地址：闽侯县上街镇新峰村、红峰村7#203单元
福建海晟连锁营销发展有限公司闽侯上街店	老板：陈	地址：闽侯县上街镇国宾大道2号博仕后公馆商业店面A3#楼1层09、10店面
福州三竹工艺品有限公司	总经理：叶	地址：闽侯县上街镇红峰村一层02店面
闽侯县福瑞贸易有限公司	总经理：王	地址：闽侯县南屿镇后山村福建闽丰科技种业有限责任公司办公楼四层
闽侯县建业五金配件加工厂	厂长：张	地址：福建省福州市闽侯县荆溪镇溪下福州榕西高级职业学校内
闽侯县泽鑫工贸有限责任公司	总经理：张	地址：闽侯县南通镇桥街村小桥仔1号
福州尚古家居工艺品有限公司	总经理：陈	地址：福建省福州市闽侯县甘蔗街道长江村墩园洲
闽侯县利康水暖有限责任公司	总经理：郑	地址：闽侯县南屿镇流洲村浦口
福州三顺石料有限公司	总经理：吴	地址：福州市闽侯县白沙镇新城闽兴大道商贸中心139号
福建伟业新型建材制造有限公司	总经理：张	地址：闽侯县竹岐乡榕岸工业区（福建宇宏新型建材制造有限公司内）
福州征泰新饲料有限公司	总经理：胡	地址：福建省福州市闽侯县荆溪镇关口村工业区
福州逸辰工艺品有限公司	总经理：方	地址：闽侯县上街镇蔗洲村
福州市鑫胜工艺品有限公司	总经理：郑	地址：福州市闽侯县甘蔗街道闽侯甘蔗工业区（闽侯县甘蔗忠艺厂）综合厂房第二层
福州裕农种业有限公司	总经理：汪义印	地址：闽侯县南屿镇高岐工业区高岐村安里58号写字楼205室
闽侯县益农农机农民专业合作社	联系人：叶立群	地址：闽侯县鸿尾乡鸿尾村
闽侯县新创意工艺品有限公司	总经理：曾豪先生	地址：闽侯县甘蔗街道新浦路1号3#车间
福建威森机械科技有限公司	总经理：叶晓扬	地址：福州市闽侯县祥谦镇泮洋村A幢一层
福州加里吨贸易有限公司	总经理：王进修	地址：福州市闽侯县上街镇乌龙江北大道1号福州地区大学新校区教师生活区B区B8#506单元
福州大世界橄榄有限公司闽侯南通经营部	老板：丁云鹏	地址：福州市闽侯县南通镇海峡副食品批发市场2029-2130店
闽侯县茂田新型建材有限公司	总经理：黄先生	地址：闽侯县南屿镇茂田村空心砖厂内
福州华烁汽车配件有限公司	总经理：赵仁心	地址：福州市闽侯县祥谦镇辅翼村
福建德亿隆投资有限公司	总经理：林鼎先生	地址：福州市闽侯县上街镇金屿村西关商住楼106-3
闽侯县金秋农业专业合作社	联系人：方先生	地址：福建省福州市闽侯县廷坪乡尾桥村桥西3号
闽侯县艾品房地产管理有限公司	总经理：陈先生	地址：闽侯县南屿镇忠观街3号旗山商贸街商住楼2#楼1层11店面
福州市闽侯源玖现代物流有限公司	总经理：缪先生	地址：闽侯县尚干镇良安路20号1#办公楼2楼
福建龙骏汽车销售服务有限公司	总经理：许先生	地址：闽侯县荆溪镇荆溪村（闽侯县荆溪镇溪头粮食复制品厂）1#楼二层
福州导航教育科技有限公司	总经理：孙先生	地址：福建省福州市闽侯县上街镇美岐村东升综合楼
福州市闽侯县恒盛贸易有限公司	总经理：黄先生	地址：福建省闽侯县甘蔗镇长江村墩园洲
福建双龙温泉旅游有限责任公司	总经理：林先生	地址：闽侯县南屿镇双龙村土牛46号
福建友丰建筑工程有限公司	总经理：林先生	地址：闽侯县青口镇新城路62号博雅星城2#楼1层03店面
福建东方巴比松文化投资管理有限公司	总经理：洪先生	地址：闽侯县南屿镇五峰里1号独幢客房6#
福建省宏华物资再生利用有限公司	总经理：连先生	地址：福建省福州市闽侯县荆溪镇关口234号
福建宝岛眼镜（连锁）有限公司闽侯南屿经营部	老板：毛先生	地址：闽侯县南屿镇南旗村桥下旗顶尾新村（张立金房屋）
闽侯县新烨家居有限公司	总经理：邓先生	地址：闽侯县甘蔗街道昙石山西大道98号新城丽景B区15#楼402单元
福建易筑建设有限公司	总经理：林先生	地址：福州市闽侯县上街镇金屿村西关商住楼连接体商场106-1C区
福州闽韵速递有限公司	总经理：周立军	地址：闽侯县南屿镇高崎工业区（闽侯县忠彬塑胶有限公司内）
福州中建正坤置业有限公司	总经理：王先生	地址：福州市闽侯县青口镇升旗村
闽侯县南屿味香村蜜饯加工场	联系人：林先生	地址：闽侯县南屿镇尧沙村
曼酷食品（福州）有限公司	总经理：张先生	地址：闽侯县甘蔗街道铁岭西路18号5#楼一层
闽侯县伟兴农业专业合作社	联系人：江先生	地址：闽侯县南通镇瓜山村瓜后40号
闽侯县德清果蔬专业合作社	联系人：张先生	地址：闽侯县南通镇泽洋村湖头路19号
闽侯县宜动机电技术有限公司	总经理：徐先生	地址：闽侯县甘蔗街道福龙新村28幢104房
福州翼游软件有限公司	总经理：林先生	地址：福建省福州市闽侯县海西高新技术产业园创新园10号楼1层
福州聚福源红木家居有限公司	总经理：洪先生	地址：闽侯县荆溪镇荆溪村徐家村165号1#厂房
福州闽侯蝶恋花食品有限公司	总经理：骆先生	地址：福州市闽侯县南屿镇后山村宅山37号食品加工厂三楼
闽侯县祥和农业专业合作社	联系人：池先生	地址：闽侯县大湖乡后洋村58号
福建耀鑫家居用品有限公司	总经理：李先生	地址：闽侯县上街厚美村（张承节厂房第一层）
中铁八局集团建筑工程有限公司福州分公司	总经理：慕先生	地址：福建省福州市闽侯县高新区海西高新技术产业园创新园11号楼4层402室
福州旺锋工艺品有限公司	总经理：陈英锋	地址：闽侯县竹岐乡榕西村111号
闽侯仲庚工艺品有限公司	总经理：杨大溪	地址：闽侯县小箬乡福田村福田5号
福州闽燕汽配有限公司	总经理：林玉清	地址：闽侯县祥谦镇门口工业区
福建汇美家俱有限公司闽侯祥谦分公司	总经理：朱杰先生	地址：闽侯县祥谦镇门口村渡头62号福州新技石材工业有限公司内
闽侯县翠屏园农业专业合作社	联系人：李章球	地址：闽侯县廷坪乡石洋村坑坪
福州长隆工艺品有限公司	总经理：董祥慈	地址：闽侯县上街镇中美村
福州市秋野园林景观工程有限公司	总经理：邱野先生	地址：闽侯县上街镇源通东路118号福晟学府8#楼201单元。
福州祥桂工艺品有限公司	总经理：林祥桂	地址：闽侯县上街镇上街村丹屿
福州喜乐工艺品有限公司	总经理：赵俊杰	地址：闽侯县上街镇榕桥村过洋15号
福州鑫艺堂工艺品有限公司	总经理：金昌燕	地址：闽侯县上街镇马保村石沙13号
福建省中国旅行社闽侯上街营业部	老板：吴晋晖	地址：闽侯县上街镇金屿、美岐村
福州百鸿汽车销售有限公司	总经理：林瑞安	地址：闽侯县青口镇农光村新城路博雅星城2#店面14
福建三辰新材料有限公司	总经理：陈明星	地址：闽侯县青口镇东台村
福州源申精密工业有限公司	总经理：李庆源	地址：闽侯县青口镇东南汽车城后福工业区
福建路路通建材有限公司	总经理：庞瑞飞	地址：闽侯县南屿镇旗山集中工业区6号1#车间A区
福州六顺担保有限公司	总经理：黄小明	地址：闽侯县南屿镇南前村土K厝
福州市万兴冶金设备有限公司	总经理：周承风	地址：闽侯县荆溪镇溪头工业区
福州市闽侯县新丝璐婚纱礼服商行	联系人：许君君	地址：闽侯县荆溪镇绿洲家园闽水情551号L9-5A
闽侯启航电子科技有限公司	总经理：杨丽曦	地址：闽侯县荆溪镇光明村上竹
闽侯县大湖仙油茶专业合作社	联系人：张延年	地址：闽侯县鸿尾乡南元村后洋34号
中信银行股份有限公司福州闽侯支行	联系人：林榕琦	地址：闽侯县甘蔗街道昙石山西大道98号新城丽景B区9号楼一层103至109、二层201-209，12号楼一
福州凯耀塑胶有限公司	总经理：俞春红	地址：闽侯县甘蔗街道长江村墩园洲（闽侯县德雅工艺品有限公司）0#厂房
闽侯县温馨家园贸易有限公司	总经理：刘文焕	地址：闽侯县甘蔗街道八一八东路南侧横屿商住楼B#402
闽侯县博斯特婴童贸易商行（普通合伙）	联系人：黄友钦	地址：闽侯县白沙镇白沙新街117号二楼
闽侯县木匠天子工艺品有限公司	总经理：李春香	地址：闽侯县白沙镇安平路88号白沙新城步行街2#楼301单元
福建福奔汽车有限公司	总经理：陈文豪	地址：福州市闽侯县青口镇宏屿村闽南厂5号办公楼
福建中恒金置业有限公司	总经理：王爱艺	地址：福州市闽侯县南屿镇乌龙江南大道77号
福建华丰伟业电子科技开发有限公司	总经理：刘月仙	地址：福州市闽侯县南屿镇生物医药和机电产业园
闽侯县容海装饰材料有限公司	总经理：刘中富	地址：福州市闽侯县南屿镇高岐工业区（高岐村安厦53号）3#厂房第四层
福州志宏群峰电子科技有限公司	总经理：陈志璋	地址：福州市闽侯县海西高新技术产业园创新园10号楼1层
福建巨亚家具制造有限公司	总经理：廖先生	地址：闽侯县甘蔗街道铁岭5号
闽侯县郝平安果蔬专业合作社	联系人：陈先生	地址：福州市闽侯县南通镇新岐村新?洲
闽侯县隆发工艺品加工厂	厂长：温先生	地址：闽侯县鸿尾乡超?村
福州新顺兴工贸有限公司	总经理：叶先生	地址：闽侯县青口镇壶山村东南千家花园6#-5#楼8号店
闽侯县鑫光工艺品有限公司	总经理：池先生	地址：闽侯县甘蔗街道五福新村
福州柏悦投资管理有限公司	总经理：吴先生	地址：福州市生物医药和机电产业园区（闽侯县南屿镇）
福州市闽侯县欣美达贸易有限公司	总经理：欧先生	地址：闽侯县上街镇国宾大道233号博仕后家园B区1-1#楼1033单元
福州森林木根雕工艺品有限公司	总经理：张先生	地址：闽侯县上街镇中美村
福州尚世汽车贸易有限公司	总经理：吴先生	地址：闽侯县尚干镇良安路8号江浩尚景园1#楼504单元
福建省融旗建设工程有限公司闽侯分公司	总经理：郭先生	地址：闽侯县上街镇侯官路101号天江第一村0207#楼
福州柏悦乳胶有限公司	总经理：吴先生	地址：福州市生物医药和机电产业园区（闽侯县南屿镇）
福建优尚保洁服务有限公司	总经理：陈先生	地址：闽侯县南屿镇六十份村10号厂房
闽侯臻红轩红木家具有限公司	总经理：张先生	地址：闽侯县荆溪镇徐家村303号
福建联众科技有限公司	总经理：吴先生	地址：闽侯县青口镇东台村
闽侯县甘蔗黄道泉便利店	老板：黄先生	地址：闽侯县甘蔗街道昙石村育才路2#楼
闽侯县甘蔗奇奇饭店	老板：张先生	地址：闽侯县甘蔗街道流洋村村委楼一层
福州粮食批发交易市场鑫明粮行	联系人：张先生	地址：闽侯县荆溪镇福州市粮食批发交易市场03座03、04号
闽侯县甘蔗东洋轮胎店	老板：程先生	地址：闽侯县甘蔗街道县城新区“世纪芳洲”住宅小区1#甲108号
闽侯县上街一帆电脑维修服务中心	联系人：胡先生	地址：闽侯县上街镇新峰社区梧洋A62-1号107
闽侯县上街新一代图文工作室	联系人：曾先生	地址：闽侯县上街镇福州大学旗山校区学生生活区24#-4号架空层
福州海峡副食品批发市场鑫港商行	联系人：林先生	地址：闽侯县南通镇海峡副食品批发市场2112号店
福州正锐鞋材贸易有限公司	总经理：洪先生	地址：闽侯县甘蔗街道滨江西大道66号“世茂滨江新城”21幢3003室
闽侯县优品吉家装饰工程有限公司	总经理：杨先生	地址：闽侯县甘蔗街道昙石山西大道98号新城丽景B区10#楼2层216店面
福建冠达文化创意产业发展有限公司	总经理：李先生	地址：闽侯县荆溪镇古山洲村洲头268号5#厂房
闽侯县盛洲弘阳贸易有限公司	总经理：叶先生	地址：福建省福州市闽侯县南屿镇高岐村安厦路52号
闽侯县海丰投资有限公司	总经理：林先生	地址：闽侯县青口镇升旗村（林宝木房屋）
闽侯县骏登贸易有限公司	总经理：林先生	地址：闽侯县尚干镇红新村（高敏兰房屋）
福州爱家房产代理有限公司	总经理：姚先生	地址：闽侯县上街镇闽都大庄园76#店面
闽侯县鼎懋农业开发专业合作社	联系人：黄香院	地址：闽侯县洋里乡仙门村坝头3号
福州金丝燕建材有限公司	总经理：李强先生	地址：闽侯县荆溪镇古山洲村67号
福建天一同益智能电网设备有限公司	总经理：叶炳凤	地址：闽侯县南屿镇（福州市生物医药和机电产业园区）
福州达克家居制造有限公司	总经理：林道胜	地址：闽侯县荆溪镇关口村
福州宏基混凝土有限公司	总经理：钱胜辉	地址：闽侯县尚干镇岐头村
福建龙旺发展有限公司	总经理：薛伟先生	地址：福建省闽侯县南屿镇乌龙江南大道66号康桥丹堤一期57#楼三层
闽侯县榕竹果蔬农民专业合作社	联系人：何功祥	地址：闽侯县竹岐乡竹岐村竹岐街
闽侯县志宇包装制品有限公司	总经理：杨孝忠	地址：闽侯县南通镇方庄村
闽侯县兴辉建材贸易有限公司	总经理：王建辉	地址：闽侯县甘蔗街道山前村38号
闽侯县鑫诚捷物业管理有限公司	总经理：陈德森	地址：闽侯县上街镇美岐村
中石化森美（福建）石油有限公司福州闽侯惠顺加油站	站长：郑彩辉	地址：福州市闽侯县荆溪镇光明村县道115线7公里400米
福州鑫腾达贸易有限公司	总经理：陈金先生	地址：闽侯县南屿镇南旗村新园洲403室
闽侯县源锋石油化工有限公司	总经理：陈锋先生	地址：闽侯县甘蔗街道昙石山西大道109号世纪芳洲住宅小区9#707单元
闽侯县兴隆兴玻璃制品厂	厂长：张文正	地址：闽侯县洋里乡洋头村清水湾大顶厂
闽侯县满山红花卉专业合作社	联系人：王月珠	地址：闽侯县鸿尾乡桥头村坂头
闽侯县新时代农业专业合作社	联系人：王贤?	地址：闽侯县鸿尾乡桥头村坂头
福建宝徕实业有限公司	总经理：郑鑫杰	地址：福建省闽侯县青口镇东台村
福州名扬竹木工艺品有限公司	总经理：陈依?	地址：闽侯县上街镇侯官村下市43号
福州市恒嘉利工艺品有限公司	总经理：王夫林	地址：闽侯县上街镇岐头村5号
闽侯县白沙小琴电动车店	老板：刘先生	地址：闽侯县白沙新城13幢106店
闽侯县南屿金家福饭庄	联系人：唐先生	地址：闽侯县南屿镇南井村生产资料中心市场
福州粮食批发交易市场五福粮行	联系人：刘先生	地址：闽侯县荆溪镇福州市粮食批发交易市场11座2号
闽侯县荆溪爱车洗车店	老板：卢先生	地址：闽侯县荆溪镇荆溪村
闽侯县甘蔗康好文化办公用品店	老板：张先生	地址：闽侯县甘蔗街道校园路56号第一间店面
闽侯县荆溪昕昕通信器材店	老板：张先生	地址：闽侯县荆溪镇徐家村
闽侯县天上涞贸易商行	联系人：魏先生	地址：闽侯县甘蔗街道校园路21号后座
闽侯县青口雷洛斯天使皮具店	老板：林先生	地址：闽侯县青口镇农光村新城路博雅星城12#店面29
闽侯县青口玉芳电器商店	老板：施先生	地址：闽侯县青口镇壶山村东南千家花园5#11号
闽侯县荆溪福胜瓷砖店	老板：毛先生	地址：闽侯县荆溪镇厚屿村
闽侯县甘蔗闽古青草店	老板：林先生	地址：闽侯县甘蔗镇三英村蔗洲路
闽侯县青口依燕棋牌室	联系人：郑先生	地址：闽侯县青口镇陶精路3号东南千家花园5#楼201单元
闽侯县荆溪马江南诊所	所长：马先生	地址：闽侯县荆溪镇绿洲家园
深圳市易迅电子商务发展有限公司福州分公司	总经理：陈刚先生	地址：闽侯县青口镇东南汽车城内后福工业区
闽侯县高岐种子产业园管理有限公司	总经理：汪清先生	地址：闽侯县南屿镇高岐工业区高岐村安里58号1#厂房1层1-2车间
福建省鑫宏扬建设工程有限公司闽侯县甘蔗分公司	总经理：洪启钢	地址：福州市闽侯县甘蔗街道长江村墩园洲
闽侯金宏鑫贸易有限公司	总经理：刘巧娟	地址：闽侯县甘蔗街道昙石山西大道69号员工公寓32座905房
福州国美电器有限公司闽侯县上街店	老板：陈凡华	地址：闽侯县上街镇金屿村余盛179号西关商住楼
福州豫龙盛建筑劳务有限公司	总经理：王爱勤	地址：闽侯县甘蔗街道昙石村安业路3栋3层
福州青酿酒业有限公司	总经理：李敏先生	地址：闽侯县甘蔗街道铁岭西路18号1#研发楼103
福州炫辉工艺品有限公司	总经理：毛武辉	地址：闽侯县甘蔗街道街心路32号“首邑步行街”A区8#301
福州优多机械有限公司	总经理：李发平	地址：闽侯县甘蔗闽侯县经济技术开发区洋屿路1号试剂车间1层01室
福州三阳电线电缆有限公司	总经理：郑孟希	地址：闽侯县青口镇付竹工业区
福建金泰汽车销售服务有限公司	总经理：张磊先生	地址：闽侯县青口镇镜上村口324国道北侧
福建省榕鼎工艺品有限公司	总经理：陈松先生	地址：福州市闽侯县上街镇金屿村403单元（刘爱樱住宅）
福建金榕汽车销售服务有限公司	总经理：梁平先生	地址：闽侯县青口镇镜上村口324国道北侧
福州百泰汽车销售服务有限公司	总经理：林元进	地址：闽侯县青口镇镜上村口324国道北侧
福建乐家建材科技有限公司	总经理：许明先生	地址：闽侯县白沙镇闽侯经济技术开发区白沙园
闽侯县南屿金香工艺品厂	厂长：黄金香	地址：闽侯县南屿镇新联村?上41号
闽侯县南屿冠贸精密五金制品厂	厂长：周世梅	地址：闽侯县南屿镇江口村码头47号
闽侯县上街王金凤日杂店	老板：王先生	地址：闽侯县上街镇金屿村金桥2号楼第1间店
闽侯县甘蔗街心美食荟饭店	老板：苏先生	地址：闽侯县甘蔗街道街心路162号一层
闽侯县上街美爆美妆精品店	老板：林先生	地址：闽侯县上街镇福建师范大学旗山校区文化街28号
闽侯县鸿尾爱儿宝奶粉店	老板：任先生	地址：闽侯县鸿尾乡石佛头街110号
闽侯县上街时时丽涂料店	老板：赵先生	地址：闽侯县上街镇红峰村沙?自然村镇办工业小区（第二间即11号店）
闽侯县起斌油漆经营部	老板：潘先生	地址：闽侯县白沙镇白沙新城14栋2号
福州福旺贸易有限公司	总经理：林先生	地址：闽侯县甘蔗街道入城路北侧海京楼8#308单元
福州市鑫泓杰汽车贸易有限公司	总经理：陈先生	地址：闽侯县尚干镇后村
福州佰庄担保有限公司	总经理：洪先生	地址：福州市闽侯县甘蔗街道昙石山西大道69号员工公寓1#-1、2、3号店面
福建和顺德混凝土有限公司	总经理：李先生	地址：福建闽侯县祥谦镇峡南村
福州创世纪家具有限公司	总经理：许先生	地址：闽侯县上街镇新上街292号上街商贸中心1#楼504单元
福州易佳通汽车贸易有限公司	总经理：郑先生	地址：闽侯县祥谦镇枕峰村国道边
闽侯县津荣农业综合开发有限公司	总经理：叶先生	地址：闽侯县荆溪镇港头村白头
福州博宏投资管理有限公司	总经理：林先生	地址：福州市闽侯县上街镇科技东路海西高新技术产业园创业大厦A区11层
闽侯县金泉菌蔬种植专业合作社	联系人：程先生	地址：闽侯县荆溪镇关西村里王8号
闽侯县鸿尾航枢苗木场	联系人：陈先生	地址：闽侯县鸿尾乡里头村25号
福州大唐木业有限公司	总经理：唐先生	地址：闽侯县上街镇建平小区建平路48号
福州吉保全机电工程有限公司	总经理：何先生	地址：闽侯县荆溪镇闽侯经济技术开发区一期三号南路1号60车间
闽侯县福秀堂化妆品有限公司	总经理：陈先生	地址：闽侯县南屿镇南旗村南屿街
闽侯县融达机械设备有限公司	总经理：郑先生	地址：闽侯县甘蔗街道陈店湖工业集中区（闽侯县明旺工艺品有限公司内）
闽侯县南屿惠海电器店	老板：林先生	地址：闽侯县南屿镇南旗村国道边
闽侯县甘蔗野魅足风暴鞋店	老板：邱先生	地址：闽侯县甘蔗镇五福村入城路南侧
闽侯县荆溪安健贸易商行	联系人：李先生	地址：闽侯县荆溪镇关东村西境103号
闽侯县甘蔗布丰窗帘店	老板：林先生	地址：闽侯县甘蔗街道横屿海京楼B3楼110、111店面
闽侯县上街聚辉便利店	老板：杨先生	地址：闽侯县上街镇溪源宫路99号（福州市第一技工学校学生公寓架空层）
闽侯县青口艺博琴行	联系人：李先生	地址：闽侯县青口镇新城西路62号博雅星城12#楼02店面
闽侯县鸿尾振球百货商店	老板：郑先生	地址：闽侯县鸿尾乡石佛头街
福州海峡副食品批发市场百联食品经营部	老板：陈先生	地址：闽侯县南通农产品物流中心海峡副食品批发市场A座2125号店
闽侯县甘蔗家灯五金店	老板：李先生	地址：闽侯县甘蔗镇横屿村232号
福州海峡副食品批发市场玉琴商行	联系人：郑先生	地址：闽侯县南通镇海峡副食品批发市场2111号店
闽侯县上街凯胜古典家具店	老板：陈先生	地址：闽侯县上街镇建平村金上大道博仕后家园1#07店
闽侯县思博创意广告有限公司	总经理：周成先生	地址：闽侯县甘蔗街道大元村陈店湖工业集中区
闽侯县森林人生态农业专业合作社	联系人：林齐勇	地址：闽侯县洋里乡长基村吾?7号
闽侯县巧农妇生态农业发展有限公司	总经理：叶晓东	地址：闽侯县甘蔗街道化龙村亭下后弄14号
闽侯县荆溪开源粮食制品加工厂	厂长：吴开源	地址：闽侯县荆溪镇关口西山
闽侯县共创广告有限公司	总经理：马彦超	地址：闽侯县上街镇源通东路118号福晟学府5#楼808单元
闽侯县安达尔玻璃制品有限公司	总经理：董敏光	地址：闽侯县甘蔗街道交通路35号
闽侯飞丰果蔬专业合作社	联系人：刘其明	地址：闽侯县南通镇泽洋村湖头
聚兴机械（闽侯）有限公司	总经理：陈秋先生	地址：闽侯县白沙镇大目溪村花文堡桥头
福州中友汽车贸易有限公司	总经理：陈晓辉	地址：福州市闽侯县青口镇壶山村陶精路3号千家花园18幢402室
福州圆福工艺品有限公司	总经理：李国勇	地址：闽侯县上街镇中美村
福州鑫通宏机械配件有限公司	总经理：林荣府	地址：闽侯县荆溪镇徐家村169号（福州盟顺工艺品有限公司）6#厂房二楼
福州鑫农达种子有限公司	总经理：汪孝伙	地址：闽侯县南屿镇高岐工业区高岐村安里58号写字楼203室
福州欣鼎工艺品有限公司	总经理：陈剑新	地址：闽侯县上街镇中美村
福州湘衡食品有限公司	总经理：谭伟先生	地址：福州市闽侯县南通镇海峡副食品批发市场1111号店
福州旺鼎工艺品有限公司	总经理：董祥钦	地址：闽侯县上街镇中美村
福州市闽侯永恒欣包装制品厂	厂长：王庆凤	地址：闽侯县白沙镇云头岭社区内（原七四二八厂）
闽侯县甘蔗端昭针织品店	老板：余先生	地址：闽侯县甘蔗镇街心路41号电力公寓沿街店面15号店面
闽侯县大湖友聚饲料店	老板：刘先生	地址：闽侯县大湖乡湖新路25号
闽侯县大湖新铿五金建材店	老板：杨先生	地址：闽侯县大湖乡大湖街49号
闽侯县大湖武水家具店	老板：陈先生	地址：闽侯县大湖乡大湖街39号
闽侯县大湖慎奎钟表店	老板：刘先生	地址：闽侯县大湖乡大湖街57号
闽侯县大湖名德服装店	老板：陈先生	地址：闽侯县大湖乡大湖街
闽侯县大湖林妹鞋店	老板：林先生	地址：闽侯县大湖乡大湖街63号
闽侯县大湖冬娇五金建材店	老板：黄先生	地址：闽侯县大湖乡湖新路55号
闽侯县大湖春玉服装店	老板：刘先生	地址：闽侯县大湖乡大湖街53-55号
闽侯县白沙文化城文化用品店	老板：肖先生	地址：闽侯县白沙镇白沙新城环岛5座106号
闽侯县白沙洪兴果园	联系人：聂先生	地址：闽侯县白沙镇马坑村洋高山
闽侯县金石新型材料有限公司	总经理：胡鹏翔	地址：闽侯县荆溪镇古山洲
闽侯鸿业鑫家具有限公司	总经理：刘友彩	地址：福州市闽侯县上街镇源通21号3层
福州新凯旋食品有限公司	总经理：施华铝	地址：闽侯县上街镇马保村后园路36号2#3层（闽侯县岐安进兴工艺品有限公司内）
福州市闽侯诚昌机电有限公司	总经理：郭碧燕	地址：闽侯县青口镇壶山村东南千家花园9号
福州市君悦制衣有限公司	总经理：夏海萍	地址：闽侯县荆溪镇光明村
福州润盛通实业有限公司	总经理：谢政英	地址：闽侯县尚干镇兰圃高速口324国道和203省道交叉口
福州宏盛源工艺品有限公司	总经理：范用见	地址：闽侯县荆溪镇溪头工业区169-1号
福州恒茂源机械工业有限公司	总经理：陈春霞	地址：闽侯县祥谦镇兰圃村闽侯县盛辉物流有限公司1#楼一层厂房
福州恒辉工艺品有限公司	总经理：程文辉	地址：闽侯县荆溪镇关口工业区8号
福州好品味食品有限公司	总经理：何裕斌	地址：闽侯县上街镇马保村后园路36号1#厂房6楼
福建中升源园林工程有限公司	总经理：陈锦	地址：闽侯县南通镇通洲路旁
福建省晟天模具制造有限公司	总经理：刘用剑	地址：闽侯县南屿镇后山村（福州长征珠宝有限公司）3#厂房3层
福建华神樟芝生物科技有限公司	总经理：马建煜	地址：闽侯县青口镇青林村委会办公大楼
闽侯县罗瑞峰园林工程有限公司	总经理：陈守瑞	地址：闽侯县廷坪乡罗桥村罗桥126号
福州恒亮塑胶科技有限公司	总经理：陈明星	地址：闽侯县尚干镇良安路16号（闽侯县福源五金机械有限公司）3号楼
闽侯县金百合苗木种植专业合作社	联系人：金昌杰	地址：闽侯县上街镇马排村竹榄32号
闽侯县加美苗木专业合作社	联系人：傅兴唐	地址：闽侯县上街镇厚美村春江御园P65
福州市旺家好物业管理有限公司闽侯分公司	总经理：林烯	地址：闽侯县上街镇红峰村
闽侯县新港健身服务有限公司	总经理：李厚兴	地址：闽侯县南屿镇江口村后双
福州诚达电子高新技术有限公司	总经理：宋建成	地址：闽侯县南屿镇（福州高新技术园区）
福建龙台山园林工程有限公司	总经理：洪晓明	地址：闽侯县荆溪镇龙台山生态园
福建科源机械有限公司	总经理：许燕玉	地址：闽侯县荆溪镇荆溪村
福州平安建筑设备租赁有限公司	总经理：夏耿忠	地址：闽侯县甘蔗街道陈店湖路1号14#厂房
福州东凌家居制品有限公司	总经理：张良东	地址：闽侯县甘蔗街道陈店湖工业区（闽侯县鑫祥工艺厂内）
闽侯县大湖宝山蔬果农民专业合作社	联系人：严仁钗	地址：闽侯县大湖乡上苑村上苑17号
福州德润建筑材料有限公司	总经理：林泷辉	地址：福州市闽侯县南通镇罗洲新桥二
福州老林旺商贸有限公司	总经理：林则恩	地址：福州市闽侯县南通镇海峡副食品批发市场3146-3147#
福州市太古家居制造有限公司	总经理：程喜	地址：福州市闽侯县荆溪镇溪头工业区徐家村165号
福州品川食品有限公司	总经理：赵榕	地址：福州市闽侯县甘蔗街道榕洲路3号滨江苑8#楼1层04、05店面
闽侯县三兴食用菌专业合作社	联系人：张贤木	地址：闽侯县廷坪乡赤坑村
福建新大地担保有限公司	总经理：许善秋	地址：闽侯县上街镇邱阳东路2号弘绘菁华园弘绘楼1层16店面
福州智慧工艺品有限公司	总经理：占智慧	地址：闽侯县上街镇建平村后山99号
福州汉唐木业有限公司	总经理：吴世勇	地址：闽侯县上街镇建平村
福州佳翔工艺品有限公司	总经理：陈忠彬	地址：闽侯县上街镇建平村
福州翔达木业有限公司	总经理：金光	地址：闽侯县上街镇建平村
闽侯县诚义达贸易有限公司青口分公司	总经理：林岚	地址：闽侯县青口镇海韵国际城17号楼
福州市闽侯县鑫达机械设备安装有限公司	总经理：杨艾平	地址：闽侯县青口镇博雅星城18幢107号
闽侯升昌贸易有限公司	总经理：林升昌	地址：闽侯县青口镇白水路11号办公楼三楼B区
闽侯县绿珍农业开发有限公司	总经理：洪月花	地址：闽侯县大湖乡大池村
福建省传祺酒业有限公司	总经理：叶绿萍	地址：福州市闽侯县祥谦镇祥青路10号1#厂房
福州英辉贸易有限公司	总经理：杨辉	地址：福州市闽侯县上街镇榕桥村幸福1号
福建祥胜物流有限公司	总经理：林祥栋	地址：福州市闽侯县青口镇坊口村民委员会综合楼6号二层
福州精锐电子科技有限公司	总经理：李辉	地址：福州市闽侯县荆溪镇厚屿187号
福建闽侯民本村镇银行股份有限公司	总经理：陈传太	地址：福州市闽侯县甘蔗镇入城路口海京楼B1#1层105-111
福州加那利贸易有限公司	总经理：林	地址：闽侯县甘蔗横屿村120号
福建省创兴木雕工艺品有限公司	总经理：张	地址：福建省闽侯县上街镇蔗州村214号
闽侯县南屿镇鬼斧神工木艺厂	厂长：范	地址：闽侯县南屿镇后山村长征珠宝1#4层
闽侯县原素家居礼品有限公司	总经理：曾	地址：闽侯县白沙镇井下村南山洋小区20幢301室
福州闽江风光农业开发有限公司	总经理：林	地址：闽侯县白沙镇唐举村
闽侯县欣义商贸有限责任公司	总经理：江	地址：闽侯县南屿镇高岐村
福建省品味人生文化传播有限公司	总经理：陈	地址：福州市闽侯县上街镇红峰村
闽侯县福宇叶绿菜专业合作社	联系人：刘	地址：闽侯县南通镇泽洋村湖头15号
福州市山民古典家具有限公司	总经理：陈	地址：闽侯县上街镇红峰村
福州佳力可食品有限公司	总经理：林	地址：闽侯县荆溪镇铁岭经济技术开发区一期九号中路5号四层西侧
福州国亿食品有限公司	总经理：林	地址：闽侯县南屿镇高岐村康南1号
闽侯县甘蔗兴速汽车修理厂	厂长：程	地址：闽侯县甘蔗街道工业区
福建省闽侯县农资公司青口第五经营部	老板：傅	地址：闽侯县青口镇东台村
闽侯县万旗商贸有限公司	总经理：雷	地址：闽侯县南通镇海峡副食品批发市场630号
福建省闽侯县光明玻纤复合材料有限公司灵峰分公司	总经理：林	地址：闽侯县白沙镇联坑村灵峰自然村
福州有容食品有限公司	总经理：郑	地址：闽侯县南屿镇后山村宅山37号
闽侯县鑫众信钢构材料有限公司	总经理：姜	地址：闽侯县竹岐乡榕东村榕东398号厂房
福州旗山飞越丛林健身服务有限公司	总经理：郭	地址：闽侯县南屿镇五峰里1号独幢客房6#整座
福州闽昕石化有限公司	总经理：陈	地址：闽侯县青口镇西台村国道324线34公里200米
福州闽侯福来香工贸有限公司	总经理：刘	地址：闽侯县祥谦镇中院村（福建省闽侯华辉橡塑制品有限公司）
福州吴氏鸿达工艺品有限公司	总经理：吴	地址：闽侯县上街镇建平村
福州阳泰大发汽车销售服务有限公司	总经理：王	地址：闽侯县尚干镇海峡汽车文化广场一期二层A区1号
福州煜仁汽车服务有限公司	总经理：连	地址：闽侯县尚干镇东升村闸里（福厦下路洋中工业区边）
福州鑫利源塑胶有限公司	总经理：陈	地址：闽侯县青口镇付竹村梅溪路6号3#厂房（福建省金磐金属制品有限公司内）
福州新宏昌工贸有限公司	总经理：张	地址：闽侯县荆溪镇桐口林场
闽侯县荆溪惠顺加油站	站长：张	地址：闽侯县荆溪镇光明村
闽侯县连富农牧发展有限公司	总经理：林	地址：闽侯县大湖乡箬洋村林雷山
福州顺合机械有限公司	总经理：徐	地址：闽侯县白沙镇南山洋工业集中区
闽侯县南屿德杰加油站有限公司	总经理：郑	地址：闽侯县南屿镇南井村
闽侯恒成车辆信息咨询有限公司	总经理：潘	地址：闽侯县甘蔗街道长江村?园洲59号
福州星睿汽车销售有限公司	总经理：高	地址：福州市闽侯县青口投资区尚干镇海峡汽车文化广场一期汽车超市三层A区4号铺
闽侯县甘蔗美林大药房	联系人：苏	地址：闽侯县甘蔗街道双池村永辉超市内
闽侯县芳铭鑫网络传媒有限责任公司	总经理：曾	地址：闽侯县上街镇国宾大道599号
福建中盟汽车销售服务有限公司	总经理：陈	地址：闽侯县尚干镇良安路1号1层
福建铁路国际旅行社有限公司闽侯县南屿火车票代售点	联系人：陆	地址：闽侯县南屿镇南旗村
福州炎烽奇木工艺品有限公司	总经理：吴	地址：闽侯县上街镇建平村
福州金碟建材有限公司	总经理：金	地址：闽侯县南屿镇高岐村
闽侯县上街阳光钱柜音乐会所	所长：林	地址：闽侯县上街镇国宾大道276号综合商场（闽侯县德盛家电商场）整座二、三层
闽侯县荆溪江平塑料制品加工场	联系人：邓	地址：闽侯县荆溪镇大佳社区内6#房
福州盛阳房地产开发有限公司	总经理：陈	地址：闽侯县甘蔗街道榕洲路58号阳光城领海综合楼103室
闽侯县上街阳光钱柜酒吧	联系人：林	地址：闽侯县上街镇国宾大道276号综合商场（闽侯县德盛家电商场）整座一层
福建永辉物流有限公司	总经理：方	地址：福建省闽侯县南通镇南通街108号
闽侯县鸿尾溪源春光铁件加工厂	厂长：温	地址：闽侯县鸿尾乡溪元村在头
闽侯县竹岐乡振辉工艺车木件加工厂	厂长：蔡	地址：闽侯县竹岐乡春风村
闽侯县南通安居铝合金加工厂	厂长：王	地址：闽侯县南通镇马腾村下面洋
福州鸿福鑫工艺品有限公司	总经理：王礼添	地址：闽侯县上街镇新洲村（石沙新村）
福州欣奇工艺品有限公司	总经理：吴凌飞	地址：闽侯县上街镇建平村二中
福州鑫如意工艺品有限公司	总经理：林勇	地址：闽侯县上街镇马保村后园路36号9#厂房01#楼2层
福州藏龙阁工艺品有限公司	总经理：吴潇	地址：闽侯县上街镇建平村
福州蒋氏贸易有限公司	总经理：陈豪	地址：闽侯县南通农产品物流中心海峡副食品批发市场A区1134-1136店
闽侯县锦豪生物科技有限公司	总经理：张洪	地址：闽侯县青口镇宏二村（闽侯宏丰纸业有限公司厂房）
福建长洋经贸有限公司	总经理：林仪	地址：闽侯县南屿镇村下村村前
闽侯县鑫慧果蔬专业合作社	联系人：温后明	地址：闽侯县鸿尾乡桥头村桥头街83号
闽侯县新印象赠品制造有限公司	总经理：黄步公	地址：闽侯县荆溪镇厚屿村湾里湖
闽侯县美家宜贸易有限公司	总经理：赵汝汉	地址：闽侯县甘蔗街道八一八东路南侧横屿商住楼B#402
福州旗山森林人家农业综合开发有限公司	总经理：金宁辉	地址：闽侯县南屿镇五峰里1号1#201
闽侯县成功农机有限公司	总经理：周	地址：闽侯县竹岐乡竹岐桥头
福州深深房地产开发有限公司闽侯分公司	总经理：周	地址：闽侯县上街镇庄南路1号E5#01
福州宏业机械有限公司	总经理：陈	地址：闽侯县祥谦镇洋下村（福建龙生机械有限公司1#厂房）
福州港太太集成家居有限公司	总经理：陈	地址：闽侯县南屿镇高岐工业区
福建鑫威扬建材有限公司	总经理：郑	地址：福州市闽侯县上街镇马保高岐桥头1号鑫威扬工业园
福建省闽侯县大宽农业有限公司	总经理：陈	地址：闽侯县南屿镇后山村
闽侯县鑫翔汽车租赁有限公司	总经理：郑强	地址：闽侯县上街镇新峰村
闽侯鑫宝石料有限公司	总经理：陈威	地址：闽侯县青口镇梅岭村青龙路3公里处
闽侯县福顺铁合金厂	厂长：王剑峰	地址：闽侯县大湖乡珍山村
福州市闽侯县金日发贸易有限公司	总经理：李增金	地址：闽侯县青口镇新城商贸街商住楼3＃403
闽侯县山然工艺品有限公司	总经理：张世文	地址：闽侯县竹岐乡榕西村（昕华工艺品有限公司）1＃楼
闽侯县伯铭石油化工有限公司	总经理：陈伯休	地址：闽侯县甘蔗镇坛石村247号
闽侯县壹家壹快捷宾馆	联系人：饶祥明	地址：闽侯县街道入城路139号东利大厦六层
闽侯县耕心农业专业合作社	联系人：王昌云	地址：闽侯县鸿尾乡溪元村垅边3号
福州潮辉纸业有限公司	总经理：黄旭剑	地址：闽侯县祥谦镇兰圃村
闽侯县福丽汽车销售有限公司	总经理：林福光	地址：闽侯县尚干镇过浦村马路线22公里处
闽侯县嘉利商贸购物有限公司	总经理：林东英	地址：闽侯县上街镇金屿村余盛179号西关商住楼
闽侯县汶洲蔬菜农民专业合作社	联系人：林诗海	地址：闽侯县竹岐乡汶洲村
福建建盛建设工程有限公司闽侯装修装饰分公司	总经理：陈晨	地址：福建省闽侯县甘蔗镇八一八西路86号
闽侯县怡佳制衣厂	厂长：苏飞鹏	地址：闽侯县甘蔗街道军民路食品厂内
闽侯县祥谦星光鞋厂	厂长：林增文	地址：闽侯县祥谦镇澜澄村
福州市兴远成木业有限公司	总经理：张国斌	地址：闽侯县南屿镇晓岐村长门头
闽侯县渡头水泥制品场	联系人：林孟春	地址：闽侯县祥谦镇门口村工业集中区
闽侯县丰宇旅游开发有限公司	总经理：林丰年	地址：闽侯县上街镇新峰村新宅45号
福建正泽新能源有限公司	总经理：陈美栋	地址：闽侯县经济技术开发区一期甘洪路3号
深圳市赢时通汽车服务有限公司福州分公司	总经理：张传飞	地址：闽侯县青口镇政府楼3#407
闽侯县贝蒂工艺品有限公司	总经理：余姿英	地址：闽侯县陈店湖工业区
福州市闽侯县韵达快捷速递有限公司	总经理：张绍帅	地址：闽侯县青口镇宏二村
福州凯佳塑粉有限公司	总经理：吴佳发	地址：福州市闽侯县甘蔗街道陈店湖工业区
福建省闽侯县农资公司白沙新街经营部	老板：刘钊	地址：闽侯县白沙镇白沙新街
闽侯县青口天天货运代理有限公司	总经理：陈子山	地址：闽侯县青口镇千家山花园店面25号
闽侯宏鑫塑胶有限公司	总经理：林友向	地址：闽侯县竹岐乡榕西村中城（福建鸥标拉链有限公司内）
闽侯县宏良包装材料有限公司	总经理：林秋弟	地址：闽侯县青口镇庄头村桥头
福州金港劳务有限公司	总经理：林千龙	地址：闽侯县青口镇农光村新城路博雅星城12#303号
闽侯县建晖建筑劳务有限公司	总经理：张学宏	地址：闽侯县甘蔗街道校园路51号
中国邮政储蓄银行有限责任公司闽侯竹岐营业所	所长：王玲敏	地址：闽侯县竹岐乡竹岐村
福州安佳拆迁有限公司	总经理：洪伊?	地址：闽侯县甘蔗镇街心路11号
福州鑫亿达金属制品有限公司	总经理：刘伟	地址：闽侯县青口镇付竹工业区建材市场
福建精立机电有限公司	总经理：林少芳	地址：福州市闽侯县南屿镇元峰村（福州光华百特饲料有限公司）6#厂房底层
福州无忧车辆信息服务有限公司	总经理：张真	地址：闽侯县上街镇大洋路1号融汇山水一区22#楼03联排住宅
福建省恩典商贸有限公司	总经理：陈云	地址：闽侯县甘蔗街道校园路149号
福建省闽侯梁宏塑业有限公司	总经理：方?	地址：闽侯县青口镇青圃工业区
福州安融贸易有限公司	总经理：温启容	地址：闽侯县鸿尾乡桥头村桥头
闽侯县恒丰贸易有限公司	总经理：张秋泉	地址：闽侯县青口镇青口村（郑传国）自用房整座。
福州闽侯正中包装材料有限公司	总经理：郑玉忠	地址：闽侯县甘蔗街道闽侯经济技术开发区一期铁岭工业区九号中路10号
闽侯县方与圆汽车租赁有限公司	总经理：陈招妹	地址：闽侯县甘蔗街道818大道南侧海京楼6B601
福州源森泰橱柜有限公司	总经理：庄宗荣	地址：福州市闽侯县经济技术开发区一期九号中路9号
福州弘昌汽车销售服务有限公司	总经理：杨金华	地址：闽侯县祥谦镇枕峰村
闽侯县普罗精密工业有限公司	总经理：王顺本	地址：闽侯县青口镇莲峰村付竹亭1号
福建蓝海物流有限公司	总经理：廉小强	地址：福州市闽侯县青口镇青口投资区
闽侯县锐龙贸易有限公司	总经理：林志民	地址：闽侯县青口镇宏三村（吉山新村）A座4号楼
福建森通动力机械有限责任公司	总经理：谢知孝	地址：福建省闽侯县经济技术开发区一期（荆溪镇）
闽侯县祥谦宏源新型水泥砖厂	厂长：林文广	地址：闽侯县祥谦镇枕峰工业区（永德吉节能灯厂旁）
福州华科商贸有限公司	总经理：张辰	地址：闽侯县青口镇宏四村马路街50号茂泰花园5#楼305单元
闽侯县金博涂料有限公司	总经理：谢剑锐	地址：闽侯县南通镇罗洲村
闽侯县贝丰工艺品厂	厂长：刘澍晖	地址：闽侯县甘蔗街道墩园洲福州闽豪工艺品有限公司内
闽侯县岐兴农业综合开发有限公司	总经理：朱孟清	地址：闽侯县白沙镇上岐朱厝顶1号
福州闽龙航运有限公司	总经理：张炳坤	地址：闽侯县祥谦镇峡南村道头新村30号
闽侯县大官源农业观光园有限公司	总经理：杨林	地址：闽侯县荆溪镇关中村
福建省闽侯县诚辉食品有限公司	总经理：傅仁锋	地址：福建省闽侯县上街建平村后山61号
福州畅通电子有限公司	总经理：郑棋飞	地址：福州市闽侯县竹岐乡榕东村316国道21公里处
福建巨鑫诚机械制造有限公司	总经理：王永丁	地址：闽侯县荆溪镇永丰村亭下32号
闽侯县瑞虎贸易有限公司	总经理：何淦斌	地址：闽侯县上街镇国宾大道338号英泰第一城B区商住2#楼504单元
闽侯县特尔通玻纤有限公司	总经理：江清?	地址：闽侯县大湖乡珍山村万宝山
闽侯县祥谦峡南道头井水厂	厂长：刘朋团	地址：闽侯县祥谦镇峡南社区原闽江渔网厂旁边
闽侯县喜柏年家具厂	厂长：黄特	地址：闽侯县甘蔗街道青岐村116号
闽侯县旺顺餐饮管理有限公司	总经理：瞿国金	地址：闽侯县甘蔗街道里山前4号
闽侯县十八溪林业专业合作社	联系人：陈祥发	地址：闽侯县南通镇古城村溪东2号
闽侯县商辉工艺品有限责任公司	总经理：郑清?	地址：闽侯县甘蔗街道陈店湖工业区
闽侯县三源生态农业专业合作社	联系人：陈雷鸣	地址：闽侯县竹岐乡源格村
闽侯县三溪口自来水厂	厂长：林文华	地址：闽侯县祥谦镇三溪口村
闽侯县品邑橄榄专业合作社	联系人：程道勇	地址：闽侯县甘蔗街道横屿村118号
闽侯县南屿镇五四果林场	联系人：林钟钦	地址：闽侯县南屿镇芝田村
闽侯县南屿美林工艺品有限公司	总经理：梁永坚	地址：闽侯县南屿镇旗山工业集中区
闽侯县南通镇南港农村客运站	站长：徐瑞前	地址：闽侯县南通镇洲头村通洲路旁
闽侯县共创贸易有限公司	总经理：黄江勇	地址：闽侯县青口镇农光村新城路博雅星城1#楼1层09店面
闽侯县富强海绵有限公司	总经理：周昌华	地址：闽侯县南通镇洲头村东路31号
闽侯县成丰家居制造有限公司	总经理：陈国峰	地址：闽侯县甘蔗青岐村69号
闽侯县宝丰建材有限公司	总经理：林秀萍	地址：闽侯县祥谦镇枕峰村
闽侯陈氏三姐妹婚庆有限公司	总经理：陈夏玉	地址：闽侯县上街镇国宾大道338号英泰第一城B区商住1#楼411单元
福州鑫天科数码喷绘有限公司闽侯分公司	总经理：马云飞	地址：闽侯县甘蔗镇入城路328号
福州旺祺家居用品制造有限公司	总经理：邓立旺	地址：闽侯县鸿尾乡官路村
福州市闽侯县华农餐饮管理有限公司	总经理：林冬冬	地址：闽侯县福泉高速公路闽侯青口服务区B区
福州尚都农业开发有限公司	总经理：王雅斌	地址：闽侯县洋里乡街中路70号
福州上善环保科技有限公司闽侯分公司	总经理：江涛	地址：闽侯县青口镇东台村杨梅山45号
福州聚力新农业发展有限公司	总经理：陈光明	地址：闽侯县南通镇罗洲村南港大桥东侧堤边农场
福州经晟机电有限公司	总经理：林高明	地址：福州市闽侯县荆溪镇荆头村溪头甘洪路南侧（福州德宇电器有限公司内）
福州计联电脑有限公司闽侯分公司	总经理：齐峰	地址：闽侯县上街镇新峰村工贸路沿街商住楼
福州大地春水保技术咨询有限公司	总经理：杨玉清	地址：闽侯县上街镇金屿村工贸路福禄坊18#-111号
福建万能新材料技术有限公司	总经理：林郁亮	地址：闽侯县上街镇科技东路海西高新技术产业园创业大厦A区15层
福建麦特新铝业科技有限公司	总经理：柯东杰	地址：闽侯县青口投资区祥谦镇辅翼村
福建聚全新材料技术有限公司	总经理：朱鹏杰	地址：闽侯县上街镇科技东路海西高新技术产业园创业大厦A区14层
福建捷达工贸有限公司	总经理：李孟达	地址：闽侯县鸿尾乡大模村
福建宏印贸易有限公司	总经理：牟俊先	地址：闽侯县青口镇农光村新城路博雅星城14号楼209单元
福建恒成玻璃有限公司	总经理：于波	地址：闽侯县祥谦峡南村
闽侯县邮政局南通批发市场邮政所	所长：陈雄	地址：闽侯县南通陈厝村海峡农副产品物流中心果品批发市场
闽侯县清心芽菜专业合作社	联系人：陈祖飞	地址：闽侯县南屿镇五都村留臂54号
福州鑫盛宏业工艺品有限公司	总经理：余卫平	地址：闽侯县甘蔗街道蔗街道滨城大道13号1#厂房二层
福州旺隆金属材料有限公司	总经理：郑孝忠	地址：闽侯县青口镇莲峰村工贸大厦
福州群升置业有限公司	总经理：徐步升	地址：闽侯县南屿镇高岐工业小区
闽侯县荆溪化民饮料厂	null	地址：中国 福建 福州市 闽侯县荆溪镇桐口村
闽侯县佳惠食品有限公司	null	地址：中国 福建 福州市 闽侯县荆溪镇溪头村
福建榕诚食品有限公司	总经理：游平	地址：中国 福建 福州市 福建闽侯县铁岭工业集中区
福建省福州洋兴有限公司	null	地址：中国 福建 福州市 福建福州闽侯县洋里乡
闽汇食品有限公司	null	地址：中国 福建 福州市 福建省福州市闽侯县甘蔗?铃工业区第一期甘洪路二号1栋2楼
福州?立莱旅游制品有限公司-技术部	null	地址：中国 福建 福州市 福州市闽侯县上街镇厚美村521号
闽江学院总部	null	地址：中国 福建 福州市 福州市闽侯县上街镇
福州康家名居室内用品有限公司	null	地址：中国 福建 福州市 闽侯县荆溪镇徐家村
林熠（个人会员）	联系人：林熠	地址：中国 福建 福州市 福建省福州市闽侯县上街镇
福州木兰工艺品有限公司	总经理：高云	地址：中国 福建 福州市 福州闽侯县详谦
雅座根雕有限公司	null	地址：中国 福建 福州市 福建省福州市闽侯县南屿镇葛岐村67号
闽侯县仙岑生态农场	null	地址：中国 福建 福州市 闽侯县南屿镇五都村边尾
福州闽侯PVC软胶工艺品厂	null	地址：中国 福建 福州市仓山区 福州市闽侯县
福建省铁锋机械有限公司福州办事处	null	地址：中国 福建 福州市 闽侯县上街镇学园路3号
中诚工艺品有限公司	null	地址：中国 福建 福州市 闽侯县陈店湖工业区8座
陈鸿清（个人会员）	null	地址：中国 福建 福州市 闽侯县南通镇陈厝工业区
福州金华角梳有限公司	null	地址：Nigeria 福建省 福州市 闽侯县袁歧村2号
水脉服饰公司	null	地址：中国 福建 福州市 福建福州闽侯县上街镇上街村丹屿41号
福州市闽侯县精誉工艺品有限公司	null	地址：中国 福建 福州市 闽侯县荆溪镇徐家村工业区
闽侯县南屿浙福明怡工艺品加工场	null	地址：中国 福建 福州市 闽侯县南屿镇芝田村
福州粮食批发交易市场闽健精米厂	null	地址：中国 福建 福州市 福建省福州市闽侯县荆溪镇粮食加工区5座
闽侯县华庆塑料厂	null	地址：中国 福建 福州市 福建省福州市闽侯县洋里乡洋里村街西２４号
赵易蓝（个体经营）	null	地址：中国 福建 福州市 福建省福州市闽侯县上街
福建祥鑫光??能科技有限公司	null	地址：中国 福建 福州市 福建省福州市闽侯县尚干镇蓝脚盛工业区
陈智音（个人）	null	地址：中国 福建 福州市 福州市闽侯县上街镇
福建祥鑫铝业有限公司--销售中心	null	地址：中国 福建 福州市 闽侯县尚干镇蓝脚盛工业区
闽侯县尚干德光五金店	null	地址：中国 福建 福州市 闽侯县尚干镇洋中村
闽侯县青口鑫腾达机械模具加工店	null	地址：中国 福建 福州市 闽侯县青口镇宏四村郑厝尾7号
福州学宾五金机械有限公司	总经理：方金莲	地址：中国 福建 福州市 闽侯县青口镇青口东南汽车城学宾五金机械有限公司
宏新电子公司	null	地址：中国 福建 福州市 福州市闽侯县青口投资区
闽侯县荆溪联强木工机械厂	厂长：徐本銮	地址：中国 福建 福州市 福州市闽侯县荆溪镇大?顶
福建恒嘉环保设备有限公司	null	地址：中国 福建 福州市 闽侯县铁岭工业集中区二号南路
祥鑫光电有限公司	null	地址：中国 福建 福州市 福建省福州市闽侯县尚干镇蓝脚盛工业区
恒信混凝土有限公司	null	地址：中国 福建 福州市 闽侯县
王世开（个人）	null	地址：中国 福建 福州市 闽侯县祥谦镇虎山村
福建省闽侯县天宏输送机.托辊.滚筒.机械加工厂	null	地址：中国 福建 福州市 福建省闽侯县青口镇境上村12号
闽侯县青口安信五金模具加工店	null	地址：中国 福建 福州市 闽侯县青口镇付竹村马路店
?莞市上沙永翔?子?	null	地址：中国 福建 福州市台江区 福州闽侯县南屿镇高岐工业区2栋和4栋
福建柯伊努尔节能路灯有限公司	null	地址：中国 福建 福州市 闽侯县青口开发区柯伊努尔路灯公司
福州淘美居家装	null	地址：中国 福建 福州市 福州市闽侯县上街镇
福州鑫海贸易有限公司	null	地址：中国 福建 福州市 福州市闽侯县青口投资区
闽侯县雅雄防火板厂	null	地址：中国 福建 福州市 闽侯县甘蔗镇山前工业区
闽侯明明工艺厂	null	地址：中国 福建 福州市 闽侯县荆溪镇光明村岭尾34号
江南农业公司	null	地址：中国 福建 福州市 福州市闽侯县洋里镇洋里村41号
福州新捷塑胶有限公司	总经理：詹丽钦	地址：中国 福建 福州市 办事处福州市华林路华林星座12层403 工厂地址：福州市闽侯县上街马保工业区
福州超凡现象热转印制品有限公司	null	地址：中国 福建 福州市 福州市闽侯县荆溪镇西门外厚屿187号
福州顺兴包装印刷品有限公司	null	地址：中国 福建 福州市 福州市闽侯县南屿镇西门工业小区1号
福建兴源森纸业股份有限公司	null	地址：中国 福建 福州市 福建省福州市闽侯县陈店湖工业区
欣彦根雕有限公司	null	地址：中国 福建 福州市 福州市闽侯县上街镇建平村
闽侯县汇家工艺厂	null	地址：中国 福建 福州市 闽侯县白沙镇上寨村原初级中学
闽侯县上街国标絮棉经营部	null	地址：中国 福建 福州市 闽侯县上街镇红丰村邱阳52号
周永燕（个体经营）	联系人：周永燕	地址：中国 福建 福州市 福州市闽侯县上街镇建平村郭氏君诚根雕厂
猫头鹰（福州）日用品有限公司	总经理：薛惠娟	地址：中国 福建 福州市 闽侯县经济技术开发区一期九号中路1号
方孝文（个体经营）	null	地址：中国 福建 福州市 福建省福州市闽侯县上街镇岐安村岐西29号
王佩佩（个体经营）	null	地址：中国 福建 福州市 福建省福州市闽侯县南通镇马腾街中8号
天彩服装针织有限公司	null	地址：中国 福建 福州市台江区 闽侯县甘蔗镇大元村桥
周雪珍（个人）	null	地址：中国 福建 福州市 福建省福州市闽侯县建平村后山001号
文明(个体经营)	null	地址：中国 福建 福州市台江区 福州市闽侯县上街镇大学城福大学生街3号店
黄津（个人会员）	联系人：黄津	地址：中国 福建 福州市 闽侯县甘蔗
闽侯?雅工艺品有限公司	null	地址：中国 福建 福州市 福建省福州市闽侯县甘蔗工业园区
福建意达工艺根雕厂	null	地址：中国 福建 福州市 福建福州闽侯县上街镇
林家胜（个体经营）	null	地址：中国 福建 福州市 福建省福州市闽侯县
金昌松（个人会员）	null	地址：中国 福建 福州市 福建闽侯县上街建平村148号
福建省闽清县华益工艺品有限公司	null	地址：中国 福建 福州市 福州市闽侯县甘蔗街道铁岭工业区1号天工宇诚工艺有限公司
福建省闽侯县干花厂	null	地址：中国 福建 福州市 闽侯县荆溪镇连头村
福州建明树脂工艺品厂	null	地址：中国 福建 福州市 闽侯县荆溪镇古山洲三号
福建闽侯福华工艺品有限公司	null	地址：中国 福建 福州市 福建省闽侯县荆溪工业区
江智思（个体经营）	null	地址：中国 福建 福州市 闽侯县南屿镇南溪村
陈秀琴（个体经营)	null	地址：中国 福建 福州市 闽侯县甘蔗镇80号
福州市益丰源赠品制造有限公司	null	地址：中国 福建 福州市 福州市西门外厚屿187(福州市闽侯县荆溪镇厚屿187号)
高建华（个人）	null	地址：中国 福建 福州市 福建省福州市闽侯县竹岐乡罗洋村洋?30号
福州名旺有限公司	null	地址：中国 福建 福州市 闽侯县
诚志根雕厂	null	地址：中国 福建 福州市 闽侯县上街镇建平村董屿55号
福建新秋龙工艺品厂	null	地址：中国 福建 福州市 福州市闽侯县祥谦工业区
陈赞（个体经营）	联系人：陈赞	地址：中国 福建 福州市 福建省福州市闽侯县建平村
福州市炜辉工艺品公司	总经理：张宗炜	地址：中国 福建 福州市 福建省闽侯县竹歧乡316国道22.7公里处
宋常希（个人会员）	联系人：宋常希	地址：中国 福建 福州市 福建省闽侯县上街镇新洲
斌丽艺雕厂	厂长：吴丽琴	地址：中国 福建 福州市 闽侯县上街建平村
福建闽侯桐均木雕厂	厂长：吴志成	地址：中国 福建 福州市 福州市闽侯县上街镇建平村董屿71号
福州形意坊根雕厂	厂长：姚桂良	地址：中国 福建 福州市 闽侯县上街建平村
闽侯县荆溪龙威沙发加工场	null	地址：中国 福建 福州市 闽侯县荆溪关口村
上海晶雅工艺品有限公司	null	地址：中国 福建 福州市 福建省闽侯县
福建华龙贸易有限公司	null	地址：中国 福建 福州市 闽侯县福建师范大学南区5―2（505）
福州市晋安区博雅工艺品有限公司	总经理：钟宙明	地址：中国 福建 福州市 福建省福州市闽侯县甘蔗镇143号
福州华兴工艺有限公司	null	地址：中国 福建 福州市 闽侯县鸿尾镇
李春生（个体经营）	null	地址：中国 福建 福州市 闽侯县竹岐乡榕西村
福建胜亚模具有限公司	总经理：黄荣光	地址：中国 福建 福州市 福建省闽侯县青口镇杨厝村千家山工业区
福建东亚鼓风机股份有限公司市场部	null	地址：中国 福建 福州市鼓楼区 中国 福建 闽侯县 福州市闽侯县荆溪镇永丰村亭下32号
福州奋达伟业厨房设备有限公司	总经理：龙莉莉	地址：中国 福建 福州市 闽侯县铁岭工业集中区
七四二八工厂工程机械附件厂	null	地址：福建省福州市闽侯县白沙镇埕元村
七四二八厂工程机械附件厂经营部	null	地址：福建省福州市闽侯县白沙镇
福州市闽侯洋里田当格上坪菜果场	null	地址：福建省福州市闽侯县洋里乡田当村
福州石风帆蛇业开发有限公司	null	地址：福建省福州市闽侯县十八重溪第六重
福州上滔花木园艺有限公司	null	地址：福建省福州市闽侯县上街乡厚美村
福州闽溪农业大观园有限公司	总经理：杨武声	地址：福建省福州市闽侯县荆溪镇光明村　　　　法定代表人：
福州闽盛竹草制品有限公司	null	地址：福建省福州市闽侯县上街镇联心村
福州闽侯良存华侨学校	校长：李钟信	地址：福建省福州市闽侯县南屿镇江口村
福州马特俐土特产品有限公司	null	地址：福建省福州市闽侯县甘蔗镇侨园街１号
福州六和机械有限公司	成立日期：2000/12/25	地址：中国 福建 福州市 中国福建福州市闽侯县青口镇白水路
福州路德医疗保健品有限公司甘蔗分公司	总经理：梁春风	地址：福建省福州市闽侯县甘蔗镇入城路１１２号
福州私立光华学校	null	地址：福建省福州市闽侯县祥谦镇山后光华学校
福州市南通洲头龙眼场	联系人：林凤声	地址：福建省福州市闽侯县南通镇洲头村
福州兴汇利装饰材料有限公司	总经理：林爱贞	地址：福建省福州市闽侯县尚干镇福厦路工业区
福州台纽花卉农业有限公司	总经理：綦耀华	地址：福建省福州市闽侯县农业科技园区　　　　法　人：綦耀
福州鞋业联合总厂第七分厂	null	地址：福建省福州市闽侯县甘蔗镇墩园洲５０号
福州藤王娱乐有限公司	null	地址：福建省福州市闽侯县上街镇金屿村
福州田当脐橙种植场	null	地址：福建省福州市闽侯县洋里乡田当村
福州添美艺术发展有限公司	null	地址：福建省福州市闽侯县尚干镇
福州正邦纸品材料有限公司	总经理：薛伟洪	地址：福建省福州市闽侯县上街乡厚美村　　　　法定代表人：薛伟洪
福州正邦熔剂材料有限公司	总经理：李军	地址：福建省福州市闽侯县上街镇厚美村　　　　法定代表人：李军
福州裕盟养殖有限公司	总经理：许春明	地址：福建省福州市闽侯县南屿镇龙泉村　　　　法定代表人：许春明
福州友祥制鞋有限公司	总经理：林聚祥	地址：福建省福州市闽侯县上街镇上街村
福州永昌盛贸易有限公司	总经理：洪	地址：福州市闽侯县甘蔗街道洽埔村洽埔170号
福州雅福摩托车贸易有限公司闽侯分公司	总经理：徐燕贞	地址：福建省福州市闽侯县甘蔗镇入城路
福洲市关西果牧综合试验场	null	地址：福建省福州市闽侯县荆溪镇关西村
甘蔗五福天东饮食店	null	地址：福建省福州市闽侯县甘蔗镇五福村
陶精（福建）实业有限公司	总经理：邱志中	地址：福建省福州市闽侯县青口投资区
南屿镇旗山果场	null	地址：福建省福州市闽侯县南屿镇坎水村石松寺
闽江源达木材加工厂	null	地址：福建省福州市闽侯县闽江乡峡南村公路边
闽候县沿海管防工作委员会办公室	null	地址：福建省福州市闽侯县甘蔗镇交通路2号
闽候县文科学会	null	地址：福建省福州市闽侯县甘蔗县甘蔗镇交通路60号
闽候县食品公司鸿尾食品站	null	地址：福建省福州市闽侯县鸿尾乡石佛头街84号
闽候县上街乡土地管理所	null	地址：福建省福州市闽侯县上街乡金屿村
闽候县农业服务中心	null	地址：福建省福州市闽侯县竹岐乡竹岐村
闽候县理科学会	null	地址：福建省福州市闽侯县甘蔗镇交通路11号
闽候县老龄工作委员会	null	地址：福建省福州市闽侯县甘蔗镇交通路2号
闽候县荆溪地区凤山诗社	null	地址：福建省福州市闽侯县荆溪镇光明村
闽候县华韵书画联谊会	null	地址：福建省福州市闽侯县甘蔗镇交通路2号
闽候县鸿尾金沙水闸管理所	null	地址：福建省福州市闽侯县鸿尾乡　石村
闽候县供销合作社联合社驻榕联购站	null	地址：福建省福州市闽侯县台江区国货路新港商厦四楼
闽候县工程技术管理学会	null	地址：福建省福州市闽侯县甘蔗镇交通路2号
闽候县保密局	null	地址：福建省福州市闽侯县甘蔗镇交通路2号
闽侯振成电木梳有限公司	null	地址：福建省福州市闽侯县荆溪乡关口村
闽侯县住房制度改革领导小组办公室	null	地址：福建省福州市闽侯县甘蔗镇
闽侯县竹岐宗江食杂店G	null	地址：福建省福州市闽侯县竹岐乡白龙村12号
闽侯县竹岐竹编厂	null	地址：福建省福州市闽侯县竹岐街216号
闽侯县竹岐志祥食杂店G	null	地址：福建省福州市闽侯县竹岐乡竹岐街46号
闽侯县竹岐增玉水泥店G	null	地址：福建省福州市闽侯县竹岐乡竹岐街106号
闽侯县竹岐月发食杂店G	null	地址：福建省福州市闽侯县竹岐白龙村
闽侯县竹岐幼芳食杂店G	null	地址：福建省福州市闽侯县竹岐乡榕西村
闽侯县竹岐友谊修理店G	null	地址：福建省福州市闽侯县竹岐乡汶洲村
闽侯县竹岐永飞食杂店	null	地址：福建省福州市闽侯县竹岐乡榕西村
闽侯县竹岐燕玉食杂店G	null	地址：福建省福州市闽侯县竹岐乡竹岐街
闽侯县竹岐学杰电机修理店G	null	地址：福建省福州市闽侯县竹岐乡竹岐街
闽侯县竹岐星光竹编厂Ｇ	null	地址：福建省福州市闽侯县竹岐乡竹岐西尾128号
闽侯县竹岐祥龙竹编厂	null	地址：福建省福州市闽侯县竹岐乡竹岐街216号
闽侯县竹岐乡竹岐村合作基金会	null	地址：福建省福州市闽侯县竹岐乡竹岐村
闽侯县竹岐乡新华日杂店	null	地址：福建省福州市闽侯县竹岐乡竹岐街111号
闽侯县竹岐乡乡镇企业办公室	null	地址：福建省福州市闽侯县竹岐乡竹岐街１２５号
闽侯县竹岐乡社会治安综合治理委员会办公室	null	地址：福建省福州市闽侯县竹岐乡竹岐街１２５号
闽侯县竹岐乡林果牧实验场	null	地址：福建省福州市闽侯县竹岐乡竹西村东岛
闽侯县竹岐乡劳动就业服务站	null	地址：福建省福州市闽侯县竹岐乡竹岐街125号
闽侯县竹岐乡计生服务所	null	地址：福建省福州市闽侯县竹岐乡竹岐街１２５号
闽侯县竹岐乡火炬竹木藤制品厂	厂长：张怀林	地址：福建省福州市闽侯县竹岐乡火炬村彭中队
闽侯县竹岐乡春风养殖场G	null	地址：福建省福州市闽侯县竹岐乡南洋当
闽侯县竹岐乡安置灾民住宅小区建设工程指挥部	老板：肖本工	地址：福建省福州市闽侯县竹岐乡政府
闽侯县竹岐文英食杂店G	null	地址：福建省福州市闽侯县竹岐乡竹岐街
闽侯县竹岐为标食什店G	null	地址：福建省福州市闽侯县竹岐乡榕中村
闽侯县竹岐同德食杂店G	null	地址：福建省福州市闽侯县竹岐乡白龙村
闽侯县竹岐塑革厂	厂长：林志胜	地址：福建省福州市闽侯县竹岐乡楼东村１２３号
闽侯县竹岐苏洋建金翻砂场	null	地址：福建省福州市闽侯县竹岐乡苏洋村
闽侯县竹岐水文站	null	地址：福建省福州市闽侯县竹岐乡竹岐街
闽侯县竹岐水利水电技术服务队	null	地址：福建省福州市闽侯县竹岐乡竹岐街１２５号
闽侯县竹岐双丰食杂店	老板：林发涛	地址：福建省福州市闽侯县竹岐乡竹岐村２３号
闽侯县竹岐书诚农具修理店	null	地址：福建省福州市闽侯县竹岐乡白龙村
闽侯县竹岐尚柱食什店G	null	地址：福建省福州市闽侯县竹岐乡榕东村
闽侯县竹岐榕中英良食杂店G	null	地址：福建省福州市闽侯县竹岐乡榕中村
闽侯县竹岐榕西振东食杂店G	null	地址：福建省福州市闽侯县竹岐乡榕西村
闽侯县竹岐榕西西京食杂店G	null	地址：福建省福州市闽侯县竹岐榕西136号
闽侯县竹岐榕西礼旺食杂店G	null	地址：福建省福州市闽侯县竹岐榕西村276号
闽侯县竹岐榕西建童食杂店G	null	地址：福建省福州市闽侯县竹岐乡榕西村
闽侯县竹岐榕岸日杂店G	null	地址：福建省福州市闽侯县竹岐乡榕西村
闽侯县竹岐明杜食杂店G	null	地址：福建省福州市闽侯县竹岐榕东村
闽侯县竹岐美英食杂店G	null	地址：福建省福州市闽侯县竹岐乡竹岐街
闽侯县竹岐林羽农机修理店G	null	地址：福建省福州市闽侯县竹岐乡竹岐街206号
闽侯县竹岐林萍电工器材店G	null	地址：福建省福州市闽侯县竹岐乡竹岐街125号
闽侯县竹岐联丰养殖场	null	地址：福建省福州市闽侯县竹岐乡竹岐街
闽侯县竹岐联丰蔬菜基地	联系人：郑少平	地址：福建省福州市闽侯县竹岐乡榕中村
闽侯县竹岐丽英食杂店G	null	地址：福建省福州市闽侯县竹岐乡竹岐街110号
闽侯县竹岐宽炎汽车修理店G	null	地址：福建省福州市闽侯县竹岐乡竹岐街
闽侯县竹岐机动车电器电瓶修理店G	null	地址：福建省福州市闽侯县竹岐乡竹岐街
闽侯县竹岐惠英食杂店G	null	地址：福建省福州市闽侯县竹岐乡竹岐街176号
闽侯县竹岐合作总店	老板：林斯波	地址：福建省福州市闽侯县竹岐乡竹岐街４１号
闽侯县竹岐合作店竹岐分店	null	地址：福建省福州市闽侯县竹岐乡竹岐村36号
闽侯县竹岐合作店榕中分店	null	地址：福建省福州市闽侯县竹岐乡榕中村
闽侯县竹岐合作店榕东分店	null	地址：福建省福州市闽侯县竹岐乡榕东村
闽侯县竹岐国金无损检测电器服务部	null	地址：福建省福州市闽侯县竹岐乡榕东村
闽侯县竹岐福兴食杂店G	null	地址：福建省福州市闽侯县竹岐乡西村
闽侯县竹岐福盛小百店G	null	地址：福建省福州市闽侯县竹岐乡竹岐街108号
闽侯县竹岐福美沙发店G	null	地址：福建省福州市闽侯县竹岐乡榕西村
闽侯县竹岐大霖食杂店G	null	地址：福建省福州市闽侯县竹岐乡榕中村8号
闽侯县竹岐春香食杂店G	null	地址：福建省福州市闽侯县竹岐乡竹岐街218号
闽侯县竹岐春风为宋食杂店G	null	地址：福建省福州市闽侯县竹岐乡春风村
闽侯县竹岐传霖修理自行车店G	null	地址：福建省福州市闽侯县竹岐乡竹岐街57号
闽侯县竹岐草竹编织厂	null	地址：福建省福州市闽侯县竹岐乡竹岐街２１８号
闽侯县竹岐财霖食杂店G	null	地址：福建省福州市闽侯县竹岐乡榕西村
闽侯县竹岐白龙如水食杂店G	null	地址：福建省福州市闽侯县竹岐乡白龙村
闽侯县竹岐白龙村竹编厂	null	地址：福建省福州市闽侯县竹岐乡白龙村
闽侯县中榕环保工程有限公司	总经理：陈建星	地址：福建省福州市闽侯县祥谦镇中院村院前
闽侯县植物医院上街分院	null	地址：福建省福州市闽侯县上街镇新商业街
闽侯县南屿志强松脂加工场	null	地址：福建省福州市闽侯县南屿镇南前
闽侯县南屿镇逸平水库工程指挥部	null	地址：福建省福州市闽侯县南屿镇人民政府内
闽侯县南屿镇秀英食杂摊	联系人：江秀英	地址：福建省福州市闽侯县南屿镇南井村上井１２６号
闽侯县南屿镇五都村经济合作社	联系人：阮孟林	地址：福建省福州市闽侯县南屿镇五都村
闽侯县南屿镇桐南山兜村果树开发基地	null	地址：福建省福州市闽侯县南屿镇桐南山兜村
闽侯县南屿镇企业管理站	null	地址：福建省福州市闽侯县南屿镇水西林１３号
闽侯县南屿镇农村合作基金会	联系人：宋信昌	地址：福建省福州市闽侯县南屿镇南屿街
闽侯县南屿镇六十份翻砂厂	null	地址：福建省福州市闽侯县南屿镇六十份村
闽侯县南屿镇柳浪村老人会	null	地址：福建省福州市闽侯县南屿镇柳浪村
闽侯县南屿镇柳浪村经济合作社	null	地址：福建省福州市闽侯县南屿镇柳浪村
闽侯县南屿镇离退休干部管理办公室	联系人：陈宝盛	地址：福建省福州市闽侯县南屿镇电影院二楼
闽侯县南屿镇劳动就业服务站	null	地址：福建省福州市闽侯县南屿镇企业办
闽侯县南屿镇开发办公室	联系人：江道镜	地址：福建省福州市闽侯县南屿镇水西村１３号
闽侯县南屿镇江口玉英粮复制品加工厂G	null	地址：福建省福州市闽侯县南屿镇江口村九石112号
闽侯县南屿镇环球五交店G	null	地址：福建省福州市闽侯县南屿镇南屿街
闽侯县南屿镇窗厦抽水机站	null	地址：福建省福州市闽侯县南屿镇窗厦村
闽侯县南屿玉风服装小百摊G	null	地址：福建省福州市闽侯县南屿镇南屿街
闽侯县南屿永兴煤炭店G	null	地址：福建省福州市闽侯县南屿镇南屿街
闽侯县南屿义成食杂店G	null	地址：福建省福州市闽侯县南屿镇南屿街
闽侯县南屿铁器厂	null	地址：福建省福州市闽侯县南屿镇新桥头
闽侯县南屿水产场	联系人：周宗棠	地址：福建省福州市闽侯县南屿镇六十份三八场
闽侯县南屿守惠材店G	null	地址：福建省福州市闽侯县南屿镇柳厝街
闽侯县南屿市场炳正食杂店G	null	地址：福建省福州市闽侯县南屿镇南屿市场
闽侯县南屿世同食杂店G	null	地址：福建省福州市闽侯县南屿镇民主街5号
闽侯县南屿时霖水产品店G	null	地址：福建省福州市闽侯县南屿镇南屿街
闽侯县南屿赛娟国产化纤布摊G	null	地址：福建省福州市闽侯县南屿镇市场
闽侯县南屿如亮食杂店	老板：陈如亮	地址：福建省福州市闽侯县南屿镇南旗村
闽侯县南屿浦泉漆筷加工场	null	地址：福建省福州市闽侯县南屿镇龙泉村哺口
闽侯县南屿蓬莱良浩水库工程指挥部	null	地址：福建省福州市闽侯县南屿镇水西林13号
闽侯县南屿龙泉特艺厂	null	地址：福建省福州市闽侯县南屿镇龙泉村
闽侯县南屿粮食管理站	null	地址：福建省福州市闽侯县南屿镇水西林
闽侯县南屿立春食杂店G	null	地址：福建省福州市闽侯县南屿镇南江村
闽侯县南屿黎明家具场	null	地址：福建省福州市闽侯县南屿镇村下村
闽侯县南屿金章服装摊	联系人：金章	地址：福建省福州市闽侯县南屿镇市场
闽侯县南屿金星五金日杂店G	null	地址：福建省福州市闽侯县南屿镇农贸市场
闽侯县南屿金涛海产摊	null	地址：福建省福州市闽侯县南屿镇南屿市场
闽侯县南屿江口棉带厂	null	地址：福建省福州市闽侯县南屿镇江口村过透
闽侯县南屿江口金妹食杂店G	null	地址：福建省福州市闽侯县南屿镇江口村
闽侯县南屿江口建銮绒织厂	厂长：宋建銮	地址：福建省福州市闽侯县南屿镇江口村青洲３１号
闽侯县南屿江口纺织二厂	null	地址：福建省福州市闽侯县南屿镇江口村九石
闽侯县南屿合作总店	null	地址：福建省福州市闽侯县南屿镇南屿街
闽侯县南屿丹红冷作厂G	null	地址：福建省福州市闽侯县南屿镇尧沙村月山106号
闽侯县南屿村下工艺加工厂	null	地址：福建省福州市闽侯县南屿镇村下村
闽侯县南屿步榕食杂店G	null	地址：福建省福州市闽侯县南屿镇南屿街桥下
闽侯县南屿宝娇布摊	联系人：姚宝娇	地址：福建省福州市闽侯县南屿镇农贸市场
闽侯县南通祚旺加工场	联系人：郭祚旺	地址：福建省福州市闽侯县南通镇罗州新桥
闽侯县南通镇泽洋村盛美联队	队长：张钿泉	地址：福建省福州市闽侯县南通镇泽洋村盛美
闽侯县南通镇泽苗村泽道老人会	null	地址：福建省福州市闽侯县南通泽苗村
闽侯县南通镇新岐村经济合作社	联系人：林从华	地址：福建省福州市闽侯县南通镇新岐村
闽侯县南通镇陈厝村经济合作社	联系人：林其坦	地址：福建省福州市闽侯县南通镇陈厝村
闽侯县南通兆帜五交店	null	地址：福建省福州市闽侯县南通镇南通街131号
闽侯县南通泽苗大队人寿互助会	null	地址：福建省福州市闽侯县南通镇泽苗村
闽侯县南通泽江张氏宗祠理事会	null	地址：福建省福州市闽侯县南通镇泽苗村
闽侯县南通云彪修理店	null	地址：福建省福州市闽侯县南通街56号
闽侯县南通仰清五金冷作店	null	地址：福建省福州市闽侯县南通镇街尾
闽侯县南通亚男农机配件店	null	地址：福建省福州市闽侯县南通镇南通街
闽侯县南通秀华布摊	null	地址：福建省福州市闽侯县南通镇南通街市场
闽侯县南通兴隆物资商行竹木加工场	联系人：陈珍	地址：福建省福州市闽侯县南通镇陈厝村公路边
闽侯县南通兴隆物资商行	联系人：陈东光	地址：福建省福州市闽侯县南通镇陈厝街东40号
闽侯县南通乡善春食杂店	null	地址：福建省福州市闽侯县南通镇南通村
闽侯县南通先锋特艺厂	null	地址：福建省福州市闽侯县南通镇锋古城
闽侯县南通淑兰日杂店	null	地址：福建省福州市闽侯县南通镇南通街
闽侯县南通寿忠木线加工场G	null	地址：福建省福州市闽侯县南通镇泽苗文化宫边
闽侯县南通寿清草索加工场	联系人：张寿清	地址：福建省福州市闽侯县南通镇泽苗村
闽侯县南通生春汽车修理店	null	地址：福建省福州市闽侯县南通镇南通街
闽侯县南通瑞炳木线条加工场	null	地址：福建省福州市闽侯县南通镇马腾村
闽侯县南通荣贞服装摊	null	地址：福建省福州市闽侯县南通镇
闽侯县南通荣光食杂店	null	地址：福建省福州市闽侯县南通南通街
闽侯县南通仁发食杂店	null	地址：福建省福州市闽侯县南通镇南通街
闽侯县南通桥街农械厂	null	地址：福建省福州市闽侯县南通镇桥街村
闽侯县南通排涝站	站长：A	地址：福建省福州市闽侯县南通镇文山
闽侯县南通农机修理店	null	地址：福建省福州市闽侯县南通镇街31号
闽侯县南通明光草竹编织厂	null	地址：福建省福州市闽侯县南通镇南通街
闽侯县南通美龙音箱制造厂	厂长：陈培龙	地址：福建省福州市闽侯县南通镇陈厝村卫星21号
闽侯县南通罗洲竹草制品厂	null	地址：福建省福州市闽侯县南通镇罗洲村
闽侯县南通罗洲竹编二厂	null	地址：福建省福州市闽侯县南通镇罗洲村
闽侯县南通罗洲沙石场	null	地址：福建省福州市闽侯县南通镇罗洲村方庄
闽侯县南通粮食管理站	null	地址：福建省福州市闽侯县南通镇苏洲桥苏坂东路４２号
闽侯县南通礼桂木筷加工场G	null	地址：福建省福州市闽侯县南通镇瓜山村
闽侯县南通兰英食杂店	null	地址：福建省福州市闽侯县南通镇南通街
闽侯县南通金财食杂店	null	地址：福建省福州市闽侯县南通街
闽侯县南通伙明食杂店	null	地址：福建省福州市闽侯县南通镇南通街
闽侯县南通惠珍小百店	null	地址：福建省福州市闽侯县南通镇南通街
闽侯县南通华英日杂店	null	地址：福建省福州市闽侯县南通镇南通街30号
闽侯县南通合作总店	null	地址：福建省福州市闽侯县南通镇南通街
闽侯县南通国斌五金电器店	null	地址：福建省福州市闽侯县南通街51号
闽侯县南通冠铣食杂店	null	地址：福建省福州市闽侯县南通镇泽洋村
闽侯县南通古城特艺厂	null	地址：福建省福州市闽侯县甘蔗镇甘蔗下井巷25号
闽侯县南通古城工艺漆筷厂G	null	地址：福建省福州市闽侯县南通镇古城村周厝里1号
闽侯县南通工艺竹编厂	null	地址：福建省福州市闽侯县南通镇南通街
闽侯县南通福新甲壳加工场	联系人：林峰	地址：福建省福州市闽侯县南通镇新岐村
闽侯县南通德美塑料袋加工厂	null	地址：福建省福州市闽侯县南通镇银安村
闽侯县南通丹红食杂店	null	地址：福建省福州市闽侯县南通镇苏坂
闽侯县南通陈云食杂店	null	地址：福建省福州市闽侯县南通镇街道
闽侯县南通陈强农机修理店	null	地址：福建省福州市闽侯县南通镇南通街105号
闽侯县南通超勇日杂店	null	地址：福建省福州市闽侯县南通镇南通街
闽侯县南通爱芳日杂店	null	地址：福建省福州市闽侯县南通镇南通新街
闽侯县南港日新针纺厂	null	地址：福建省福州市闽侯县南屿镇江口九石
闽侯县闽星溶剂材料厂	null	地址：福建省福州市闽侯县荆溪镇厚屿村98号
闽侯县闽敏轻工制品厂	null	地址：福建省福州市闽侯县甘蔗镇墩园洲55号
闽侯县闽江南岸堤路工程建设指挥部	老板：陈存枫	地址：福建省福州市闽侯县上街镇侨联大楼二层
闽侯县杨飞木业有限公司	总经理：杨明熹	地址：福建省福州市闽侯县荆溪镇港头村横歧
闽侯县闽龙空心砖厂	厂长：林挺煊	地址：福建省福州市闽侯县南屿镇南井村
闽侯县廷坪乡赤坑村经济合作社	联系人：胡礼福	地址：福建省福州市闽侯县廷坪乡赤坑村
闽侯县廷坪乡文山岗村经济合作社	联系人：张贤义	地址：福建省福州市闽侯县廷坪乡文山岗村
闽侯县大兴木业有限公司	总经理：胡新平	地址：福建省福州市闽侯县荆溪镇溪下村
闽侯县丹光汽车租赁有限公司	总经理：张丹光	地址：福建省福州市闽侯县青口镇前街村
闽侯县旭祥新型砖厂	厂长：潘志光	地址：福建省福州市闽侯县南通镇陈厝村洲尾自然村
闽侯县龙祥岛龙翔生态农业开发有限公司	总经理：江小珊	地址：福建省福州市闽侯县祥谦镇禄家村
闽侯县桐口永顺石料场	联系人：陈兴标	地址：福建省福州市闽侯县荆溪镇桐口工区牛坑
闽侯县新和木业有限公司	总经理：程文?	地址：福建省福州市闽侯县荆溪镇港头村横岐
闽侯县文辉渔具厂	厂长：陈文	地址：福建省福州市闽侯县南通镇南通街
闽侯县东德木业有限公司	总经理：林文东	地址：福建省福州市闽侯县荆溪镇港头村岭头
闽侯县三联木业有限公司	总经理：林一金	地址：福建省福州市闽侯县荆溪港头村连头
闽侯县鑫旺木业有限公司	总经理：杨东升	地址：福建省福州市闽侯县荆溪镇港头村横岐
闽侯县永达木业有限公司	总经理：杨新东	地址：福建省福州市闽侯县荆溪镇港头村横岐
闽侯县廷坪乡罗桥村经济合作社	联系人：陈维荣	地址：福建省福州市闽侯县廷坪乡罗桥村
闽侯县廷坪乡石洋村经济合作社	联系人：郑振桥	地址：福建省福州市闽侯县廷坪乡石洋村
闽侯县宇华木业有限公司	总经理：程勇志	地址：福建省福州市闽侯县荆溪镇港头村
闽侯县秋泉木业有限公司	总经理：潘建华	地址：福建省福州市闽侯县荆溪镇港头村白头
福州新丰建材有限公司闽侯分公司	总经理：陈柏青	地址：福建省福州市闽侯县竹岐乡榕岸村
福建华发建材有限公司	总经理：郑玉爱	地址：福建省福州市闽侯县南屿镇双龙村后尾洲
福建奇东电线电缆有限公司	总经理：黄启寿	地址：中国 福建 福州市 闽侯县铁岭工业集中区一期九号中路10号（期货、和卖发票的勿扰!!!）
福建省闽侯县建兴木业有限公司	总经理：陈健	地址：福建省福州市闽侯县荆溪镇港头村连头
福州鑫峰服装有限公司	总经理：邹训友	地址：福建省福州市闽侯县荆溪镇关口村１号
贝奇（福建）食品有限公司	总经理：王永新	地址：福建省福州市闽侯县铁岭工业集中区
福州市闽侯县上街龙寿汽配五金厂	厂长：赵家光	地址：福建省福州市闽侯县上街镇沙堤村
福州市闽侯县青口福泰福利企业公司酒厂	厂长：张依熙	地址：福建省福州市闽侯县青口镇庄头村
福州市闽侯县南屿高岐油毡厂	厂长：唐一峰	地址：福建省福州市闽侯县南屿镇高岐村
福州市闽侯县开思网宇新空间网吧	联系人：林若凡	地址：福建省福州市闽侯县上街镇美岐村美前７４号
贝奇（福建）饮料有限公司	总经理：王永新	地址：福建省福州市闽侯县铁岭工业集中区
福州市闽侯县江口群益织布厂	厂长：宋艳辉	地址：福建省福州市闽侯县南屿镇江口村青洲6号
福州市闽侯县通亚建材有限公司	总经理：陈择锐	地址：福建省福州市闽侯县祥谦镇枕峰码头
福州市闽侯县锦囊文化传媒有限公司	总经理：温瑞霖	地址：福建省福州市闽侯县上街镇建平村博仕后家园１０座１０４
福州市闽侯春晖农业开发有限公司	总经理：兰得晖	地址：福建省福州市闽侯县南屿镇元峰村水闸边
闽侯县鸿光木业有限公司	总经理：程开枝	地址：福建省福州市闽侯县荆溪镇港头村
闽侯县顺旺木业有限公司	总经理：林文诚	地址：福建省福州市闽侯县荆溪镇港头村岭头
闽侯县青口新城物业管理有限公司	总经理：施遵枝	地址：福建省福州市闽侯县青口镇商贸街
闽侯县竹岐大龙丰饲料有限公司	总经理：朱宗流	地址：福建省福州市闽侯县竹岐乡白龙村
闽侯县清隆木业有限公司	总经理：潘云清	地址：福建省福州市闽侯县荆溪镇港头村白头
闽侯县永记胶合板有限公司	总经理：叶孝永	地址：福建省福州市闽侯县荆溪镇港头村１１１号
闽侯县廷坪乡黄埔村经济合作社	联系人：肖诗设	地址：福建省福州市闽侯县廷坪乡黄埔村
闽侯县廷坪乡曹地村经济合作社	联系人：周乃红	地址：福建省福州市闽侯县廷坪乡曹地村
闽侯县廷坪乡广坪村经济合作社	联系人：陈克快	地址：福建省福州市闽侯县廷坪乡广坪村
闽侯县文化行业协会	联系人：陈光耀	地址：福建省福州市闽侯县甘蔗镇街心路文博大楼四楼
闽侯县鸿尾乡元口村经济合作社	联系人：吴大云	地址：福建省福州市闽侯县鸿尾乡元口村
闽侯县青口众鑫幼儿园	联系人：陈丽英	地址：福建省福州市闽侯县青口镇西台村
闽侯县霖杰木业有限公司	总经理：林文杰	地址：福建省福州市闽侯县荆溪镇港头村岭头
闽侯县金华木业有限公司	总经理：杨依科	地址：福建省福州市闽侯县荆溪镇港头村横歧
闽侯县通盛木业有限公司	总经理：叶鼎明	地址：福建省福州市闽侯县荆溪镇港头村白头
闽侯县盛达包装品有限公司	总经理：施朝春	地址：福建省福州市闽侯县青口投资区汽配城
闽侯县甘蔗培英幼儿园	联系人：张琳英	地址：福建省福州市闽侯县甘蔗镇交通路２５号
闽侯县义和模具机械有限公司	总经理：陈雪秋	地址：福建省福州市闽侯县青口镇大义坊口村
福州绕城高速公路（闽侯段）征地拆迁指挥部	老板：陈源	地址：福建省福州市闽侯县荆溪镇
福州绕城高速公路（闽侯荆溪段）征地拆迁指挥部	老板：林炳	地址：福建省福州市闽侯县荆溪镇政府内
福州绕城高速公路（闽侯上街段）征地拆迁指挥部	老板：林荫	地址：福建省福州市闽侯县上街镇金桥村
闽侯县上街金豆幼儿园	联系人：金爱钦	地址：福建省福州市闽侯县上街新州村
闽侯县榕森人造板有限公司	总经理：潘东生	地址：福建省福州市闽侯县荆溪镇港头村白头
闽侯县洋里乡梧溪村经济合作管理委员会	联系人：余须春	地址：福建省福州市闽侯县洋里乡梧溪村
闽侯县日达车辆维修有限公司	总经理：叶晨	地址：福建省福州市闽侯县青口镇大义后街３号
闽侯县廷坪乡西坑村经济合作社	联系人：陈学柳	地址：福建省福州市闽侯县廷坪乡西坑村
闽侯县廷坪乡蕉溪村经济合作社	联系人：李友贤	地址：福建省福州市闽侯县廷坪乡蕉溪村
闽侯县廷坪乡流源村经济合作社	联系人：方如英	地址：福建省福州市闽侯县廷坪乡流源村
闽侯县安居木业有限公司	总经理：陈建安	地址：福建省福州市闽侯县南通镇文山村
闽侯县圣丰木业有限公司	总经理：徐建生	地址：福建省福州市闽侯县荆溪镇徐家村
闽侯县上街文明村幼儿园	联系人：黄仙明	地址：福建省福州市闽侯县上街镇红峰沙墩村内
闽侯县上街慈爱幼儿园	联系人：林玉	地址：福建省福州市闽侯县上街红峰台北新村
闽侯县鑫辉建材贸易有限公司	总经理：刘明团	地址：福建省福州市闽侯县祥谦镇峡南村２号３０２单元
闽侯茂兴家具有限公司	总经理：林大波	地址：福建省福州市闽侯县祥谦镇枕峰村
闽侯县秋宏食品有限公司	总经理：程永秋	地址：福建省福州市闽侯县荆溪镇关西村
闽侯县三闽木业有限公司	总经理：冯为灼	地址：福建省福州市闽侯县荆溪镇港头村连头
福建省龙发米业有限公司	总经理：李发水	地址：福建省福州市闽侯县荆溪镇甘洪路粮食批发市场加工区６号
闽侯县甘蔗由先幼儿园	联系人：强锦惠	地址：福建省福州市闽侯县甘蔗五福巷２０号
闽侯县彩虹木业有限公司	总经理：杨宝生	地址：福建省福州市闽侯县荆溪镇港头村横岐
闽侯县廷坪乡岩头村经济合作社	联系人：肖诗培	地址：福建省福州市闽侯县廷坪乡岩头村
闽侯县城关拆迁工程处	联系人：洪华	地址：福建省福州市闽侯县甘蔗镇校园路１２９号
福建金亿通特种电缆实业发展有限公司	总经理：严先生	地址：福建省福州市闽侯县祥青龙泰工业城
闽侯县绿色通道培训中心	联系人：陈建芳	地址：福建省福州市闽侯县上街镇中美村洋中厝
闽侯县鸿尾晨曦幼儿园	联系人：张秀萍	地址：福建省福州市闽侯县鸿尾石佛头街新市场内
闽侯县金友木业有限公司	总经理：潘友清	地址：福建省福州市闽侯县荆溪镇港头村
闽侯县榕嘉华食品有限公司	总经理：林祥敢	地址：福建省福州市闽侯县竹岐乡榕东村２９号
闽侯县文林家政服务有限公司	总经理：周香珠	地址：福建省福州市闽侯县上街镇上街村
闽侯县成安纸箱包装有限公司	总经理：陈安	地址：福建省福州市闽侯县南通镇文山村
闽侯县廷坪乡后溪村经济合作社	联系人：林维钱	地址：福建省福州市闽侯县廷坪乡后溪村
闽侯县兴旗建材贸易有限公司	总经理：林明	地址：福建省福州市闽侯县南屿镇南前村
闽侯县鸿尾乡大罕村经济合作社	联系人：邓金榕	地址：福建省福州市闽侯县鸿尾乡大罕村
闽侯县大湖乡双溪村经济合作管理委员会	联系人：林依?	地址：福建省福州市闽侯县大湖乡双溪村
福建永辉现代农业发展有限公司	总经理：张轩松	地址：福建省福州市闽侯县上街镇金屿村３１６国道北侧
福州市闽侯县甘蔗镇五福造纸厂	厂长：程文彬	地址：福建省福州市闽侯县甘蔗镇五福村
福州市闽侯广顺台车修造厂	厂长：郑强	地址：福建省福州市闽侯县荆溪镇（福建八闽汽车总厂内）
福建省闽侯县新嘉顺服装有限公司	总经理：陈香金	地址：福建省福州市闽侯县荆溪镇徐家村荆山境
福建省闽侯县明星服饰手套有限公司	总经理：宋亮明	地址：福建省福州市闽侯县南屿镇
福建省闽侯葡京食品有限公司	总经理：吴兴武	地址：福建省福州市闽侯县铁岭工业集中区
福建省闽侯县飞燕木业有限公司	总经理：潘起升	地址：福建省福州市闽侯县荆溪镇港头村
闽侯县绿洋农业开发综合场	联系人：周而学	地址：福建省福州市闽侯县洋里乡刘洋村
闽侯县诚意酒店管理有限公司	总经理：林新	地址：福州市闽侯县甘蔗街道甘洲路39号
福建省闽侯县鸿川木业有限公司	总经理：杨林	地址：福建省福州市闽侯县荆溪镇港头村横歧
闽侯县隆辉木业有限公司	总经理：杨善秋	地址：福建省福州市闽侯县荆溪镇港头村横歧
福建省闽侯县农兴饲料有限公司	总经理：林存波	地址：福建省福州市闽侯县祥谦镇兰圃工业区
福建三盛房地产开发有限公司闽侯分公司	总经理：段剑熹	地址：福建省福州市闽侯县南屿镇高岐村
闽侯县荆溪镇广播电视站	null	地址：福建省福州市闽侯县荆溪镇
闽侯县鸿尾乡埕头广播电视站	null	地址：福建省福州市闽侯县鸿尾乡埕头电视站
闽侯县尚干镇广播电视站	站长：郭延辉	地址：福建省福州市闽侯县尚干镇政府内
福建京华乡村俱乐部有限公司	总经理：壬为华	地址：福建省福州市闽侯县南通镇古城村
闽侯审计师事务所	null	地址：福建省福州市闽侯县甘蔗镇街心路３１号
福州田园乡村俱乐部有限公司	总经理：梁榕	地址：福建省福州市闽侯县上街　　　　　　　　法定代表人：梁榕
闽侯县农村社会养老保险闽江管理站	站长：叶建彪	地址：福建省福州市闽侯县闽江乡峡南村后湾６号
闽侯县农村社会养老保险南通镇管理站	null	地址：福建省福州市闽侯县南通镇南通街１０８号
闽侯县农村社会养老保险白沙管理站	null	地址：福建省福州市闽侯县白沙镇政府机关内
闽侯县农村社会养老保险青口镇管理站	null	地址：福建省福州市闽侯县青口镇青口村
闽侯县电影公司县城影剧院	null	地址：福建省福州市闽侯县甘蔗镇街心路１３４号
闽侯县农村社会养老保险竹岐管理站	null	地址：福建省福州市闽侯县竹岐乡竹岐街１２５号
闽侯县医疗保险制度改革工作领导小组办公室	联系人：林炳光	地址：福建省福州市闽侯县甘蔗镇
闽侯县农村社会养老保险公司	null	地址：福建省福州市闽侯县甘蔗镇
闽侯县天天美食城	null	地址：福建省福州市闽侯县甘蔗镇大元村程天淦大楼
闽侯县甘蔗川三海鲜酒楼	null	地址：福建省福州市闽侯县甘蔗镇街心路155号
闽侯县南屿锦江饭店	null	地址：福建省福州市闽侯县南屿镇旗顶尾新村
闽侯县甘蔗林影咖啡屋	联系人：林影	地址：福建省福州市闽侯县甘蔗镇街心路６６号
闽侯县甘蔗日月星酒楼	联系人：林夏荣	地址：福建省福州市闽侯县甘蔗镇８１８西路１３５号
闽侯县甘蔗嬴洲城饭店	null	地址：福建省福州市闽侯县甘蔗镇街心路186号
闽侯县南屿新世纪综合酒楼	null	地址：福建省福州市闽侯县南屿镇南屿街28号
闽侯县人民政府招待所工会委员会	联系人：洪茂秋	地址：福建省福州市闽侯县甘蔗镇街心路１６２号
闽侯县白沙永平旅社G	null	地址：福建省福州市闽侯县白沙镇安平路41号
闽侯县食品公司招待所	null	地址：福建省福州市闽侯县甘蔗镇街心路１０６号
福州知音山庄有限责任公司	null	地址：福建省福州市闽侯县南通十八重溪
闽侯县顺丰饮食服务有限公司	总经理：林少庄	地址：福建省福州市闽侯县闽江乡峡南村
闽侯县人民政府招待所	所长：陈泽荣	地址：福建省福州市闽侯县甘蔗镇街心路１６２号
闽侯县上街镇省委迎宾馆征地办公室	null	地址：福建省福州市闽侯县上街镇政府大院内
福建省闽侯宾馆	联系人：许春用	地址：福建省福州市闽侯县甘蔗镇校园路１４９号
闽侯县甘蔗朝光运输户G	null	地址：福建省福州市闽侯县甘蔗镇山前村里山前49号
闽侯县祥谦胜利运输队	null	地址：福建省福州市闽侯县祥谦乡岐尾村
闽侯县白沙镇溪头村（朝良运输户）	联系人：王朝良	地址：福建省福州市闽侯县白沙镇溪头村
闽侯县白沙德标装卸运输队G	null	地址：福建省福州市闽侯县白沙镇火车路
闽侯县荆溪兴运运输队	null	地址：福建省福州市闽侯县荆溪镇厚屿村
闽侯县甘蔗道森运输户G	null	地址：福建省福州市闽侯县大元巷78号
福建省莆田市糖酒副食品公司枕峰仓库	null	地址：福建省福州市闽侯县祥谦乡枕峰村食糖仓库
闽侯县闽福仓储服务有限公司	总经理：张德海	地址：福建省福州市闽侯县闽江乡峡南村
福建省农资仓储中心	null	地址：福建省福州市闽侯县荆溪镇杜乌
闽侯县洋里恒隆汽车运输队	队长：杨品慈	地址：福建省福州市闽侯县洋里乡洋里村
福建省闽侯县邮电局上街邮电支局	null	地址：福建省福州市闽侯县上街镇商业街
福建省闽侯县邮电局廷坪邮电支局	null	地址：福建省福州市闽侯县廷坪乡街心路５号
福建省闽侯县邮电局祥谦邮电支局	null	地址：福建省福州市闽侯县祥谦镇祥谦路８４号
福建省闽侯县邮电局洋里邮电支局	null	地址：福建省福州市闽侯县洋里乡花桥村２４号
福建省闽侯县邮电局鸿尾支局	null	地址：福建省福州市闽侯县鸿尾乡石头街３７号
中国邮电工会闽侯县邮政局委员会	联系人：马昌武	地址：福建省福州市闽侯县甘蔗镇街心路１４２号
福建省闽侯县邮电局青口邮电支局	null	地址：福建省福州市闽侯县青口镇工业路１号
福建省闽侯县邮电局白沙邮电支局	null	地址：福建省福州市闽侯县白沙镇埕元村３号
福建省闽侯县邮电局南通邮电支局	null	地址：福建省福州市闽侯县南通镇南通街３号
福建省闽侯县邮电局南屿邮电支局	null	地址：福建省福州市闽侯县南屿镇榕屿
福建省闽侯县邮电局荆溪邮电支局	null	地址：福建省福州市闽侯县荆溪镇前山街３０２号
福建省闽侯县邮电局大湖邮电支局	null	地址：福建省福州市闽侯县大湖乡大湖街４４号
闽侯县洋里供销社副食品仓库	联系人：江本淦	地址：福建省福州市闽侯县洋里乡花桥村
福建省闽侯县邮电局闽江邮电支局	null	地址：福建省福州市闽侯县闽江乡峡南村后湾６号
福建省公路管理局杜乌储运处工会委员会	联系人：陈兴	地址：福建省福州市闽侯县荆溪镇永丰村
闽侯县小箬乡公路管理站	站长：陈由槐	地址：福建省福州市闽侯县小箬乡小箬村
闽侯县上街镇公路管理站	站长：林茂生	地址：福建省福州市闽侯县上街镇浦口村
福建省公路管理局杜坞储运处	null	地址：福建省福州市闽侯县荆溪乡永丰村
闽侯县华能煤炭枕峰转运站	null	地址：福建省福州市闽侯县祥谦镇枕峰村
福建省闽侯县尚干油料中转站	null	地址：福建省福州市闽侯县尚干镇大桥头
闽侯县青口镇公路管理站	站长：林连奇	地址：福建省福州市闽侯县青口镇镇政府内
南平车务段劳动服务公司杜乌运输服务分所	null	地址：福建省福州市闽侯县杜坞火车站
南平车务段铁龙装卸运输公司杜乌分公司	null	地址：福建省福州市闽侯县荆溪镇杜乌火车站货场
闽侯县南通文山客运站	null	地址：福建省福州市闽侯县南通镇文山村
福建省闽侯县邮电局竹岐邮电支局	null	地址：福建省福州市闽侯县竹岐乡竹岐街１２６号
闽候县上街搬运站	null	地址：福建省福州市闽侯县
闽侯县祥谦运输公司搬运队	队长：林悯	地址：福建省福州市闽侯县祥谦镇桥头
闽侯县白沙搬运联队	null	地址：福建省福州市闽侯县白沙镇火车路１１５号
闽侯县祥谦镇公路管理站	站长：刘孝平	地址：福建省福州市闽侯县祥谦镇中院村
闽侯县廷坪乡公路管理站	站长：陈夫法	地址：福建省福州市闽侯县廷坪乡政府办公楼
闽侯县洋里乡公路管理站	站长：江水弟	地址：福建省福州市闽侯县洋里乡洋里村
闽侯县大湖乡养路队	null	地址：福建省福州市闽侯县大湖乡上苑村
闽侯县鸿尾乡公路管理站	站长：李敦镜	地址：福建省福州市闽侯县鸿尾乡石佛头街７７号
闽侯县水政监察大队	队长：翁长沙	地址：福建省福州市闽侯县甘蔗镇交通路２号
福州闽侯泰发家俱装饰有限公司	null	地址：福建省福州市闽侯县甘蔗镇福龙小区
闽侯县竹岐榕东土石方工程队	null	地址：福建省福州市闽侯县竹岐乡榕东村
闽侯县洋里福兴建筑装修社	null	地址：福建省福州市闽侯县洋里乡安仁村
福建省闽侯县丰顺建筑装饰材料有限公司	null	地址：福建省福州市闽侯县竹岐乡原格村
福建省闽侯恒宇装璜装饰有限公司	null	地址：福建省福州市闽侯县甘蔗镇八一八路177号
福州综毅建筑装饰材料有限公司	null	地址：福建省福州市闽侯县上街镇上街２１号
福州三禾家俱装饰有限公司	null	地址：福建省福州市闽侯县上街镇上街村
闽侯县新艺装饰工程有限公司	总经理：任成波	地址：福建省福州市闽侯县青口镇福厦路２８公里处贝伦宾馆１
闽侯县超氏装璜装饰有限公司	null	地址：福建省福州市闽侯县甘蔗镇甘洲路３５１号
闽侯县甘蔗水电设备安装公司门市部	老板：程道和	地址：福建省福州市闽侯县甘蔗镇双池街１２０号
闽侯县南通方山公路工程指挥部	null	地址：福建省福州市闽侯县南通镇方山村
福州电业局电力安装工程公司闽侯第二分公司	null	地址：福建省福州市闽侯县甘蔗镇入城路
福建省闽侯县联胜装饰有限公司	null	地址：福建省福州市闽侯县甘蔗镇校园路
闽侯县南屿建筑工程公司	null	地址：福建省福州市闽侯县南屿镇柳厝街１号
福建省闽侯县上街工业设备安装队	null	地址：福建省福州市闽侯县上街镇新峰村
闽侯县白沙天柳石膏水泥店G	null	地址：福建省福州市闽侯县白沙新街65号
闽侯县尚干建豪家电修理店	老板：林建豪	地址：福建省福州市闽侯县尚干街祥谦路２１８号
闽侯县甘蔗思榕电器维修店	老板：许思榕	地址：福建省福州市闽侯县甘蔗镇校园路６７号
福建省闽侯金矿	null	地址：福建省福州市闽侯县白沙镇汶溪村
闽侯县南通永新石膏板加工场	null	地址：福建省福州市闽侯县南通镇马腾村
闽侯县廷坪乡供电所	null	地址：福建省福州市闽侯县廷坪乡廷坪街
福建省闽侯供电局上街供电所	所长：陈小明	地址：福建省福州市闽侯县上街镇红峰邱阳５号
福建省闽侯供电局兴业服务站	null	地址：福建省福州市闽侯县甘蔗镇街心路41号
大湖乡坂头片供电开关站管理委员会	null	地址：福建省福州市闽侯县大湖乡坂头村供电开关站
福建省闽侯供电局多种经营办公室	null	地址：福建省福州市闽侯县甘蔗供电局
闽侯县食品公司贸易行栈摄影服务部	null	地址：福建省福州市闽侯县甘蔗镇街心路１１４号
闽侯县南屿江口供电所	null	地址：福建省福州市闽侯县南屿镇江口村
福建省闽侯县闽江税务所	null	地址：福建省福州市闽侯县闽江乡峡南村
闽侯县税务局青口税务所	null	地址：福建省福州市闽侯县青口镇青口村
闽侯县国家税务局荆溪分局	null	地址：福建省福州市闽侯县荆溪镇徐家村２３８号
闽侯县小箬乡人民政府	null	地址：福建省福州市闽侯县小箬乡人民政府内
闽侯县白沙镇人民政府电管站	null	地址：福建省福州市闽侯县白沙镇埕元村1号
闽侯县大湖乡财政所	null	地址：福建省福州市闽侯县大湖乡大湖街１０１号
闽侯县税务局上街税务所	null	地址：福建省福州市闽侯县上街镇新峰街
闽侯县上街乡科学技术委员会	null	地址：福建省福州市闽侯县上街镇政府
闽侯县闽江乡财政所	null	地址：福建省福州市闽侯县闽江乡峡南村后湾６号
闽侯县南屿镇人民政府司法办公室	联系人：林善森	地址：福建省福州市闽侯县南屿镇水西林１３号
闽侯县税务局大湖税务所	null	地址：福建省福州市闽侯县大湖乡大湖街１０５号
闽侯县白沙镇人民政府司法所	null	地址：福建省福州市闽侯县白沙镇安平路９０号
闽侯县人民政府税收财务物价大检查办公室	null	地址：福建省福州市闽侯县财政局
闽侯县税务局南屿税务所	null	地址：福建省福州市闽侯县南屿镇新桥头０号
闽侯县闽江乡人民政府民政办公室	联系人：陈建胜	地址：福建省福州市闽侯县闽江乡峡南后湾６号
闽侯县税务局南通税务所	null	地址：福建省福州市闽侯县南通镇南通村
闽侯县经委工会委员会	null	地址：福建省福州市闽侯县甘蔗镇交通路２号
闽侯县工商行政管理局甘蔗工商所	null	地址：福建省福州市闽侯县甘蔗镇街心路３１号
闽侯县工商行政管理局大坪工商所	null	地址：福建省福州市闽侯县大湖乡大坪村大坪街
闽侯县工商行政管理局南屿工商所	null	地址：福建省福州市闽侯县南屿镇
闽侯县交通局工会委员会	null	地址：福建省福州市闽侯县甘蔗镇交通路２号
闽侯县竹岐乡村镇规划建设管理站	null	地址：福建省福州市闽侯县竹岐乡竹岐街１２５号
中国共产党闽侯县财贸委员会	联系人：林崇秋	地址：福建省福州市闽侯县甘蔗镇交通路２号
闽候县建设局工会委员会	null	地址：福建省福州市闽侯县
闽侯县林业局工会委员会	null	地址：福建省福州市闽侯县甘蔗镇交通路２号
闽侯县青口镇前街村经济委员会	null	地址：福建省福州市闽侯县青口镇前街村
闽侯县农业局工会委员会	联系人：郑成金	地址：福建省福州市闽侯县甘蔗镇交通路２号
闽侯县物价局工会委员会	联系人：郑钦椒	地址：福建省福州市闽侯县甘蔗镇交通路２号
闽侯县工商行政管理局荆溪工商所	null	地址：福建省福州市闽侯县荆溪镇荆溪村徐家村
闽侯县工商行政管理局青口工商所	null	地址：福建省福州市闽侯县青口镇工业路１号
闽侯县林业局廷坪林业工作站	null	地址：福建省福州市闽侯县廷坪乡廷坪村街心路
闽侯县鸿尾乡村镇规划建设管理站	null	地址：福建省福州市闽侯县鸿尾乡石佛头街１０７号
福建省工商行政管理局闽侯峡南缉私检查站*	null	地址：福建省福州市闽侯县闽江乡峡南村后湾１号
闽侯县林业局荆溪林业工作站	null	地址：福建省福州市闽侯县荆溪镇徐家村
闽侯县林业局鸿尾林业工作站	null	地址：福建省福州市闽侯县鸿尾乡石佛头街１５９号
闽侯县小箬乡计划生育办公室	null	地址：福建省福州市闽侯县小箬乡人民政府内
闽侯县人民法院工会委员会	null	地址：福建省福州市闽侯县甘蔗镇环城路１５４号
闽候县人民法院上街人民法庭	null	地址：福建省福州市闽侯县上街镇全屿村商业街
闽侯县闽江乡计划生育办公室	联系人：潘华荣	地址：福建省福州市闽侯县闽江乡政府内
闽侯县体委工会委员会	null	地址：福建省福州市闽侯县甘蔗镇街心路４号
闽侯县人民法院青口人民法庭	null	地址：福建省福州市闽侯县青口镇
闽侯县洋里乡计划生育办公室	null	地址：福建省福州市闽侯县洋里乡花桥村２０号
闽侯县竹岐乡计划生育办公室	null	地址：福建省福州市闽侯县竹岐乡计生办
闽侯县工商行政管理局祥谦工商所	null	地址：福建省福州市闽侯县祥谦镇
闽侯县工商行政管理局上街工商所	null	地址：福建省福州市闽侯县上街镇新峰村１号
闽侯县人民检察院工会委员会	联系人：陈炳端	地址：福建省福州市闽侯县甘蔗镇交通路２号
闽侯县尚干人民法庭	null	地址：福建省福州市闽侯县尚干镇兰圃村
闽侯县劳动局工会委员会	联系人：江正丁	地址：福建省福州市闽侯县甘蔗镇街心路１９３号
闽侯县青口镇工会联合委员会	null	地址：福建省福州市闽侯县青口镇政府内
闽候县油厂工会委员会	null	地址：福建省福州市闽侯县福州郊区建新镇洪塘下境49号
闽侯县大湖乡机关工会委员会	联系人：陈修清	地址：福建省福州市闽侯县大湖乡政府
中国人民保险公司闽侯县支公司工会委员会	null	地址：福建省福州市闽侯县甘蔗镇甘洲路１９８号
闽侯县良种繁殖场工会委员会	联系人：陈书新	地址：福建省福州市闽侯县白沙镇林柄村林柄８０号
闽侯县南通镇机会工会委员会	null	地址：福建省福州市闽侯县南通镇南通街１０８号
闽侯县闽江乡机关工会委员会	联系人：孙富官	地址：福建省福州市闽侯县闽江乡峡南村后湾６号
闽侯县副食品公司工会委员会	null	地址：福建省福州市闽侯县甘蔗镇街心路６９号
闽侯县民政局工会委员会	联系人：林玉英	地址：福建省福州市闽侯县甘蔗镇校园路
闽侯县青口镇机关工会委员会	null	地址：福建省福州市闽侯县青口镇政府院内
闽侯县建筑材料公司工会委员会	null	地址：福建省福州市闽侯县甘蔗镇交通路３号
闽侯县闽江乡工会联合委员会	null	地址：福建省福州市闽侯县闽江乡政府内
闽侯县白沙工会联合委员会	null	地址：福建省福州市闽侯县白沙镇政府内
闽侯县南屿镇机关工会委员会	null	地址：福建省福州市闽侯县南屿镇政府内
闽侯县青口学区工会委员会	联系人：陈维清	地址：福建省福州市闽侯县青口镇青圃村新桥外６１号
闽侯县洋里机关工会委员会	null	地址：福建省福州市闽侯县洋里乡花桥村
闽侯县尚干镇村镇规划建设管理站	站长：林建海	地址：福建省福州市闽侯县尚干镇政府
中国人民政治协商会议闽侯县委员会	null	地址：福建省福州市闽侯县甘蔗镇交通路２号
中国人民政治协商会议闽侯县委员会办公室	null	地址：福建省福州市闽侯县甘蔗镇交通路２号
闽候县南屿镇柑桔协会	null	地址：福建省福州市闽侯县南屿镇水西林23号
闽侯县林业局	null	地址：福建省福州市闽侯县甘蔗镇交通路２号
闽侯县小箬乡村镇规划建设管理站	null	地址：福建省福州市闽侯县小箬乡
闽侯县国家税务局外税分局	局长：张孔院	地址：福建省福州市闽侯县甘蔗镇街心路150号
福建省福州市卫生用品厂工会	null	地址：福建省福州市闽侯县甘蔗镇墩园路
中国致公党福州市委员会闽侯直属支部	老板：赵碧珍	地址：福建省福州市闽侯县甘蔗镇八一八西路１２８号
闽侯县廷坪学区教育工会委员会	null	地址：福建省福州市闽侯县廷坪乡廷坪村
闽侯县荆溪镇人民政府电管站	null	地址：福建省福州市闽侯县荆溪镇徐家村新街
闽侯县教育工会委员会	联系人：黄光祖	地址：福建省福州市闽侯县甘蔗镇交通路６０号
闽侯县闽江学区教育工会委员会	null	地址：福建省福州市闽侯县闽江乡峡南村
闽侯县江口联兴织布厂	null	地址：福建省福州市闽侯县南屿镇江口村过透
福建省闽候县榕信工艺品有限公司	null	地址：福建省福州市闽侯县
闽侯县南通金松制刷厂	厂长：陈松年	地址：福建省福州市闽侯县南通镇罗洲村新桥浦２号
福建省间侯县茂明工艺品有限公司	null	地址：福建省福州市闽侯县青口镇杨厝村
闽侯县南屿江口崇桂织带厂	null	地址：福建省福州市闽侯县南屿镇江口村过透１１号
福建省闽侯县弘达工艺品有限公司	null	地址：福建省福州市闽侯县甘蔗镇福龙新村
福州欣博工艺品有限公司	成立日期：2003/12/3	地址：中国 福建 福州市 福州闽侯县
闽侯县榕江线带厂	null	地址：福建省福州市闽侯县南通镇泮洋村
闽侯县古城旅游工艺厂	null	地址：福建省福州市闽侯县南通古城村
福建省闽侯闽杨针织厂	null	地址：福建省福州市闽侯县青口镇杨厝村
闽侯县南屿江口飞龙线带厂	null	地址：福建省福州市闽侯县南屿镇江口过透１０８号
闽侯县竹歧石料厂	null	地址：福建省福州市闽侯县竹歧乡竹歧村
闽侯县青口恒顺气体有限公司	总经理：郑国雄	地址：福建省福州市闽侯县青口镇宏四村
闽侯县南屿北城织布厂	null	地址：福建省福州市闽侯县南屿镇江口村过透８０号
福建省闽侯县东方工艺品有限公司	null	地址：福建省福州市闽侯县甘蔗镇里山前36号
闽侯县友诚家具厂	null	地址：福建省福州市闽侯县南屿镇晓岐村长门头
闽侯县南屿镇江口福清织布厂	null	地址：福建省福州市闽侯县南屿镇江口过透５９号
闽侯县江口新兴工业布厂	null	地址：福建省福州市闽侯县南屿镇江口浦口村
福州帆布厂工会委员会	null	地址：福建省福州市闽侯县白沙镇长坪园１号
闽侯县大湖新塘机砖厂	null	地址：福建省福州市闽侯县大湖乡新塘村
福建省闽侯县江口针棉织厂	null	地址：福建省福州市闽侯县南屿镇江口后双１０６号
闽侯县江口兴利织布厂G	null	地址：福建省福州市闽侯县南屿镇江口村过透
闽侯县南屿江口新龙织布厂	null	地址：福建省福州市闽侯县南屿镇江口码头
福建省闽侯县诚都工艺厂	厂长：兰意龙	地址：福建省福州市闽侯县荆溪镇古山洲村５８号
福建省闽侯福成工艺厂	厂长：余宝珍	地址：福建省福州市闽侯县甘蔗镇墩园州
闽侯县上街青洲工艺厂	null	地址：福建省福州市闽侯县上街镇３１６国道工业区
闽侯县南屿兴达陶瓷工艺厂	null	地址：福建省福州市闽侯县南屿镇葛岐村
闽侯县南通学区涂料厂	null	地址：福建省福州市闽侯县南通镇罗洲村
闽侯县荆溪古山洲工艺美术厂	null	地址：福建省福州市闽侯县荆溪镇古山洲村９３号
福建省闽侯县鸿尾卫华工艺厂	null	地址：福建省福州市闽侯县鸿尾乡石佛头街
闽侯县鸿尾龙华工艺厂	厂长：李道伟	地址：福建省福州市闽侯县鸿尾乡石佛头村
闽侯县南通唐方涂料厂G	null	地址：福建省福州市闽侯县南通镇罗洲村
闽侯县荆溪光明漆器工艺厂	null	地址：福建省福州市闽侯县荆溪镇光明村
闽侯县旅游工艺美术厂	null	地址：福建省福州市闽侯县甘蔗镇五福村
闽侯县南港培松木线厂	厂长：陈培松	地址：福建省福州市闽侯县南通镇陈厝卫星２２号
闽侯县青口农光恒昌工艺品厂	null	地址：福建省福州市闽侯县青口镇农光村
福建省闽侯县荆溪富兴漆器工艺厂	null	地址：福建省福州市闽侯县荆溪镇关口村西山１０号
闽侯县竹岐苏洋兴成石料厂	厂长：赵宝银	地址：福建省福州市闽侯县竹岐乡苏洋村
闽侯县尚干红星印刷厂	null	地址：福建省福州市闽侯县尚干镇福兴路３号
福建省闽侯闽星工艺厂	null	地址：福建省福州市闽侯县南屿镇窗厦村
闽侯县大坪机砖厂	厂长：陈保香	地址：福建省福州市闽侯县大湖乡大坪村
闽侯县荆溪坛石入城空心砖厂	null	地址：福建省福州市闽侯县荆溪镇坛石村
闽侯县南屿信龙纺织厂G	null	地址：福建省福州市闽侯县南屿镇流洲村浦口
闽侯县江口永丰织布厂	厂长：林高全	地址：福建省福州市闽侯县南屿镇江口村九石
闽侯县江口榕青纺织厂G	null	地址：福建省福州市闽侯县南屿镇江口村青州
福州大顺蓄电池有限公司	null	地址：福建省福州市闽侯县南屿镇村下村（榕城监狱三大队内）
福建省闽侯县华福制衣厂	null	地址：福建省福州市闽侯县甘蔗镇交通路５号
福建省闽侯县建盛瓷业有限公司	null	地址：福建省福州市闽侯县洋里乡西村村
闽侯县南屿鞋厂	null	地址：福建省福州市闽侯县南屿镇南屿街
福建省闽侯县青口农光针织厂	null	地址：福建省福州市闽侯县青口镇农光村郑厝26号
闽侯县南屿青州恒利纺织厂	null	地址：福建省福州市闽侯县南屿镇江口青州村2号
闽侯县闽鑫服饰手套织造有限公司	成立日期：2001/1/21	地址：中国 福建 福州市 西郊闽侯县南屿街(安德楼旁别墅内)
闽侯县江口秀林纺织厂G	null	地址：福建省福州市闽侯县南屿镇江口村旺厝63号
福建省闽侯闽泉工艺品有限公司	总经理：李道伟	地址：福建省福州市闽侯县鸿尾乡石佛头街１５８号
闽侯县江口榕平纺织厂	null	地址：福建省福州市闽侯县南屿镇江口厝35号
福建省闽侯县江口金盛纺织厂G	null	地址：福建省福州市闽侯县南屿镇江口村
福建省闽侯县上街丹丽针织厂	null	地址：福建省福州市闽侯县上街镇新峰村
闽侯县超峰工艺品厂	厂长：程增勇	地址：福建省福州市闽侯县荆溪镇港头村白头
福建省闽侯县闽星微型灯饰厂G	null	地址：福建省福州市闽侯县尚干镇尚南路
闽侯县东升轴承锻造厂	null	地址：福建省福州市闽侯县上街镇庄南村
福建省闽侯县鸿尾祥达工艺厂	厂长：张无模	地址：福建省福州市闽侯县鸿尾乡奎石村１６号
福州闽侯欣欣制衣有限公司	null	地址：福建省福州市闽侯县竹岐乡榕东村
福建省闽侯县鹏盛瓷业有限公司	总经理：林协钦	地址：福建省福州市闽侯县小箬乡西村村
福州瓦尔工艺品有限公司	成立日期：1998/10/12	地址：中国 福建 福州市 闽侯县鸿尾乡桥头村
福建省闽侯胜兴工艺厂	厂长：方胜文	地址：福建省福州市闽侯县南通镇罗洲方庄南路２６号
闽侯县鹏达工艺厂	厂长：张赛昭	地址：福建省福州市闽侯县甘蔗镇八一八路１１０号
福建省闽侯星兴工艺厂	厂长：王农	地址：福建省福州市闽侯县甘蔗镇军民路３０号
闽侯县尚兴工艺厂	厂长：张万兵	地址：福建省福州市闽侯县小箬乡尚格村
福建省建阳县鸿达竹木工艺品有限公司闽侯分厂	null	地址：福建省福州市闽侯县竹岐乡汶洲村
闽侯县上街新民服装厂	厂长：林燕玉	地址：福建省福州市闽侯县上街镇厚美村
闽侯县闽江兴星鞋帽服装厂	null	地址：福建省福州市闽侯县闽江乡峡南村
闽侯县上街一品师制衣厂	厂长：陈仁贵	地址：福建省福州市闽侯县上街镇金屿村
福州弘乔卫浴电器有限公司	总经理：林育成	地址：福建省福州市闽侯县青口投资区
福建省福州市第二电线厂服务部	老板：林晖	地址：福建省福州市闽侯县甘蔗镇后山路１０号
福州市第二电线厂甘蔗经营部	老板：陈玉清	地址：福建省福州市闽侯县甘蔗镇八一八路１５７号
福州永圣机械电器有限公司	null	地址：福建省福州市闽侯县青口投资区
闽侯县江南电线厂	null	地址：福建省福州市闽侯县荆溪镇溪下村
闽侯嘉辉鞋帽有限公司	总经理：陈天龙	地址：福建省福州市闽侯县南通镇陈厝村　　　　法定代表人：陈天龙
闽侯上街乐辉服装厂	null	地址：福建省福州市闽侯县上街镇沙堤村后街
闽侯县洋里林果场木材制品厂	null	地址：福建省福州市闽侯县洋里乡中平村２３号
闽侯县上街鑫利竹木制品厂Ｇ	null	地址：福建省福州市闽侯县上街镇马排村
闽侯县闽军竹木制品厂G	null	地址：福建省福州市闽侯县洋里乡安仁村56号
闽侯县龙泉昌翔竹木制品厂	null	地址：福建省福州市闽侯县南屿镇龙泉村
闽侯县甘蔗光华竹草木制品厂	null	地址：福建省福州市闽侯县甘蔗镇横屿村309号
闽侯县甘蔗光华竹木制品厂	null	地址：福建省福州市闽侯县甘蔗镇横屿村309号
闽侯县金龙塑木制品有限公司	null	地址：福建省福州市闽侯县甘蔗镇卫生巾厂
闽侯县南屿双溪竹木制品厂	厂长：雷高云	地址：福建省福州市闽侯县南屿镇九都村
闽侯县竹岐天台竹木制品厂	null	地址：福建省福州市闽侯县竹岐乡天台村
闽侯县竹岐半岭竹木制品厂	厂长：林仁淦	地址：福建省福州市闽侯县竹岐乡半岭村
福建省闽侯县创新竹木制品厂	null	地址：福建省福州市闽侯县荆溪镇南山村１８号
福建省闽侯县信达工艺厂G	null	地址：福建省福州市闽侯县鸿尾乡石佛头街
闽侯县祥谦山后五金厂	null	地址：福建省福州市闽侯县祥谦镇山后村
闽侯县竹岐林兴竹草工艺厂	null	地址：福建省福州市闽侯县竹岐乡溪口村
福建省闽侯县鸿尾登峰工艺厂	null	地址：福建省福州市闽侯县鸿尾乡溪元村
福建省闽侯县鸿尾红星草竹工艺厂G	null	地址：福建省福州市闽侯县鸿尾乡超乾村
闽侯县南屿雷鸣饲料厂	厂长：张雷鸣	地址：福建省福州市闽侯县南屿镇葛岐村
福建省闽侯县鸿尾溪源闽江工艺厂	null	地址：福建省福州市闽侯县鸿尾乡溪源村
闽侯县甘蔗横屿竹木制品厂	null	地址：福建省福州市闽侯县甘蔗镇横屿村
闽侯县农副产品开发公司竹木制品厂	厂长：陈道灼	地址：福建省福州市闽侯县甘蔗镇长江路８９号
闽侯县尚干五金厂	null	地址：福建省福州市闽侯县尚干镇尚南路73号
福建省闽侯县鸿尾明松工艺厂	null	地址：福建省福州市闽侯县鸿尾乡官路村
闽侯县鸿尾东金工艺厂	厂长：李东金	地址：福建省福州市闽侯县鸿尾乡官路村
闽侯县南屿南旗旗山工艺厂	null	地址：福建省福州市闽侯县南屿镇龙泉村浦口１２５号
闽侯县北园新发木线条加工厂	null	地址：福建省福州市闽侯县祥谦肖家道省少管所内
福建省闽侯城关文具工艺厂	厂长：张孔容	地址：福建省福州市闽侯县甘蔗镇校园路７３号
闽侯县青口梅岭工艺厂	null	地址：福建省福州市闽侯县青口镇梅岭工艺厂
闽侯县上街康兴工艺厂	厂长：冯昭为	地址：福建省福州市闽侯县上街镇美岐长镜６８号
闽侯县青口沪屿草编厂	null	地址：福建省福州市闽侯县青口沪屿紫台庵
闽侯县长江竹木制品厂	null	地址：福建省福州市闽侯县甘蔗镇墩园洲60号
闽侯县鸿尾岩石竹木制品厂	null	地址：福建省福州市闽侯县鸿尾乡岩石村
闽侯县竹岐乡春风木器厂G	null	地址：福建省福州市闽侯县竹岐乡春风村
福州善缘工艺品有限公司	null	地址：福建省福州市闽侯县青口镇镜上村
闽侯县森兴竹木制品厂	厂长：陈孝田	地址：福建省福州市闽侯县甘蔗镇大元巷１０２号
闽侯县金玫瑰工艺美术厂	厂长：陈歌乐	地址：福建省福州市闽侯县甘蔗镇墩园洲５０号
福建省闽侯县南屿学区轻工艺厂	null	地址：福建省福州市闽侯县南屿镇南井松杭州６号
福建省闽侯县青龙工艺厂	null	地址：福建省福州市闽侯县白沙镇白沙街刘厝４８号
闽侯县青口镇沪新草编厂	null	地址：福建省福州市闽侯县青口镇沪屿村坂尾５号
闽侯县上街明铭日用制品厂	null	地址：福建省福州市闽侯县上街镇沙堤村
闽侯县甘蔗山前依苏蜂窝煤加工厂	厂长：洪依苏	地址：福建省福州市闽侯县甘蔗镇山前村
闽侯县荆溪流洋木器厂G	null	地址：福建省福州市闽侯县荆溪镇流洋村
福建省闽侯县白沙工艺印刷厂	null	地址：福建省福州市闽侯县白沙镇白沙街安平路２９号
闽侯县四通工艺厂	null	地址：福建省福州市闽侯县荆溪镇坛石村
闽侯县上街康发角制工艺品厂	厂长：郑新	地址：中国 福建 福州市鼓楼区 闽侯县上街镇岐安村下长安41号
