福州浩威金属制品有限公司	总经理：胡英	地址：福建闽侯县兰圃工业区318号
福建省九兴投资有限责任公司	总经理：陈	地址：闽侯县甘蔗街道校园路21号后
福建优建建筑科技有限公司	总经理：蔡	地址：福建省福州市闽侯县上街镇科技东路3号福州高新区海西高新技术产业园创新园一期10#楼1
闽侯县南通方敏生服装加工场	联系人：方	地址：福建省福州市闽侯县南通镇方庄村
闽侯县闽旺农业专业合作社	联系人：林	地址：福建省福州市闽侯县白沙镇上岐村上岐70号
闽侯县富城农业专业合作社	联系人：林	地址：闽侯县廷坪乡汶合村九里11号
闽侯县洋里德群家庭农场	联系人：陈	地址：福建省福州市闽侯县洋里乡绅带村桥里自然村水槽亭
闽侯县鸿尾耕慧家庭农场	联系人：陈	地址：福建省福州市闽侯县鸿尾乡南坑村
福建溪源种德生态农业有限公司	总经理：潘	地址：闽侯县上街镇溪源宫村罗丰片
福州宏华家居制造有限公司	总经理：黄	地址：福建省福州市闽侯县竹岐乡榕西村中埕67号厂房三层
福州鸿祥运输有限公司	总经理：卢	地址：福建省福州市闽侯县南屿镇忠观街3号旗山商贸街商住楼9号楼1层07店面
闽侯县大山里工艺品商行	联系人：黄	地址：福建省福州市闽侯县上街镇上街四房（林友钦宅）
福建华粮米业有限公司	总经理：林	地址：福建省福州市闽侯县荆溪镇福州市粮食批发交易市场1座19号
闽侯县南通镇洲头跳龙门锦鲤育苗场	联系人：黄	地址：福建省福州市闽侯县南通镇洲头村里洋
福州云众数据科技有限公司	总经理：林	地址：福建省福州市闽侯县科技东路3号福州高新区海西高新技术产业园创新园一期10#楼1层158室
福建蓝城信息科技有限公司	总经理：林	地址：福建省福州市闽侯县科技东路3号福州高新区海西高新技术产业园创新园一期10#楼1层166室
闽侯县五福茶叶有限公司	总经理：洪	地址：闽侯县五福茶叶有限公司
福建久策气体销售有限公司	总经理：何	地址：福建省福州市闽侯县南屿镇117县道新联村福州高新区两园安置房一期一标段裙楼三层3-002
福州海峡龙祥建设有限责任公司	总经理：彭	地址：闽侯县祥谦镇福厦公路（324）国道西侧21公里处
福建鑫善源农业开发有限公司	总经理：林	地址：福建省福州市闽侯县尚干镇后村村后埕1号
闽侯县丰达竹木制品有限公司	总经理：方	地址：闽侯县竹岐乡竹岐村
福州市闽侯县王府建材有限公司	总经理：陈	地址：福州市闽侯县祥谦镇辅翼村福建豪峰金属制品有限公司厂房三整座
福州迁旺家家居股份有限公司	总经理：李	地址：福建省福州市闽侯县上街镇马保村闽侯县艺根玻璃有限公司4#厂房3楼
闽侯县仙门山食用菌专业合作社	联系人：王	地址：福建省闽侯县洋里乡仙门村岩头4号
闽侯县墨轩教育咨询有限公司	总经理：洪	地址：福州市闽侯县上街镇蔗洲村学生街2号楼211室
闽侯县鸿尾紫藤家庭农场	联系人：罗	地址：福建省福州市闽侯县鸿尾乡南坑村
福州臻顺建筑劳务有限公司	总经理：陈	地址：闽侯县上街镇沙堤村中洲片
福建森朗贸易有限公司	总经理：林	地址：福建省福州市闽侯县甘蔗街道入城路东方花园6#501
闽侯县旭丰工艺品有限公司	总经理：方	地址：闽侯县南通镇方庄
福州兴诺机械工业有限公司	总经理：卢	地址：福建省福州市闽侯县南屿镇高岐村福州海量管道器材有限公司6#综合整座
福州博红森实业有限公司	总经理：陈	地址：福建省福州市闽侯县上街镇建平村金上大道博仕后家园1#06店
福州印象行天下汽车租赁有限公司	总经理：林	地址：福建省福州市闽侯县祥谦镇中院村中院47号
福州市邂逅巴黎餐饮管理有限公司	总经理：李小姐	地址：福州市闽侯县上街镇庄南村博仕后缘墅
福州经炜家居饰品有限公司	总经理：沈	地址：闽侯县甘蔗街道大元村
闽侯县鸿尾乡雪英农林综合场	联系人：谢	地址：福建省福州市闽侯县鸿尾乡南元村垄门池
福州泰茂机电科技有限公司	总经理：罗	地址：闽侯县青口镇新城西路58号博雅星城凯景大酒店910单元
闽侯县白沙后义洋农业综合开发示范场	联系人：张	地址：福建省福州市闽侯县白沙镇安平路67号
福州快捷快递有限公司	总经理：杨	地址：闽侯县祥谦镇辅澜路3号1#厂房整座
福州亚鼎汽车贸易有限公司	总经理：李	地址：福州市闽侯县青口镇宏四村马路街50号茂泰花园1#楼1层07店面
福州闽都网络技术工程有限公司	总经理：余	地址：闽侯县
闽侯县华盛农业专业合作社	联系人：聂	地址：闽侯县廷坪乡池坑村上弯37号
福州鑫时尚家纺有限公司	总经理：王	地址：闽侯县荆溪镇光明村
福州众行汽车销售有限公司	总经理：张	地址：福建省福州市闽侯县尚干镇祥通路11-2号
福州银宝汽车服务有限公司	总经理：许	地址：福州市闽侯县尚干镇良安路8号江浩尚景园5号楼806
闽侯县大邱坪生态种养殖专业合作社	联系人：朱	地址：闽侯县鸿尾乡古洋村外境16号
闽侯县新春医药有限公司	总经理：王	地址：闽侯县上街镇国宾大道2号博仕后公馆商业广场A12#楼一层24、25店面
福州贝林工艺品有限公司	总经理：肖	地址：闽侯县荆溪镇荆溪村
福建经帆建筑劳务有限公司	总经理：马	地址：福建省闽侯县上街镇沙堤村后街66号
福州佶盛典当行有限公司	总经理：周	地址：福建省福州市闽侯县甘蔗街道昙石山东大道10号综合楼一层
闽侯县新晖企业管理有限公司	总经理：郑	地址：闽侯县甘蔗街道昙石山西大道98号新城丽景B区10#楼2层212店面
福州阳光钱柜音乐会所有限公司	总经理：林	地址：福建省闽侯县青口镇付竹村富竹大厦三层
闽侯县上街美刻妆容美容中心（普通合伙）	联系人：杨	地址：福建省福州市闽侯县上街镇博仕后公馆3号楼3-4号店
闽侯县总部园房地产有限公司	总经理：林	地址：闽侯县甘蔗街道八一八西路185号
福建长大建设有限公司	总经理：林	地址：闽侯县甘蔗街道昙石山西大道98号新城丽景B区12#楼503单元
闽侯县如果电子商务有限公司	总经理：卢	地址：福建省福州市闽侯县南通镇街西排东起第六直
闽侯县益康生农业专业合作社	联系人：鄢	地址：闽侯县五都村榜尾洋
福州联亿汽车配件有限公司	总经理：林	地址：闽侯县祥谦镇兰圃村住宅小区
闽侯县富利民食品有限公司	总经理：吕	地址：闽侯县竹岐乡竹岐村
闽侯县峰龙山农业专业合作社	联系人：何	地址：闽侯县白沙镇白沙村
闽侯县肆年传媒有限公司	总经理：周	地址：闽侯县上街镇岐安村（福州地区大学新校区体育场地东南附属楼）
世纪民生（福州）蔬菜有限公司	总经理：林	地址：闽侯县南通镇福州市海峡蔬菜批发市场精品场位106号
闽侯县华烨工艺品有限公司	总经理：王	地址：闽侯县荆溪镇港头村坛山29号
福州市甲午农业开发有限公司	总经理：欧	地址：福州市闽侯县竹岐乡竹岐村虎鼻头
福州泓一金属制品有限公司	总经理：王	地址：闽侯县竹岐乡竹西溪口116号2号厂房
福州智能时代电子科技有限公司	总经理：赖	地址：福建省福州市闽侯县科技东路3号福州高新区海西高新技术产业园创新园10#楼1层142室
闽侯县宏丰达金属制品有限公司	总经理：郭	地址：闽侯县祥谦镇中院村（原祥谦中院中心小学内）
福州佳胜贸易有限公司	总经理：吴	地址：福建省福州市闽侯县青口镇宏四村
福州有聊影视文化有限公司	总经理：盘	地址：福建省福州市闽侯县科技东路8号福州高新区海西高新技术产业园创业大厦B区1层159室
闽侯县鑫瑞杰贸易有限公司	总经理：李	地址：闽侯县大湖乡珍山村1号
福州新竹科技园发展有限公司	总经理：何	地址：福建省福州市闽侯县科技东路8号福州高新区海西高新技术产业园创业大厦B区2层205室
闽侯县尚干鸿哲商务信息咨询服务部	老板：吴	地址：福建省福州市闽侯县尚干镇新榕路1号新榕小区02幢19号店铺
闽侯县若水生花生物科技有限公司	总经理：张	地址：闽侯县上街镇岐安村（福州地区大学新校区体育场地东南附属楼）
福州卓尔物流有限公司	总经理：杨	地址：福州市闽侯县祥谦镇辅澜路3号福州皇杰实业有限公司研发楼五层501室
闽侯县彦铭贸易有限公司	总经理：徐	地址：闽侯县甘蔗街道洽浦村洽浦193号
福州盛科计算机网络信息技术有限公司	总经理：叶	地址：闽侯县上街镇岐安村（福州地区大学城新校区体育场地东南附属楼）
福州鑫辉达设备租赁有限公司	总经理：林	地址：福州市闽侯县上街镇浦口村
福建荣捷万仕德汽车销售服务有限公司	总经理：姜	地址：福建省福州市闽侯县青口镇新城西路62号博雅星城16#楼16店面
福州上仟贸易有限公司	总经理：陈	地址：福州市闽侯县上街镇建平路99号福建高速物流园12#130-131
闽侯县永诚包装制品有限公司	总经理：宋	地址：福建省福州市闽侯县甘蔗街道大元巷102号
福州亚博天汽车贸易有限公司	总经理：念	地址：福建省闽侯县青口镇新城路62号博雅星城2#楼1层03店面
闽侯县野狼贸易有限公司	总经理：林	地址：闽侯县上街镇美岐小区二期5座107室
福州城森园林景观工程有限公司	总经理：唐	地址：福建省福州市闽侯县南屿镇南前村土溪厝3号
福州市情定依身贸易有限公司	总经理：王	地址：闽侯县上街镇岐头村5-6号
闽侯县洋里诗尧工艺品加工场	联系人：江	地址：福建省福州市闽侯县洋里乡洋里村洋里街西路107号
上海奉贤建设发展（集团）有限公司福州分公司	总经理：钱	地址：福建省福州市闽侯县南屿镇旗山集中工业区8号楼二层
闽侯县千家山农业专业合作社	联系人：林	地址：闽侯县甘蔗镇军民路12号五层楼房
闽侯县众彩广告传媒有限公司	总经理：林	地址：闽侯县祥谦镇枕峰村上塘125号
福州三友装修有限公司	总经理：畅	地址：福建省福州市闽侯县甘蔗街道入城路南侧
青峰（福州）传媒有限公司	总经理：林	地址：闽侯县青口镇升旗村青口街53号
福州市闽侯县圆柏贸易有限公司	总经理：毛	地址：福建省福州市闽侯县上街镇国宾大道338号英泰第一城B区商住楼5#619单元
闽侯县祥顺农林开发有限公司	总经理：邓	地址：福建省福州市闽侯县竹岐乡竹岐村
福州秋实园贸易有限公司	总经理：陈	地址：福州市闽侯县上街镇庄南路1号“博仕后缘墅“E2#103
闽侯县仙和祥原生态农业有限公司	总经理：王	地址：福建省福州市闽侯县洋里乡仙门村坝头自然村3号
福州三友和贸易有限公司	总经理：陈	地址：闽侯县甘蔗街道昙石山西大道98号新城丽景B区10#楼2层214店面
福建神州美景健康管理有限公司	总经理：陈	地址：福州市闽侯县科技东路8号福州高新区海西高新技术产业园创业大厦B区1层157室
福建根艺达工艺品有限公司	总经理：陈	地址：福建省闽侯县上街镇国宾大道1号闽都大庄园沿街商住9#楼1层147店面
福州市闽侯县科阳金属制品有限公司	总经理：陈	地址：福州市闽侯县上街镇沙堤村（闽侯县鑫龙寿五金机械有限公司）2#厂房4层405
福州九易传媒有限公司	总经理：林	地址：闽侯县甘蔗街道入城路横屿233号一楼店面
福建省煜景装饰设计有限公司	总经理：聂	地址：闽侯县上街镇国宾大道276号综合商场7层
福州菜鸟工艺品有限公司	总经理：蔡	地址：闽侯县上街镇闽都大庄园165号店面
闽侯县创鑫木业有限公司	总经理：徐楚	地址：福建闽侯县荆溪镇港头村白头19号
福建同乐食品开发有限公司	总经理：钟紫琳	地址：福州福州闽侯县竹岐乡榕东工业区
闽侯县新云运输装卸队	队长：潘先生	地址：闽侯县荆溪镇关口村3号
福州金叶工艺品有限公司	总经理：金先生	地址：闽侯县上街镇新洲村
福州润景园林景观工程有限公司	总经理：陈先生	地址：闽侯县南屿镇乌龙江南大道33号三盛托斯卡纳125#楼03店面
福建隆晶建材有限公司	总经理：杨先生	地址：闽侯县祥谦镇卜洲村
福州凯润数控机电有限公司	总经理：王先生	地址：闽侯县青口镇壶山村东南千家花园15号
福州旗山红木家具有限责任公司	总经理：赵先生	地址：闽侯县上街镇红峰村
福州鑫业工艺品有限公司	总经理：金先生	地址：闽侯县上街镇新洲村
福州骏龙汽车销售服务有限公司	总经理：陈先生	地址：闽侯县青口镇坊口村马路街189号
闽侯县友隆建筑装饰材料厂	厂长：何先生	地址：闽侯县上街镇马保村
益金行（福州）实业有限公司	总经理：叶先生	地址：福州市闽侯县南通镇南通街108号
福州百龙家居制造有限公司	总经理：林先生	地址：闽侯县甘蔗镇大元巷102号
福州天晓工艺品有限公司	总经理：林先生	地址：闽侯县上街镇马保村3#602
福州安永生物技术有限公司	总经理：王先生	地址：闽侯县甘蔗街道三福小区四路6号第三层
福建恒丰轻工制品有限公司	总经理：薛先生	地址：闽侯县白沙镇南山洋工业区
福州捷扬工艺品有限公司	总经理：陈先生	地址：闽侯县上街镇建平村
闽侯劲翔机电设备有限公司	总经理：江先生	地址：闽侯县白沙镇白沙火车路235号
福州中铁润海置业有限公司	总经理：宋先生	地址：闽侯县荆溪镇徐家村236号
福建聚凯工贸有限公司	总经理：钟先生	地址：福建省福州市闽侯县荆溪镇溪下村溪下158号
闽侯县鸿尾明珍农业综合开发基地	联系人：郑先生	地址：闽侯县鸿尾乡元口村过溪
福州市美和东?投资有限公司	总经理：郑先生	地址：闽侯县甘蔗街道滨江西大道6号1#楼五层
闽侯县鸿尾岩石美锣砂林果场	联系人：张先生	地址：闽侯县鸿尾乡岩石村
闽侯县龙溪农业开发有限公司	总经理：张先生	地址：闽侯县青口镇西台村后义1号
闽侯县华姿工艺品有限公司	总经理：余先生	地址：闽侯县白沙镇南山洋工业集中区
闽侯神龙潭农林发展有限公司	总经理：杨先生	地址：闽侯县竹岐乡竹岐街151号
福州奇创工艺品有限公司	总经理：谢先生	地址：闽侯县甘蔗街道大元村、双池村（陈店湖工业区）
闽侯县鸿尾溪源温春蛟铁件加工场	联系人：温先生	地址：闽侯县鸿尾乡溪元村在头
闽侯县望新再生资源回收有限公司	总经理：王先生	地址：闽侯县青口镇青秀村
闽侯县仙门果蔬专业合作社	联系人：王先生	地址：闽侯县洋里乡仙门村岩头4号
普洛斯（福州）物流仓储有限公司	总经理：王先生	地址：闽侯县南通镇南通街108号
福建闽迪汽车贸易有限公司	总经理：王先生	地址：闽侯县上街镇源通东路59号尚书耕天下花园2#店面1层03店面
宏德盛（福建）科技发展有限公司	总经理：林先生	地址：福州市生物医药和机电产业园（闽侯县南屿镇）
福州融侨双龙旅游发展有限公司	总经理：林先生	地址：闽侯县南屿镇南井村新桥头
闽侯县鑫旺农机专业合作社	联系人：林先生	地址：闽侯县祥谦镇凤港村
福州宏科建材有限公司	总经理：廖先生	地址：闽侯县鸿尾乡超?村1号
福州潮福前味食品有限公司	总经理：旷先生	地址：福州市闽侯县甘蔗街道铁岭西路18号3#厂房2层
闽侯县鸿尾达茂工艺品加工场	联系人：林先生	地址：闽侯县鸿尾乡闽泉公司内2号楼二层
闽侯县鸿尾世江工艺品加工场	联系人：黄先生	地址：闽侯县鸿尾乡闽泉公司内5号楼备料车间
闽侯县鑫旺果蔬专业合作社	联系人：陈先生	地址：闽侯县鸿尾乡桥头村过溪47号
福州紫光科技园投资发展有限公司	总经理：杨红征	地址：福州闽侯县高新区海西高新技术产业园创业大厦B区4层
福州特斯天食品有限公司闽侯加工厂	厂长：郭勇先生	地址：福州市闽侯县（南通镇）马腾村福州海峡冻品市场食品加工包装大楼一层
福州瑞诚兴汽车贸易有限公司	总经理：陈和利	地址：闽侯县青口镇青秀村新道头5号
福州闽侯县顺亿玻璃制品有限公司	总经理：卢勇强	地址：闽侯县上街镇新峰村
福建京诚房地产开发有限公司	总经理：林世清	地址：闽侯县南屿镇五都村楼溪2号
福建鼎利泰物资回收有限公司	总经理：黄翠林	地址：闽侯县甘蔗街道大元村陈店湖工业集中区9号厂房1层
福建省博发投资股份有限公司	总经理：季征南	地址：福州市闽侯县上街镇科技东路福州高新区“海西高新技术产业园”创业大厦A区11层
闽侯县福益工艺品厂	厂长：程道顺	地址：闽侯县甘蔗街道坛石村铁岭
闽侯县邱希峰工艺品加工厂	厂长：邱希峰	地址：闽侯县荆溪镇永丰村湖头9号
闽侯县蓝一海汽车贸易商行	联系人：洪英先生	地址：闽侯县甘蔗街道流洋村（洪桂英、陈道坦）整座
闽侯县虎头岗农业综合开发有限公司	总经理：林秀华	地址：闽侯县竹岐乡火炬村虎头岗
闽侯县欧亚食尚贸易有限公司	总经理：欧孝辙	地址：闽侯县上街镇大洋路1号融汇山水一区19C#楼
福建伯典机械有限公司	总经理：吴恒昌	地址：福州市闽侯县南屿镇高岐村安里68号-1幢
福州六旺担保有限公司	总经理：黄小明	地址：闽侯县南屿镇南前村土K厝
福州瑞丽雅贸易有限公司	总经理：施玲先生	地址：闽侯县荆溪镇溪头工业区徐家村165号
福州新亚途汽车贸易有限公司	总经理：陈先生	地址：福州市闽侯县青口镇义溪路11号（福州新榕钢结构制品有限公司）综合楼整座
闽侯县鸿尾孝铭工艺品加工场	联系人：魏先生	地址：闽侯县鸿尾乡闽泉公司内1号楼一层
福州日发工艺品有限公司	总经理：徐先生	地址：闽侯县上街镇金屿村工贸路福禄坊13#105
闽侯县鸿尾明贵工艺品加工场	联系人：刘先生	地址：闽侯县鸿尾乡闽泉公司内气割区
福州草根工艺品有限公司	总经理：金先生	地址：闽侯县上街镇新洲村
福州新榕城市建设发展有限公司闽侯分公司	总经理：钟先生	地址：闽侯县尚干镇福州市海峡汽车文化广场一期汽车超市二层E厅
闽侯县鸿尾国林工艺品加工场	联系人：代先生	地址：闽侯县鸿尾乡闽泉公司内1号楼二层
福州文光工艺品有限公司	总经理：王先生	地址：闽侯县上街镇岐头村55号
闽侯县鸿尾杨先工艺品加工场	联系人：刘先生	地址：闽侯县鸿尾乡闽泉公司内5号楼备料车间
闽侯县鸿尾明辉工艺品加工场	联系人：刘先生	地址：闽侯县鸿尾乡闽泉公司内2号楼一层
福州凤翔家居装饰品有限公司	总经理：廖先生	地址：闽侯县甘蔗墩园洲工业小区
闽侯县鸿尾家兴工艺品加工场	联系人：唐先生	地址：闽侯县鸿尾乡闽泉公司内1号楼附属楼
福州森活林工艺品有限公司	总经理：吴先生	地址：闽侯县上街镇新洲村二片
闽侯县大湖民兴果蔬专业合作社	联系人：陈先生	地址：闽侯县大湖乡马?村马?28号
中国平安人寿保险股份有限公司福建分公司闽侯南通营销服务部	老板：吴先生	地址：闽侯县南通镇罗洲村方玉英自用房的三、四层
闽侯县上街择意木雕厂	厂长：黄先生	地址：闽侯县上街镇建平村
福州和达汽车销售服务有限公司	总经理：童先生	地址：福州市闽侯县尚干镇浦里村（福厦公路21公里处）
福建瀛洲投资有限公司	总经理：余先生	地址：闽侯县甘蔗街道昙石山西大道33号源泉大酒店六层
闽侯县添怡园保洁有限公司	总经理：黄先生	地址：福建省闽侯县甘蔗街道818大道北侧海京广场商场
福建省闽侯县农资公司南屿第一经营部	老板：董先生	地址：闽侯县南屿镇南井村上井112号
福州祥缘工艺品有限公司	总经理：陈先生	地址：闽侯县上街镇岐安村
大唐（福州）新能源有限公司	总经理：杨先生	地址：福建省福州市闽侯县青口镇青林村
福州铭木工艺品有限公司	总经理：柳先生	地址：闽侯县上街镇红丰村都巡
福州生之养农林开发有限公司	总经理：幺先生	地址：闽侯县白沙镇孔源村168号（原白沙监狱留守处）
闽侯县上街众康宜又佳医药商店	老板：薛先生	地址：闽侯县上街镇新峰村商贸中心8#11号店
福州启政教育咨询有限公司	总经理：冯先生	地址：福州市闽侯县上街镇建平路50号博仕后家园2#楼1层09店面
福州市闽侯旺启来食品有限公司	总经理：郑先生	地址：闽侯县祥谦镇兰圃村闽侯县盛辉物流有限公司2号楼三层
福建龙泰时代建设工程有限公司	总经理：郑先生	地址：闽侯县上街镇浦口村浦口洲87号
福建天创建筑工程有限公司	总经理：任先生	地址：闽侯县甘蔗街道城新区世纪芳洲住宅小区9#楼505单元
闽侯县宏瑞木业有限公司	总经理：吴先生	地址：闽侯县上街镇建平村34号
福建建平电力建设发展有限公司	总经理：刘用平	地址：闽侯县白沙镇埕元村
福州美琪食品有限责任公司	总经理：范雪晖	地址：闽侯县甘蔗街道铁岭西路15号第四栋
福州木艺轩工艺品有限公司	总经理：王震霖	地址：闽侯县上街镇岐安村
福州鑫晖饲料有限公司	总经理：陈机先生	地址：福州市闽侯县荆溪镇关口村
福州利博顺泰房地产开发有限公司	总经理：林秀和	地址：福州市闽侯县甘蔗街道榕洲路58号阳光城领海综合楼106室
福建宏瑞建筑材料有限公司	总经理：朱由墩	地址：闽侯县白沙镇溪头村南山洋工业区268号
福州洪巨担保有限公司	总经理：洪启明	地址：闽侯县甘蔗街道三英村蔗洲路63号
闽侯神龙谷农林有限责任公司	总经理：杨增金	地址：福州市闽侯县竹岐乡榕西村小潭
闽侯县愉翔果蔬农民专业合作社	联系人：章世堂	地址：闽侯县鸿尾乡古洋村
闽侯县廷坪乡赤坑益民农场	联系人：林立务	地址：闽侯县廷坪乡赤坑村
闽侯县青口镇青峰林场	联系人：谢忠建	地址：闽侯县青口镇西台村南阳山
闽侯县杰昌苗圃	联系人：陈鹏先生	地址：闽侯县大湖乡新塘村
闽侯县怀安康护用品有限公司	总经理：徐景星	地址：闽侯县甘蔗街道流洋村
森发（福建）纸业股份有限公司闽侯县青口分公司	总经理：林泉荣	地址：福州市闽侯县青口镇义溪路96号2#厂房
闽侯县养心家禽养殖专业合作社	联系人：黄先生	地址：闽侯县鸿尾乡溪元村石峡3号
福建林丹体育文化发展有限公司	总经理：程伟明	地址：福州市闽侯县甘蔗街道昙石山中大道118号新城丽景A区1#楼2层207店面
福州新雅奇工艺品有限公司	总经理：王先生	地址：闽侯县上街镇岐头村71号
福州向福食品有限公司	总经理：罗先生	地址：闽侯县上街镇侯官村上市（原上街供销社厂房）
福州虎跃工艺品有限公司	总经理：王先生	地址：闽侯县上街镇岐头村28-7号
闽侯县南通隆光工艺品加工场	联系人：杨先生	地址：闽侯县南通镇马腾村村东5号前面
福建省德众汽车贸易有限公司	总经理：黄先生	地址：闽侯县甘蔗街道昙石山西大道98号新城丽景B区10#楼1层116店面
福州谷禾贸易有限责任公司	总经理：林先生	地址：福州市闽侯县上街镇源通东路59号尚书耕天下花园6#楼202单元
福建宝岛眼镜（连锁）有限公司闽侯甘蔗经营部	老板：林先生	地址：闽侯县甘蔗街道街心路
闽侯县鑫发燃料油贸易有限公司	总经理：陈先生	地址：闽侯县甘蔗街道福古路海京楼B2#403
福州耀中汽配有限公司	总经理：叶先生	地址：闽侯县青口镇宏三村（福州市祥意鞋材有限公司内）
福州市伊力发贸易有限公司	总经理：洪鼎美	地址：闽侯县甘蔗街道化龙村福龙巷7号
卫蓝（福建）生物科技有限公司	总经理：邓阿顺	地址：闽侯县甘蔗街道铁岭西路19号4#、5#厂房
福建南方物流有限公司	总经理：徐高明	地址：闽侯县尚干镇良安路26号
福州嘉驰汽车配件有限公司	总经理：卓学圣	地址：闽侯县青口镇东台村
福州元乔工艺品有限公司	总经理：陈华先生	地址：闽侯县上街镇金屿村
福州久森工艺品有限公司	总经理：陈爱香	地址：闽侯县上街镇建平村建平安置房2#603
福建闽声文化产业投资有限责任公司	总经理：梅先生	地址：闽侯县甘蔗街道校园路52号
闽侯县祥谦大众食品厂	厂长：林先生	地址：闽侯县祥谦镇中院后洋23号
闽侯县鼎艺奇卉苗木专业合作社	联系人：洪先生	地址：闽侯县甘蔗镇化龙村亭下后街31号
福州辉腾工艺品有限公司	总经理：吴先生	地址：闽侯县上街镇建平村
闽侯县大恒木业有限公司	总经理：柯先生	地址：闽侯县南屿镇高岐村高岐工业园区1栋1楼
闽侯县平安烟花爆竹有限公司	总经理：江先生	地址：闽侯县甘蔗街道街心路59号
福州恒诚投资管理股份有限公司	总经理：季先生	地址：闽侯县上街镇科技东路海西高新技术产业园创业大厦A区11层
福州闽宇贸易有限公司	总经理：陈先生	地址：闽侯县南通镇海峡副食品批发市场3116号店
闽侯县鸿尾端吕农业综合农场	联系人：陈先生	地址：闽侯县鸿尾乡元口村程湾
宇欢（闽侯）食品有限公司	总经理：陈先生	地址：闽侯县南屿镇高岐工业区（高岐村安厦53号）2#厂房
闽侯县鸿尾鸿新工艺厂	厂长：陈先生	地址：闽侯县鸿尾乡大模村过山12号
闽侯县帝苑投资有限公司	总经理：程先生	地址：闽侯县荆溪镇永丰村
闽侯县卓悦纺织有限公司	总经理：黄先生	地址：闽侯县南屿镇江口村九石王丘45号
福建省康辉国际旅行社股份有限公司闽侯营业部	老板：徐先生	地址：闽侯县荆溪镇徐家村266号（程雪妹住宅）
闽侯溪头老虎湾脐橙场	联系人：刘先生	地址：闽侯县白沙镇溪头村可河（刘慎霖厝）
福州揽郡汽车销售服务有限公司	总经理：陈先生	地址：闽侯县青口镇农光村新城路博雅星城18#楼403单元
福州邦成油脂有限公司	总经理：余先生	地址：闽侯县荆溪镇厚屿村216号福州粮食批发交易市场油脂批发中心二楼厂房04号
闽侯县南屿国文鞋面加工场	联系人：王先生	地址：闽侯县南屿镇元峰村小元52号
闽侯县春风农林开发有限公司	总经理：李先生	地址：闽侯县竹岐乡春风村
闽侯县广通通讯有限公司	总经理：池先生	地址：闽侯县鸿尾乡安樟村
福建神农后人生物科技有限公司	总经理：陈先生	地址：福州市闽侯县上街镇科技东路海西高新技术产业园创新园10号楼1层
福州长洋机械设备有限公司	总经理：林先生	地址：闽侯县南屿镇窗厦村村前
福建省睿隆贸易有限公司	总经理：邱先生	地址：闽侯县上街镇金屿村3#楼1层10店面
闽侯县社坑绿化苗木专业合作社	联系人：刘先生	地址：闽侯县大湖乡坂头村社坑1号
闽侯县年利农业专业合作社	联系人：何先生	地址：闽侯县青口镇宏二村
福建省东闽建设发展有限公司	总经理：胡先生	地址：福州市闽侯县甘蔗街道大元村、双池村（闽侯县孚达工艺制品厂内）办公综合楼1层
闽侯清之源食品有限公司	总经理：廖先生	地址：福州市闽侯县甘蔗街道铁岭西路21号4#厂房2层
福建伟兴生态农业开发有限公司	总经理：黄先生	地址：闽侯县南通镇瓜山村（潘钦松住宅）
福州市闽侯县启程教育信息咨询有限公司	总经理：于先生	地址：闽侯县上街镇蔗洲村2号地商业网点第贰幢第叁层第壹号店面
福建海峡文化创意产业股权投资合伙企业（有限合伙）	联系人：福建海峡文化产业股权投资管理有限公司	地址：福建闽侯县甘蔗镇校园路52号
福州立林精美工艺品有限公司	总经理：林茂官	地址：闽侯县上街镇红峰村上街根雕展示交易中心1号楼2层28号商铺
福州木缘工艺品有限公司	总经理：吴耀先生	地址：闽侯县上街镇建平村（）欧阳云銮住宅）
福建省闽侯县圣龙贸易有限公司	总经理：林挺煊	地址：福州市闽侯县南屿镇南旗村顶尾新村一楼
福州旗瑞物业管理有限公司	总经理：何文魁	地址：闽侯县南屿镇江口村
福州轩辉置业有限公司	总经理：张轩松	地址：闽侯县南通镇南通街108号
福州闽翔通讯工程有限公司	总经理：周先生	地址：闽侯县上街镇邱阳东路2号弘绘菁华园弘绘楼1层03店面
福州旭辉工艺品有限公司	总经理：林先生	地址：闽侯县上街镇新峰村（林星）自用房整座
福建郑和复兴生物信息科技有限公司	总经理：陈先生	地址：福州市闽侯县上街镇科技东路福州高新区“海西高新技术产业园”创新园10号楼1层
闽侯县大罕农业专业合作社	联系人：沈先生	地址：闽侯县鸿尾乡大罕76号
福州沃德嘉汽车贸易有限公司	总经理：林先生	地址：闽侯县尚干镇浦里，洋中村，祥谦镇泮洋村（福建省闽侯县华源工艺品有限公司内）
宏华（福建）机电有限公司	总经理：林先生	地址：闽侯县甘蔗街道官?路33号
福建振豪建设有限公司	总经理：陈先生	地址：闽侯县青口镇农光村新城路博雅星城14#109室
闽侯县甘蔗王清海装修材料店	老板：王先生	地址：闽侯县甘蔗街道校园路
福建青禾源景观工程有限公司	总经理：周先生	地址：闽侯县南屿镇中溪村溪坂15号
闽侯县智诚企业管理有限公司	总经理：李先生	地址：闽侯县南屿镇流洲村浦口42号
福州大世界现代农业发展有限公司	总经理：郑先生	地址：闽侯县荆溪镇厚屿村（福州大世界橄榄有限公司内）
闽侯县甘蔗快乐农场	联系人：李先生	地址：闽侯县甘蔗街道三英小区
福州王氏精美工艺品有限公司	总经理：王先生	地址：闽侯县上街镇建平村后山002号
闽侯县永联彩钢有限公司	总经理：姜先生	地址：闽侯县荆溪镇荆溪村
闽侯县上街利详鞋面加工厂	厂长：陈先生	地址：闽侯县上街镇金屿村金桥105号
福州森潮根雕工艺品有限公司	总经理：庄先生	地址：闽侯县上街镇红峰村上街根雕展示交易中心2号楼2层27号商铺
裕鑫达（福州）金属设备制造有限公司	总经理：唐成先生	地址：闽侯县南通镇罗洲村（霖力达）2#厂房整座
中山市紫丁香实业有限公司福州分公司	总经理：林德育	地址：闽侯县南屿镇后山村（福州长征珠宝有限公司）1#厂房第三层
福州闽润涂料有限公司	总经理：应先生	地址：闽侯县甘蔗街道陈店湖工业区
福州兴齐兴家居装饰品有限公司	总经理：刘景奇	地址：闽侯县甘蔗街道官?路36号3#厂房
闽侯县圣隆快递有限公司	总经理：陈瑞强	地址：闽侯县甘蔗镇坛石村文博路27号
福建恒景建设工程有限公司闽侯分公司	总经理：杨邦耀	地址：闽侯县荆溪镇荆溪村政府集资楼503
福州金易奥环保节能技术有限责任公司	总经理：王其安	地址：闽侯县南通镇福通路1号（福建明通环境工程科技有限公司综合楼第二层）
闽侯县牧旺农业专业合作社	联系人：江容华	地址：闽侯县青口镇青秀村新道头17号
福州鹏达投资有限公司	总经理：张志朋	地址：闽侯县上街镇建平村金上大道博仕后家园6#连接体10店
闽侯县似锦苗木专业合作社	联系人：高增波	地址：闽侯县上街镇马排村
闽侯县岩山果林农场	联系人：陈孝艳	地址：闽侯县廷坪乡广坪村广坪9号
福州晟南国际贸易有限公司	总经理：余强先生	地址：闽侯县祥谦镇祥青路6号
闽侯县绿地丰生物科技有限公司	总经理：欧光明	地址：闽侯县竹岐乡苏洋村
福建同元龙旺文化古镇旅游开发有限公司	总经理：薛斌先生	地址：闽侯县竹岐乡竹岐街151号
福州天润生物技术有限公司	总经理：陈欣先生	地址：闽侯县竹岐乡竹岐街151号
闽侯县四绿农林综合开发有限公司	总经理：孔先生	地址：闽侯县洋里乡梧洋村
福州通森德机电设备有限公司	总经理：李先生	地址：闽侯县竹岐乡榕西村23号1层
闽侯县叶洋鹅山橄榄专业合作社	联系人：林先生	地址：闽侯县甘蔗街道双池村叶洋鹅山
福州凯航劳务派遣有限公司	总经理：张先生	地址：闽侯县青口镇农光村新城路博雅星城20#楼505单元
福州奋发装潢有限公司	总经理：邓先生	地址：闽侯县竹岐乡榕东村（福州福惠工艺品有限公司）5#厂房一层A区
闽侯县利亚贸易有限公司	总经理：陈先生	地址：闽侯县甘蔗镇化龙村（李赛英厝）
闽侯县祥谦龙泰家具加工场	联系人：张先生	地址：闽侯县祥谦镇泮洋村
福州闽运汽车客运西站有限责任公司	总经理：高先生	地址：闽侯县上街镇广贤路5号
福建凯涵建设发展有限公司	总经理：陈先生	地址：闽侯县荆溪镇永丰村山尾14号
闽侯县青口闫永废品收购场	联系人：阮先生	地址：闽侯县青口镇坊口村
福建睿华管理咨询有限公司	总经理：刘先生	地址：闽侯县青口投资区东南（福建）汽车工业有限公司综合办公楼
福州路易通物流有限公司	总经理：陈先生	地址：闽侯县甘蔗镇铁岭工业区二期10号路
闽侯县上街鑫达铝塑门窗加工厂	厂长：林先生	地址：闽侯县上街镇建平村后山31号
福建福清汇通农村商业银行股份有限公司大学城支行	联系人：张锦煌	地址：闽侯县上街镇源通东路59号尚书耕天下花园3#楼1层9-14店面
闽侯县运坦农业专业合作社	联系人：刘运坦	地址：闽侯县南通镇泽洋村
闽侯县康民养蜂专业合作社	联系人：沈大胜	地址：闽侯县上街镇岐安村岐西片
闽侯县吉祥贸易有限公司	总经理：李明忠	地址：闽侯县尚干镇后村市场新村50号
福州远翔斯巴鲁汽车销售服务有限公司	总经理：施华霖	地址：闽侯县青口镇镜上村口324国道北侧（榕泰汽车会所旁）
福州中全工艺品有限公司	总经理：许先生	地址：闽侯县上街镇岐头村13号
福州闽辉汽车贸易有限公司	总经理：黄先生	地址：闽侯县青口镇农光村4#105-106
闽侯县上街欣华榕工艺品厂	厂长：王先生	地址：闽侯县上街镇岐安村岐安花园19-5座一层
福州蜗牛广告传媒有限公司	总经理：黄先生	地址：闽侯县上街镇建平村金上大道博仕后花园4#03店面
福州洪山牧业发展有限公司	总经理：林先生	地址：闽侯县上街镇国宾大道1号闽都大庄园沿街商住1-7#楼39-42店面
闽侯县南屿盛世红工艺厂	厂长：陈先生	地址：闽侯县南屿镇后山村（福州长征珠宝有限公司）1#四层
福建携程投资有限公司	总经理：郑先生	地址：闽侯县鸿尾乡奎石村
闽侯县荆溪漆彩脱胎漆器厂	厂长：方先生	地址：闽侯县荆溪镇古山洲村
福建中玻蓝星特种玻璃有限公司	总经理：郑先生	地址：闽侯县祥谦镇澜澄村
福州聚兴投资有限公司	总经理：金先生	地址：闽侯县上街镇新峰村上街商贸中心1#14号店
福州冠洋工艺品有限公司	总经理：陈先生	地址：闽侯县上街镇侯官村过洋厝10号
福州泰宇木业有限公司	总经理：王先生	地址：闽侯县上街镇岐头村58号
柳州市乐伊净水设备有限责任公司闽侯分公司	总经理：李先生	地址：闽侯县南屿镇后山元峰村（福州福龙膜科技开发有限公司）1#厂房
福建天瑞医药有限公司闽侯县第二门市部	老板：陈先生	地址：闽侯县荆溪镇厚屿村甘洪路北侧
闽侯县鸿尾宝照轮胎店	老板：吴先生	地址：闽侯县鸿尾乡奎石村
闽侯县青口一语办公用品店	老板：吴先生	地址：闽侯县青口镇宏一村
闽侯县青口爽歪歪儿童游乐园	联系人：吴先生	地址：闽侯县青口镇海韵路1号海韵国际城18幢41号店
闽侯县上街金鑫榕便利店	老板：吴先生	地址：闽侯县上街镇榕桥村集中28号
闽侯县南屿吴君义食杂店	老板：吴先生	地址：闽侯县南屿镇江口农贸市场
闽侯县祥谦榕泰山水清华茶坊	联系人：吴先生	地址：闽侯县祥谦镇祥通路1号榕泰汽车会所一楼东侧
闽侯县青口成都桥头鱼庄	联系人：秦先生	地址：闽侯县青口镇农光村
闽侯县甘蔗丽文电信服务部	老板：穆先生	地址：闽侯县甘蔗街道五福小区2#楼304单元
闽侯县南通增强日杂店	老板：张先生	地址：闽侯县南通镇桥街村桥边路
闽侯县南屿唐建荣食杂店	老板：唐先生	地址：闽侯县南屿镇尧沙村榴花97号
闽侯县大湖梅芳电信服务部	老板：马先生	地址：闽侯县大湖乡湖新路20号
福州海峡副食品批发市场林碧英副食品商行	联系人：陈先生	地址：闽侯县南通镇海峡副食品批发市场2142号店
闽侯县上街美味园快餐店	老板：黄先生	地址：闽侯县上街镇蔗洲村工程学院店面2#22号
福州海峡果品批发市场群龙商行	联系人：叶先生	地址：闽侯县南通镇海峡果品批发市场4号棚269号
闽侯县竹岐鼎飞轮胎店	老板：唐先生	地址：闽侯县竹岐乡竹岐村276号
闽侯县上街紫罗兰休闲中心	联系人：邱先生	地址：闽侯县上街镇新峰村新宅
闽侯县上街一加一服饰店	老板：吴先生	地址：闽侯县上街镇博仕后购物广场3-2号楼一层149区位
闽侯县上街顺珍饲料店	老板：王先生	地址：闽侯县上街镇红峰村红沙路邱阳老人会前面店面
闽侯县上街泼辣鱼川菜馆	联系人：向先生	地址：闽侯县上街镇福大学生公寓东北角学园路转弯处
闽侯县上街闽鑫源园林机械设备经营部	老板：陈先生	地址：闽侯县上街镇建平路50号博仕后家园2#楼1层2店面
闽侯县上街米罗发型店	老板：陈先生	地址：闽侯县上街镇国宾大道233号博仕后购物广场1-2号楼一层101、102、122区位
闽侯县上街老周沙县小吃店	老板：周先生	地址：闽侯县上街镇新街12#、13#楼连接体19#店面
闽侯县上街海蓝色主题宾馆	联系人：饶先生	地址：闽侯县上街镇岐安村商业中心A楼四层
闽侯县上街关福艾秀理发店	老板：张先生	地址：闽侯县上街镇国宾大道233号博仕后家园B区3-2#一层108-109
闽侯县青口福文办公用品店	老板：刘先生	地址：闽侯县青口镇壶山村东南千家花园6#-5#9号店面
闽侯县南屿首艺美发店	老板：宋先生	地址：闽侯县南屿镇南屿街
闽侯县荆溪永鑫电机电动工具维修部	老板：林先生	地址：闽侯县荆溪镇徐家村149#一层店面
闽侯县荆溪衣见钟情内衣坊	联系人：林先生	地址：闽侯县荆溪镇厚屿村（建行对面）
闽侯县荆溪新月铝合金店	老板：黄先生	地址：闽侯县荆溪镇徐家村
闽侯县荆溪伟林五金商行	联系人：程先生	地址：闽侯县荆溪镇厚屿新街
闽侯县荆溪丽景商务宾馆	联系人：林先生	地址：闽侯县经济技术开发区一期三号路旁关口村转产转业2#楼二层
闽侯县荆溪宏鑫电机维修部	老板：王先生	地址：闽侯县荆溪镇徐家村（荆溪国税正对面）252-2号店面
闽侯县荆溪官源电信专营店	老板：李先生	地址：闽侯县荆溪镇关东村西境53号第3间店面
闽侯县荆溪昌扩酒坊	联系人：刘先生	地址：闽侯县荆溪镇厚屿村新街
闽侯县鸿尾衣网情深服装店	老板：赵先生	地址：闽侯县鸿尾乡石佛头街市场内
闽侯县鸿尾帝豪茶艺居	联系人：吴先生	地址：闽侯县鸿尾乡石佛头街110号
闽侯县鸿尾楚楚童装店	老板：徐先生	地址：闽侯县鸿尾乡石佛头街农贸市场内
闽侯县甘蔗永发五金店	老板：洪先生	地址：闽侯县甘蔗镇山前村入城路（八一八西路七号B）
闽侯县甘蔗尚茶坊茶艺居	联系人：许先生	地址：闽侯县甘蔗街道员工公寓店面35#D01至D03
闽侯县甘蔗闽邹洲美容会所	所长：邹先生	地址：闽侯县甘蔗街道街心路41号第22号店面
闽侯县甘蔗礼惠鞋包店	老板：陈先生	地址：闽侯县甘蔗街道街心路41号电力公寓沿街底层15-2号店面
闽侯县甘蔗君安门业经营部	老板：朱先生	地址：闽侯县甘蔗街道入城路店面122号右边一间
闽侯县南屿林雨自行车修理店	老板：林先生	地址：闽侯县南屿镇窗厦村村前2号
闽侯县南屿贝倍乐孕婴用品店	老板：钟先生	地址：闽侯县南屿镇江口村龙好公路旁
闽侯县祥谦通宝日杂店	老板：黄先生	地址：闽侯县祥谦镇辅翼村宫前11号
闽侯县甘蔗惠万家五金水暖店	老板：叶先生	地址：闽侯县甘蔗镇818大道北侧海京广场103店
闽侯县南屿美家净建材店	老板：林先生	地址：闽侯县南屿镇南前村园里前5号
闽侯县南通刘碧英食杂店	老板：刘先生	地址：闽侯县南通镇马腾村
闽侯县南屿日旺五金店	老板：林先生	地址：闽侯县南屿镇江口九石2栋103号
闽侯县甘蔗三英明?煎包店	老板：洪先生	地址：闽侯县甘蔗街道三英村蔗洲路114号
闽侯县上街万佳博学超市	联系人：叶先生	地址：闽侯县上街镇福州大学旗山校区学生生活区29号架空层
闽侯县荆溪公标五金店	老板：李先生	地址：闽侯县荆溪镇关东村西境49号
闽侯县南通祥光蔬果配送店	老板：陈先生	地址：闽侯县南通镇陈厝村
闽侯县南屿欣洛配件店	老板：宋先生	地址：闽侯县南屿镇江口九石2栋101号
福州海峡副食品批发市场姚氏食品商行	联系人：刘先生	地址：闽侯县南通镇海峡副食品批发市场2148店
福州海峡果品批发市场郭翔商行	联系人：郭先生	地址：闽侯县南通镇海峡果品批发市场4号棚268号
闽侯县南屿诚和不锈钢加工店	老板：李先生	地址：闽侯县南屿镇南旗村旗顶尾（派出所集资楼）
闽侯县尚干依清珠宝店	老板：吴先生	地址：闽侯县尚干镇祥谦路232号
闽侯县青口镇清美日用品咨询服务部	老板：周先生	地址：闽侯县青口镇壶山村千家花园11#305
闽侯县竹岐便民电焊店	老板：郑先生	地址：闽侯县竹岐乡竹岐街278号
闽侯县荆溪饼饼世家蛋糕坊	联系人：张先生	地址：闽侯县荆溪镇荆溪村
闽侯县荆溪张翠彩票店	老板：张先生	地址：闽侯县荆溪镇港头村
闽侯县甘蔗新鑫磊石材店	老板：杨先生	地址：闽侯县甘蔗镇入城路北侧海京楼8#幢店5号
闽侯县鸿尾明仔小吃店	老板：杨先生	地址：闽侯县鸿尾乡石佛头街82号
闽侯县甘蔗老严五金店	老板：严先生	地址：闽侯县甘蔗镇南山安置房8号店面
闽侯县上街好朋友铝合金加工店	老板：鄢先生	地址：闽侯县上街镇红峰村沙堤文明村南起第二直
闽侯县上街美之源美发店	老板：许先生	地址：闽侯县上街镇红峰村宪窗（许善仕、许和仁宅一层）
闽侯县甘蔗万年石材店	老板：吴先生	地址：闽侯县甘蔗街道八一八大道北侧东方花园1#幢111店
闽侯县南通富强电动自行车店	老板：池先生	地址：闽侯县南通镇陈厝村国道旁
闽侯县大湖娇?窗帘店	老板：黄先生	地址：闽侯县大湖乡大湖街14号
闽侯县白沙延端床上用品店	老板：李先生	地址：闽侯县白沙镇安平路184号
闽侯县上街力信图文工作室	联系人：杜先生	地址：闽侯县上街镇福建师范大学新校区生活区B区翠竹园二楼学子超市内
闽侯县甘蔗丽珠建材商行	联系人：程先生	地址：闽侯县甘蔗镇818大道县委统战部综合楼103、104店面
闽侯县南通惠友冻品店	老板：陈先生	地址：闽侯县南通镇陈厝街西89号
闽侯县南通三姐妹建材店	老板：冯先生	地址：闽侯县南通镇洲头村
闽侯县上街薇薇公主服饰店	老板：王先生	地址：闽侯县上街镇福建师范大学旗山校区文化街129B号
闽侯县南屿高旗汽车租赁服务部	老板：王先生	地址：闽侯县南屿镇高岐村国道边
闽侯县上街龙腾美食园	联系人：滕先生	地址：闽侯县上街镇大学城蔗洲村2#商业店面第叁幢第壹层
闽侯县上街拖拖拉啦鞋包店	老板：钱先生	地址：闽侯县上街镇福建师范大学旗山校区文化街223号
闽侯县青口一品坊服装店	老板：潘先生	地址：闽侯县青口镇农光村新城路博雅星城14#店面03
闽侯县甘蔗益源居日用品商行	联系人：潘先生	地址：闽侯县甘蔗街道昙石村入馆路五栋（一楼7-8间）
闽侯县甘蔗华明电动工具店	老板：莫先生	地址：闽侯县甘蔗街道818大道县委统战部综合楼123号
闽侯县上街三六一度专卖店	老板：卢先生	地址：闽侯县上街镇金屿村农村信用社旁（原中国农业银行大学城支行办公楼）
闽侯县上街玖久超市	联系人：程先生	地址：闽侯县上街镇大学城蔗洲村2#商业网点第三幢第壹层第21-22店面
闽侯县祥谦东方铝合金门店	老板：黄先生	地址：闽侯县祥谦枕峰村（福建省福州文化用品批发公司内）
闽侯县荆溪梳阁兰美容美发店	老板：程先生	地址：闽侯县荆溪关口366号福建卫生职业技术学院学生公寓楼12号楼7号店
闽侯县晶鑫建材贸易有限公司	总经理：吴秀华	地址：闽侯县祥谦镇凤港村
福州市味美达食品有限公司	总经理：王碧岩	地址：闽侯县南通镇农产品物流中心海峡副食品批发市场3247商铺
福州市光阳丽步木业有限公司	总经理：詹松斌	地址：闽侯县荆溪镇港头村白头岭头后洋
中国移动通信集团福建有限公司闽侯南屿营业厅	联系人：赵鸿恩	地址：闽侯县南屿镇南旗村（南屿国有林场）
闽侯大丰工艺品有限公司	总经理：罗汀浔	地址：闽侯县甘蔗街道墩园洲工业区
福建欣旺物资再生利用有限公司	总经理：江年炉	地址：闽侯县荆溪镇关口村工业厂区
福州市博旺家居饰品有限公司	总经理：黄香旺	地址：闽侯县甘蔗街道长江村
闽侯县铭铧果蔬专业合作社	联系人：谢兆锋	地址：闽侯县鸿尾乡南元村南边28号
福建省贤诚建设发展有限公司	总经理：方玉辉	地址：福建省福州市闽侯县上街镇联心村创业楼103、104室
福州市闽侯县闽旺酒店用品有限公司	总经理：林建兴	地址：闽侯县南屿镇南旗村
闽侯县榄之香生态农业有限公司	总经理：吴总	地址：闽侯县榄之香生态果园区
福建华奥汽车有限公司	总经理：陈清池	地址：闽侯县尚干镇良安路20号
福建中舜环保科技有限公司闽侯分公司	总经理：徐慧钦	地址：闽侯县上街镇新峰村
福州建平雕刻工艺品有限公司	总经理：陈水利	地址：闽侯县上街镇建平村董屿203号
福建省闽侯县鑫榕新纸业有限公司	总经理：林学庸	地址：福建省闽侯县竹岐乡南洋村洋尾71号
福建谊荣机械有限公司	总经理：杨婕	地址：福州市闽侯县经济技术开发区一期铁岭工业园9中路9号
福州天趣根艺有限公司	总经理：邱日炎	地址：闽侯县上街镇建平村四中
福州花屿工艺品有限公司	总经理：林铸钟	地址：闽侯县上街镇丹屿村119号
闽侯县亿荣农业开发有限公司	总经理：陈祖津	地址：闽侯县竹岐乡山洋村下洋11号
闽侯县安顺鑫脚手架有限公司	总经理：方福安	地址：闽侯县青口镇白水路文华综合楼一层03店面
福建省海都公众服务股份有限公司	总经理：孙德坚	地址：福州市闽侯县甘蔗街道校园路52号
闽侯县爱家装饰材料加工厂	厂长：段希望	地址：闽侯县上街镇马堡村
福州靓品商贸有限公司	总经理：林平	地址：闽侯县上街大学城国宾大道233号
闽侯县青绿环境服务有限公司	总经理：林飞雁	地址：闽侯县青口镇镜上村
福州市闽侯锦盛工贸有限公司	总经理：吴榕	地址：闽侯县青口镇宏三村
福建盛世弘光文化传播有限公司	总经理：鲍岸菲	地址：闽侯县南屿镇后山村旗山工业集中区15号（福建闽丰科技种业有限公司内）
福建闽侯晟达家居装饰品有限公司	总经理：陈达	地址：闽侯县荆溪镇光明村新街
闽侯县灌园叟农业开发有限公司	总经理：苏友基	地址：闽侯县荆溪镇关中村中元
福州容大生物科技研究有限公司	总经理：潘冰	地址：闽侯县甘蔗街道闽侯经济技术开发区一期八号西路1号3#厂房整座4#厂房整座
欧尔东有限公司	总经理：翁炜	地址：福建省福州市生物医药和机电产业园区(闽侯县南屿镇）
闽侯县甘泉茶业专业合作社	联系人：梁	地址：闽侯县洋里乡梧洋村
闽侯县永利包装用品厂	厂长：林	地址：闽侯县祥谦镇中院村（福建省闽侯华辉橡塑制品有限公司第二层）
福州市闽侯县福锦记食品有限公司	总经理：严	地址：闽侯县祥谦镇兰圃村闽侯县盛辉物流有限公司2座三层
闽侯县佛尤斯体育用品有限公司	总经理：田	地址：闽侯县上街镇新洲村
福州市闽侯广元贸易有限公司	总经理：陈	地址：闽侯县尚干镇新榕路1号海峡汽车文化广场汽车超市一层A-103号
福州欣润达汽车贸易有限公司	总经理：林	地址：闽侯县?干镇（福州市青口投资区）福州海峡汽车文化广场一期汽车超市三层C区6号
闽侯县青口正坤家用电器商行	联系人：张	地址：闽侯县青口镇升旗村
闽侯县南屿思源角梳加工厂	厂长：江	地址：闽侯县南屿镇南前村南溪19号
闽侯县昱欣工艺品厂	厂长：陈	地址：闽侯县南通镇罗洲村
闽侯县南通尤氏汽车椅套加工厂	厂长：尤	地址：闽侯县南通帮道村东18号
福州吉屋时装有限公司	总经理：陈	地址：闽侯县荆溪镇关西村福州俊威建材有限公司内
中国移动通信集团福建有限公司闽侯卫生技术学院营业厅	联系人：赵	地址：闽侯县荆溪镇福建卫生职业技术学院学生公寓4号楼东侧架空层
闽侯县桥溪蔬菜专业合作社	联系人：瞿	地址：闽侯县鸿尾乡桥头村坂头56号
福州市农电服务有限公司闽侯分公司	总经理：冯	地址：闽侯县甘蔗街道818西路24号
闽侯县隆山综合农场	联系人：张	地址：闽侯县大湖乡岭头村山东自然村
福建盛世经典餐饮管理有限公司闽侯昙石山分公司	总经理：许	地址：福州市闽侯县昙石山西大道3号永辉超市A101、A201商铺
福建富通汽车服务有限公司	总经理：朱	地址：福州市闽侯县上街镇新峰村
福建天邦工程建设发展有限公司	总经理：陈	地址：福建省闽侯县甘蔗街道入城路北侧海京楼8#楼508
闽侯县金鑫有机蔬菜专业合作社	联系人：金鑫	地址：闽侯县竹岐乡火炬村
福州瑞盛电气自动化技术有限公司	总经理：范新权	地址：福州市闽侯县上街镇科技东路高新区“海西高新技术产业园”创业大厦A区19层
福建省鹏基投资发展有限公司	总经理：倪兆明	地址：福建省福州市闽侯县南通镇新岐村东70号
闽侯县盛世君汉茶业有限公司	总经理：吴健	地址：闽侯县上街镇英泰第一城商住楼K1幢11#、12#、13#
闽侯县乐嘉家政服务部	老板：郑颍	地址：闽侯县白沙镇白沙新城闽兴大道18号楼109店面
闽侯县春来蔬菜种植场	联系人：郑书建	地址：闽侯县洋里乡岭兜村见村4号
闽侯县车保姆汽车租赁服务部	老板：林	地址：闽侯县白沙镇白沙新城18座6号店面
闽侯县荆溪龙凯土工布加工厂	厂长：龚	地址：闽侯县荆溪镇永丰村杜坞知青点
福州科光管理咨询有限公司	总经理：黄	地址：闽侯县铁岭工业集中区二期7号路8号
闽侯县奥丽斯服饰有限公司	总经理：陈	地址：闽侯县上街镇上街村丹屿69号
福建青大物流有限公司	总经理：郑	地址：闽侯县青口镇前街村金山加油站旁16号村
闽侯县华义金属制品厂	厂长：吴	地址：闽侯县大湖乡珍山村花林亭
闽侯县南屿创丰纺织加工场	联系人：宋	地址：闽侯县南屿镇江口村后双龙好公路边
福州腾旭电线电缆有限公司	总经理：刘	地址：闽侯县南屿镇南前村洋中厝22号（原农机配件厂含主厂房车间右侧）
福建省闽侯县八闽工程机械有限公司	总经理：许	地址：闽侯县白沙镇埕元242号
闽侯县天顺农业开发有限公司	总经理：程	地址：闽侯县大湖乡雪峰村
福建永通电线电缆有限公司	总经理：刘	地址：福州市生物医药和机电产业园区（闽侯县南屿镇南井村新桥头）
福州大洋鹭洲房地产开发有限公司	总经理：林	地址：闽侯县上街镇大洋路2号
闽侯县鸿尾朝峰建材加工场	联系人：吴	地址：闽侯县鸿尾乡元口村
福州绿蔬农业发展有限公司	总经理：陈	地址：闽侯县竹岐乡南洋村
闽侯县连年兴农林专业合作社	联系人：洪	地址：闽侯县甘蔗街道三英小区
福州市闽侯恒成汽车零部件有限公司	总经理：陈	地址：闽侯县青口镇宏屿村闽南厂5号
闽侯县健欣润滑油有限公司	总经理：陈	地址：闽侯县白沙镇游厝里
福州泽楷贸易有限公司	总经理：程	地址：闽侯县甘蔗镇横屿132号
闽侯县兴源服装鞋帽厂	厂长：刘	地址：闽侯县竹岐乡榕东村福惠工业园
闽侯县星科农业开发有限公司	总经理：郑	地址：闽侯县荆溪镇浦前村
中国联合网络通信有限公司闽侯分公司昙石营业厅	联系人：郑	地址：闽侯县甘蔗街道南山村
闽侯县鑫嘉源建筑材料有限公司	总经理：黄	地址：福建省福州市闽侯县青口镇文华村
闽侯县天力建材有限公司	总经理：王	地址：闽侯县甘蔗街道山前村委会
闽侯县荣辉工艺品有限公司	总经理：王	地址：闽侯县鸿尾乡奎石村114县道旁
闽侯县耐克森橱柜厂	厂长：曾	地址：闽侯县上街镇马保村马保工业区（福州新捷塑胶有限公司内）
闽侯县荆溪黄治禄涂料加工厂	厂长：黄	地址：闽侯县荆溪镇永丰村杜坞23号
闽侯荣晨食品有限公司	总经理：刘	地址：闽侯县鸿尾乡鸿尾村店里160号
闽侯保恩水磨溪农场有限公司	总经理：林	地址：闽侯县南屿镇双龙村保恩大成尾
福州智宏信息技术有限公司	总经理：陈	地址：福州市闽侯县上街镇科技东路高新区“海西高新技术产业园”创业大厦A区16层
福州千龙装饰材料有限公司	总经理：王	地址：福州市闽侯县荆溪镇永丰村
福州明鑫根雕有限公司	总经理：陈	地址：闽侯县上街镇建平村
福州闽安再生资源回收有限公司	总经理：林	地址：福建省福州市闽侯县青口镇镜上村
福州来益桶生物科技有限公司	总经理：赵	地址：闽侯县南屿镇后山工业区
福建圆通仓储有限公司	总经理：陈	地址：闽侯县祥谦镇?前村
福建省福抗药业股份有限公司福州分公司	总经理：施	地址：福州市闽侯县"海西高新技术产业园"创业大厦A区22层
福建创辉市政工程有限公司	总经理：林	地址：福州市闽侯县祥谦镇泮洋村
闽侯县旗山垒鑫农业有限公司	总经理：吴建文	地址：闽侯县南屿镇南旗桥下72号
闽侯盛华船务管理有限公司	总经理：江月华	地址：闽侯县祥谦镇枕峰村委新村北座203
福州太一工贸有限公司	总经理：张鼎清	地址：福州市闽侯县竹岐乡溪口工业区
福州市闽侯县超凡电器贸易有限公司	总经理：陈少彬	地址：闽侯县上街镇上街村（上街线带厂综合楼一层店面）
福州镨瑞森精密工业有限公司	总经理：刘焕	地址：福州市闽侯县荆溪镇徐家村169号5号楼
福州超凌贸易有限公司	总经理：叶晨辉	地址：闽侯县青口镇壶山村东南千家花园2#404房
福州艾贝拓信息技术有限公司	总经理：程文忠	地址：闽侯县甘蔗街道横街
福建凯洲木业有限公司	总经理：姚为双	地址：闽侯县大湖乡东姚村
福建光华天成饲料科技有限公司	总经理：胡宗杰	地址：福建省福州市闽侯县南屿镇元峰村
闽侯县黛尔菲贸易有限公司	总经理：林金城	地址：闽侯县青口镇东南千家花园3#604
闽侯县迅腾电脑网络有限公司	总经理：林东山	地址：闽侯县上街镇新峰梧洋
闽侯县上街友辉线带厂	厂长：林辉	地址：闽侯县上街镇新峰村梧洋20号
闽侯县艾虎纠信息技术有限公司	总经理：郑苏波	地址：闽侯县上街镇新峰村红峰村4#301单元
闽侯县上街金福豆制品有限公司	总经理：林在寿	地址：闽侯县上街镇上街村三橄榄
闽侯川福制衣厂	厂长：何洪	地址：闽侯县上街镇上街村丹屿69号
闽侯县上街经济投资有限公司	总经理：林文	地址：闽侯县上街镇金屿村金桥125号
中国移动通信集团福建有限公司上街大学城闽江营业厅	联系人：林松波	地址：闽侯县上街闽江学院学生生活区第二区第三号楼第二号店面
中国移动通信集团福建有限公司上街大学城技术学院营业厅	联系人：林松波	地址：闽侯县上街福州职业技术学院3号楼东北第五间
中国移动通信集团福建有限公司上街大学城福大营业厅	联系人：林松波	地址：闽侯县上街福州大学生活区三期29#楼架空层
中国移动通信集团福建有限公司上街大学城医科大学营业厅	联系人：林松波	地址：闽侯县上街福建医科大学新校区学生生活区6号楼架空层
中国移动通信集团福建有限公司上街大学城师大营业厅	联系人：林松波	地址：闽侯县上街福建师范大学新校区文化一条街一、二层128、130店面
中国移动通信集团福建有限公司上街大学城工程学院营业厅	联系人：林松波	地址：闽侯县上街福建工程学院学生生活区D区一层
福州鑫鑫汽车零配件有限公司	总经理：黄纪伟	地址：闽侯县青口镇野猫坑[溪东村源兴（福建）汽车配件有限公司内]
福州萱裕金属配套有限公司产品设计中心	联系人：陈彦廷	地址：闽侯县青口镇溪东村萱裕公司内
闽侯县城基金钢沙耐磨地坪材料加工厂	厂长：黄金良	地址：闽侯县青口镇溪东村18号
闽侯县青口学棋集成材木业厂	厂长：张学棋	地址：闽侯县青口镇西台村
福州凯润农资有限公司	总经理：张秀珍	地址：闽侯县青口镇西台村
福州天煌环境保护设备制造有限公司	总经理：吴振煌	地址：闽侯县青口镇投资区（福州宏枫建筑材料有限公司内）
闽侯东南商友财务咨询中心	联系人：张延胜	地址：闽侯县青口镇青口镇133号
福州祥隆贸易有限公司	总经理：吴则飞	地址：闽侯县青口镇吉山新村6＃103
福州泰昌汽车座椅开发有限公司	总经理：小林英雄	地址：闽侯县青口镇吉山村
福州汇祥建筑安装工程有限公司闽侯分公司	总经理：叶宏星	地址：闽侯县青口镇壶山村新南公寓1号楼506
福建兴顺物流有限公司	总经理：陈碧珍	地址：闽侯县青口镇宏四村（国道旁）
闽侯县青口易达通讯器材有限公司	总经理：林铭	地址：闽侯县青口镇宏三村
闽侯县盛昌包装制品有限公司	总经理：吴秋祥	地址：闽侯县青口镇宏二村浦底
闽侯县钜源橡塑制品有限公司	总经理：何维	地址：闽侯县青口镇付竹莲峰村福厦路北侧（福州胜金电器企业有限公司）
闽侯县源恒汽配有限责任公司	总经理：林伟忠	地址：闽侯县青口镇付竹莲峰村（福州胜金电器有限公司内）
闽侯县闽升钢材制品有限公司	总经理：林兆铣	地址：闽侯县青口镇付竹莲峰村（福州胜金电器企业有限公司内）
闽侯县青口华金汽车配件经销部	老板：黄华金	地址：闽侯县青口镇付竹村沈厝场51号
闽侯县青口丰华机械厂	厂长：李丰	地址：闽侯县青口镇福州永圣机械电器有限公司内
闽侯县南屿三岐建筑材料厂	厂长：刘锦忠	地址：闽侯县南屿镇晓岐村
闽侯县绿强营林有限公司	总经理：吴君城	地址：闽侯县南屿镇南前村
闽侯县华仁祥农业综合开发有限公司	总经理：张香仁	地址：闽侯县南屿镇茂田村
闽侯县宏辉新型墙材厂	厂长：潘汉冰	地址：闽侯县南屿镇六十份村
闽侯县南屿江口新丰织布厂	厂长：许香英	地址：闽侯县南屿镇江口村浦口1号
福州叶氏家居有限公司	总经理：叶登峰	地址：闽侯县南屿镇高岐工业区
闽侯县长青花卉种植专业合作社	联系人：刘译远	地址：闽侯县南屿镇高岐村
闽侯县三捷服装整理厂	厂长：刘秀明	地址：闽侯县南屿后山工业区
福建正祥置业发展有限公司闽侯分公司	总经理：江映辉	地址：闽侯县南屿国有林场办公大楼五层
闽侯县南港纸制品厂	厂长：张章潮	地址：闽侯县南通镇泽洋村
闽侯县南天蔬菜有限公司	总经理：赵水希	地址：闽侯县南通镇泽苗村
闽侯县农资公司南通第三经营部	老板：杨仲南	地址：闽侯县南通镇泽苗村
福州森鑫日用品有限责任公司	总经理：陈钽	地址：闽侯县南通镇罗洲村
福建省闽侯县三农沼气设备有限公司	总经理：陈豪惠	地址：闽侯县南通镇陈厝街东5号
闽侯县正通机电设备有限公司	总经理：郭海珍	地址：闽侯县荆溪镇永丰村
闽侯县农资公司荆溪第三经营部	老板：张声海	地址：闽侯县荆溪镇徐家村
闽侯县农资公司荆溪第四经营部	老板：吴松坚	地址：闽侯县荆溪镇浦前村
福州欧莱登家居有限公司	总经理：林锦忠	地址：闽侯县荆溪镇荆溪村
闽侯县勤森服饰有限公司	总经理：官舜	地址：闽侯县荆溪镇厚屿村34号
闽侯县日星橄榄种植有限公司	总经理：阮斯荣	地址：闽侯县荆溪镇关西拔仕村15号
福州市闽侯广胜台车修造厂	厂长：张定华	地址：闽侯县荆溪镇(福建八闽汽车总厂制配分厂内)
福建省闽侯县农资公司江洋经营部	老板：周子琴	地址：闽侯县江洋农场江洋村
闽侯县江洋兴航蛋鸡场	联系人：林源	地址：闽侯县江洋农场茶区
闽侯县鸿尾元盛果林场	联系人：吴传政	地址：闽侯县鸿尾乡元口村
闽侯县闽安竹木工艺品厂	厂长：张孝灯	地址：闽侯县鸿尾乡溪源村
福州科丰植保技术服务部闽侯县鸿尾石佛头分部	老板：黄恒尧	地址：闽侯县鸿尾乡石佛头街
闽侯县鸿尾搏兴农业综合场	联系人：涂礼其	地址：闽侯县鸿尾乡桥头村桥头79号
福州锐祥工艺品有限公司	总经理：李依琴	地址：闽侯县鸿尾乡官路横堤
福州建兴石材有限公司	总经理：罗则炮	地址：闽侯县鸿尾乡大模村
福州富力家居饰品有限公司	总经理：郑榆	地址：闽侯县鸿尾乡超?村板洲湾
福建海京建设工程有限公司	总经理：张华	地址：闽侯县甘蔗镇海京楼B2座202
闽侯县天源卫生用品有限公司	总经理：林玉仁	地址：闽侯县甘蔗镇陈店湖工业区
闽侯县永能五金机械配件有限公司	总经理：谢在芳	地址：闽侯县甘蔗街道青岐村188号
福州龙恺家居饰品有限公司	总经理：林素芬	地址：闽侯县甘蔗街道陈店湖工业区
中国邮政储蓄银行有限责任公司闽侯县支行	联系人：王传翥	地址：闽侯县甘蔗街道八一八中路156号
闽侯县仙山农场	联系人：马义荣	地址：闽侯县大湖乡仙山村
闽侯县南洋养殖专业合作社	联系人：王小春	地址：闽侯县大湖乡墙坪村
闽侯县盛源农牧发展有限公司	总经理：林善和	地址：闽侯县大湖乡后洋村
闽侯县丰珍农业有限公司	总经理：廖承杰	地址：闽侯县大湖乡东姚村
闽侯县天益食品有限公司	总经理：刘用邦	地址：闽侯县大湖乡东圪村
福州大湖远峰农牧有限公司	总经理：肖依兴	地址：闽侯县大湖乡大湖街16号
福建省闽侯县山有农林开发有限公司	总经理：朱抒	地址：闽侯县大湖乡大湖村后街40号
福建省电力有限公司闽侯供电局	局长：林敏辉	地址：闽侯县城关818西路24号
闽侯县闽隆物业管理有限公司	总经理：林木?	地址：闽侯县白沙镇新城隆兴北路4#楼
闽侯县明丰机械制造厂	厂长：黄永森	地址：闽侯县白沙镇下浦路55号
福州三发石料有限公司	总经理：黄钗言	地址：闽侯县白沙镇唐举村
闽侯县胜意家?有限公司	总经理：何心钗	地址：闽侯县白沙镇南山洋工业集中区
闽侯县白沙三鑫油料化工经营部	老板：吴威	地址：闽侯县白沙镇马坑村
福州市闽侯县道利玻璃纤维厂	厂长：陈孝光	地址：闽侯县白沙镇联坑村灵峰自然村
福州孔原农业综合开发有限公司	总经理：吴昌钢	地址：闽侯县白沙镇孔元村70号
闽侯县绿闽橄榄专业合作社	联系人：王庆华	地址：闽侯县白沙镇大目埕村三溪口40号
福州村笙制冷设备有限公司	总经理：杨浩正	地址：福建省闽侯县竹岐乡竹岐村
闽侯县绅带种养殖专业合作社	联系人：陈德群	地址：福建省闽侯县洋里乡绅带村桥里35号
闽侯县新日鲜水产养殖有限公司	总经理：林登俊	地址：福建省闽侯县洋里乡岭兜村
福州洋里山泉有限公司	总经理：江昌浩	地址：福建省闽侯县洋里乡岭兜村
福州福丰农牧发展有限公司	总经理：江福丰	地址：福建省闽侯县洋里乡际兜村上元自然村
福州荻原模具冲压有限公司	总经理：渡边弘明	地址：福建省闽侯县祥谦镇洋下村
闽侯县和丰纸业有限责任公司	总经理：林玉桂	地址：福建省闽侯县祥谦镇绿家村
闽侯县鹏远电子加工	联系人：王世鸿	地址：福建省闽侯县祥谦虎山村王厝
闽侯县廷坪乡鲤鱼山综合农场	联系人：陈方泳	地址：福建省闽侯县廷坪乡罗桥村鲤鱼山
闽侯县美林青红豆杉种植有限公司	总经理：曾光美	地址：福建省闽侯县廷坪乡洪山村１号
福州福老酒业有限公司	总经理：陈宗基	地址：福建省闽侯县铁岭工业区
福州源鑫混凝土有限公司	总经理：陈必松	地址：福建省闽侯县上街镇蔗洲村
闽侯县联益贸易有限公司	总经理：陈继晓	地址：福建省闽侯县青口镇商贸街农光综合楼
福州鸿鑫泰贸易有限公司	总经理：林珠英	地址：福建省闽侯县青口镇青口医院对面
闽侯县祥汇海绵有限公司	总经理：郑典祥	地址：福建省闽侯县青口镇梅溪
闽侯县畅捷纸品有限公司	总经理：吴晓川	地址：福建省闽侯县青口镇梅岭村
闽侯县惠铭电子有限公司	总经理：叶月浦	地址：福建省闽侯县青口镇壶山村陶精路千家花园222店面
闽侯县青口世勇木箱加工场	联系人：吴世勇	地址：福建省闽侯县青口镇宏二村衙门8号
福州宝山废品回收有限公司	总经理：许舜武	地址：福建省闽侯县青口镇宏二村(闽侯县隆基汽车配件有限公司内)
福州龙兴祥食品冷冻加工有限公司	总经理：陈本龙	地址：福建省福州市闽侯县上街镇上街村　　　　法定代表人：陈本龙
福州联丰生物技术开发有限公司	总经理：金涛	地址：福建省福州市闽侯县上街工贸开发区　　　法定代表人：金涛
福州利文生物工程有限公司	总经理：萧进华	地址：福建省福州市闽侯县上街镇马排村　　　　法　人：萧进
福州瑞茂工贸有限公司	null	地址：福建省福州市闽侯县青口镇开发区镜上镜厦路北一号
福州乾宇特种动植物研究有限公司	总经理：陈亮	地址：福建省福州市闽侯县荆溪镇光明村大士山
福州汽车运输公司枕峰服务站	null	地址：福建省福州市闽侯县祥谦镇枕峰村
福州喃嵘水产技术设备有限公司	总经理：黄春梅	地址：福建省福州市闽侯县闽江乡峡南村　　　　法定代表人：黄春梅
福州瑞亨陶瓷有限公司	总经理：杨正宗	地址：福建省福州市闽侯县青口投资区
福州荣诚贸易有限公司闽侯分公司	总经理：曾光诚	地址：福建省福州市闽侯县荆溪镇徐家村（七四二七厂内）
福州青茂鞋材有限公司	null	地址：福建省福州市闽侯县青口镇杨厝村
福州旗山万佛禅寺	联系人：释广霖	地址：福建省福州市闽侯县南屿镇中溪村
福州旗山农牧综合场	null	地址：福建省福州市闽侯县上街镇旗山
福州浦江建筑机械有限公司	总经理：郭坚	地址：福建省福州市闽侯县永丰３２２７０部队内
福州农业科技园区管理委员会	联系人：潘桂光	地址：福建省福州市闽侯县荆溪镇
福州敬业旅游用品有限公司	null	地址：福建省福州市闽侯县青口投资区
福州警木维尔贸易有限公司	总经理：陈相如	地址：国货东路象园村尾（闽侯县农业机械公司内）
福州市淡水养殖中试基地	联系人：林本兴	地址：福建省福州市闽侯县荆溪镇永丰杜坞２号
福州市郊区秀云食杂店	null	地址：福建省福州市晋安区台江镇国货路东段闽侯县农机公司边
福州市隆特禽业有限公司	null	地址：福建省福州市闽侯县荆溪镇桐口林场
福州宏薇贸易有限公司	总经理：黄镇国	地址：福建省福州市闽侯县上街镇美岐村
福州回春生物制品有限公司	总经理：何厚中	地址：福建省福州市闽侯县甘蔗镇五福村　　　　法定代表人：
福州宏安经济发展公司闽侯分公司	null	地址：福建省福州市闽侯县甘蔗镇校园路128号
福州恒强服装制品有限公司（工商已吊销）	联系人：洪新丁	地址：福建省福州市闽侯县竹岐乡榕中村
福州恒大华贸易有限公司	总经理：陈秋忠	地址：福建省福州市闽侯县南通镇罗洲村陈厝街东１８号
福州福欣产业投资综合开发有限公司	null	地址：福建省福州市闽侯县上街镇上街村
福州金水湖渡假娱乐有限公司	null	地址：福建省福州市闽侯县竹岐乡竹西村
福州嘉诚鞋服有限公司	总经理：陈刚	地址：福建省福州市闽侯县南通镇陈厝村　　　　法定代表人：陈刚
福州佳丰农牧渔发展有限公司	null	地址：福建省福州市闽侯县荆溪镇坛石村（市农业科技园区内）
福州开顺达饰品有限公司	成立日期：1991/8/15	地址：中国 福建 福州市 福州市闽侯县竹岐乡316国道旁高旋公司内
福州东利娱乐城有限公司	总经理：许正中	地址：福建省福州市闽侯县甘蔗镇山前村　　　　法定代表人：许正中
福州大荣晟建筑钢架有限公司	总经理：黄光雄	地址：福建省福州市闽侯县青口投资区　　　　　法定代表人：黄光雄
福州粉磨站职工技术协作服务部	老板：程法俊	地址：福建省福州市闽侯县荆溪镇厚屿福州粉磨站
福州杜坞联运有限公司	null	地址：福建省福州市闽侯县荆镇杜坞村９号
福永线窗厦至龙泉公路建设指挥部	null	地址：福建省福州市闽侯县南屿镇尧沙村
福州长利塑胶制品有限公司	null	地址：福建省福州市闽侯县甘蔗墩园洲长利科技园
福州昌恒实业有限公司	总经理：张勤	地址：福建省福州市闽侯县上街镇工贸区内　　　法定代表人：张勤
福州波特敏彩珠有限公司	总经理：开敏	地址：福建省福州市闽侯县竹岐乡苏阳村　　　　法　人：开敏
福厦线福州市联合检查站特产税检查科	null	地址：福建省福州市闽侯县闽江乡峡南村
福厦线福州联合检查站税务检查（站）科	null	地址：福建省福州市闽侯县闽江乡峡南村
福泉高速公路闽侯县征拆指挥部	null	地址：福建省福州市闽侯县尚干镇
福建英华藻业工贸有限公司	null	地址：福建省福州市闽侯县上街镇红峰村
福建新国道食品市场发展有限公司	总经理：张蔚	地址：福建省福州市闽侯县西大门上街投资区余盛批发市场
福建省三星石化开发公司乙炔气厂	null	地址：福建省福州市闽侯县荆溪镇永丰村
福建省文盛农业技术开发公司闽侯经营部	老板：陈端	地址：福建省福州市闽侯县在湖乡雪峰村１００号
福建省雪峰农牧业开发有限公司	null	地址：福建省福州市闽侯县大湖乡雪峰村天湖山
福建省烟草公司闽侯县公司南屿经营部	老板：王贞国	地址：福建省福州市闽侯县南屿镇街水西林６５号
福建省烟草公司闽侯县公司厚屿经营部	老板：程章敏	地址：福建省福州市闽侯县荆溪镇厚屿村
福建省轻纺工业设计院设计六所	所长：叶敏	地址：福建省福州市闽侯县甘蔗镇福龙新村２６座６０３
中国人民解放军３２１２２部队军人服务社	联系人：蒋文贤	地址：福建省福州市闽侯县荆溪镇铁岭
长青（福建）资源再生有限公司	null	地址：福建省福州市闽侯县祥谦镇枕锋村
福建省闽华涤棉厂	null	地址：福建省福州市闽侯县白沙镇下浦路５４号
福建省闽候县榕南联营林果场	null	地址：福建省福州市闽侯县鸿尾乡南坑村
福建省闽侯竹岐湖昌养殖场	null	地址：福建省福州市闽侯县竹岐乡火炬村
福建省闽侯征洋贸易有限公司	null	地址：福建省福州市闽侯县甘蔗镇甘洲路56号
福建省闽侯运输集团公司尚干分公司	null	地址：福建省福州市闽侯县尚干镇汽车站
福建省闽侯雪峰农业综合开发有限公司	总经理：杨文华	地址：福建省福州市闽侯县大湖乡雪峰
福建省闽侯新光来料加工厂	厂长：葛坚	地址：福建省福州市闽侯县祥谦镇枕峰村半月山１号
福建省闽侯祥谦物资供应公司	null	地址：福建省福州市闽侯县尚干镇尚南路
福建省闽侯县竹岐花茶精制厂	null	地址：福建省福州市闽侯县竹岐乡榕东村
福建省闽侯县中旭贸易有限公司	总经理：吴用淦	地址：福建省福州市闽侯县祥谦镇中院中信机械厂
福建省闽侯县云尾坂头竹编厂	null	地址：福建省福州市闽侯县鸿尾乡桥头村
福建省闽侯县元鸿玻璃灯具制品有限公司	null	地址：福建省福州市闽侯县祥谦镇卜洲村
福建省闽侯县永丰脱胎漆器厂	null	地址：福建省福州市闽侯县荆溪镇永丰村横路２０号
福建省闽侯县漪珍工贸开发有限公司	null	地址：福建省福州市闽侯县尚干镇浦里
福建省闽侯县洋里小箬竹艺厂	null	地址：福建省福州市闽侯县洋里小箬
福建省闽侯县洋里经济发展有限公司	null	地址：福建省福州市闽侯县洋里乡洋里街８号
福建省闽侯县杨丰手厂	厂长：杨英顺	地址：福建省福州市闽侯县青口镇杨厝村
福建省闽侯县旭业制冷配件厂	null	地址：福建省福州市闽侯县荆溪镇永丰村杜乌41号
福建省闽侯县星辰工贸有限公司	null	地址：福建省福州市闽侯县甘蔗镇城关福龙新村16座302号
福建省闽侯县兴隆建材有限公司	null	地址：福建省福州市闽侯县白沙镇安平路71号
福建省闽侯县信达电子器材有限公司	null	地址：福建省福州市闽侯县甘蔗入城路
福建省闽侯县鑫山润滑脂有限公司	null	地址：福建省福州市闽侯县青口镇工业路10号
福建省闽侯县新艺厂	null	地址：福建省福州市闽侯县尚干镇南园７号
福建省闽侯县新兴贸易有限公司	null	地址：福建省福州市闽侯县甘蔗镇军民路188号二层
福建省闽侯县小箬闽江笔料店G	null	地址：福建省福州市闽侯县洋里乡小箬村
福建省闽侯县祥源给排水设备厂	null	地址：福建省福州市闽侯县上街镇新峰村
福建省闽侯县祥谦展凤茶果加工场	null	地址：福建省福州市闽侯县祥谦镇凤港村
福建省闽侯县祥谦商行	null	地址：福建省福州市闽侯县祥谦镇祥南路４１号
福建省闽侯县祥谦龙山石制品厂G	null	地址：福建省福州市闽侯县祥谦镇双龙山村
福建省闽侯县祥谦茶果厂	null	地址：福建省福州市闽侯县尚干镇尚南路４１号
福建省闽侯县维钦淡水养殖场	null	地址：福建省福州市闽侯县白沙镇溪头仙山万丈底
福建省闽侯县投资企业公司	总经理：唐自亮	地址：闽侯县甘蔗镇
福建省闽侯县天龙经贸有限公司	null	地址：福建省福州市闽侯县闽江乡峡南村道头３号
福建省闽侯县天龙茶果厂	null	地址：福建省福州市闽侯县上街镇六中
福建省闽侯县顺进石材加工厂	null	地址：福建省福州市闽侯县大湖乡珍山村
福建省闽侯县顺登工贸有限公司	总经理：何先龙	地址：福建省福州市闽侯县甘蔗镇军民路９号
福建省闽侯县顺达工贸有限公司	null	地址：福建省福州市闽侯县上街镇新峰村
福建省闽侯县税务代理部	null	地址：福建省福州市闽侯县甘蔗镇校园路143号
福建省闽侯县生活用品厂	null	地址：福建省福州市闽侯县白沙镇新街22号
福建省闽侯县升源竹编厂	null	地址：福建省福州市闽侯县荆溪镇关东村东境96号
福建省闽侯县伸带木制厂	null	地址：福建省福州市闽侯县洋里乡伸带村
福建省闽侯县社会治安综合治理办公室	联系人：林依清	地址：福建省福州市闽侯县甘蔗镇交通路2号
福建省闽侯县尚干镇编织厂	null	地址：福建省福州市闽侯县尚干镇尚南路４２号
福建省闽侯县尚干益兴金属熔坯厂	null	地址：福建省福州市闽侯县尚干镇福夏路
福建省闽侯县上街其华特艺厂	null	地址：福建省福州市闽侯县上街镇蔗洲村59号
福建省闽侯县上街海丽经营部	null	地址：福建省福州市闽侯县上街镇厚美村
福建省闽侯县商业贸易经营部	null	地址：福建省福州市闽侯县甘蔗镇街心路22号
福建省闽侯县山洋宇发蒸笼厂	null	地址：福建省福州市闽侯县竹岐乡竹岐街144号
福建省闽侯县三峰鳗业有限公司	null	地址：福建省福州市闽侯县白沙镇大目溪村
福建省闽侯县榕福贸易有限公司	null	地址：福建省福州市闽侯县甘蔗镇甘洲路357号
闽侯县上街顺意果子场	null	地址：福建省福州市闽侯县上街镇溪源村
闽侯县上街生云塑料加工场	null	地址：福建省福州市闽侯县上街镇浦口村
闽侯县上街升和木材加工场	null	地址：福建省福州市闽侯县上街镇新丰村
闽侯县上街沙榕茶箱加工厂Ｇ	null	地址：福建省福州市闽侯县上街镇沙堤村后街46号
闽侯县上街群星娱乐城	null	地址：福建省福州市闽侯县上街镇新街
闽侯县上街前街腐竹厂	厂长：孙庆铨	地址：福建省福州市闽侯县上街镇侯官村
闽侯县上街宁群食杂店	老板：金宁群	地址：福建省福州市闽侯县上街镇新峰村
闽侯县上街能富特艺厂	厂长：方能富	地址：福建省福州市闽侯县上街镇岐安村
闽侯县上街明折食杂店	老板：赵明折	地址：福建省福州市闽侯县上街镇沙堤村后街４６号
闽侯县上街美岐农副产品加工场	null	地址：福建省福州市闽侯县上街乡美岐村
闽侯县上街銮浦竹器加工场G	null	地址：福建省福州市闽侯县上街镇美岐村
闽侯县上街龙王热水炉厂	厂长：李自常	地址：福建省福州市闽侯县上街镇红峰村沙墩１号
闽侯县上街林焱汽车修理店	老板：林焱	地址：福建省福州市闽侯县上街镇３１６国道边
闽侯县上街金山腐竹厂	厂长：陈慈煌	地址：福建省福州市闽侯县上街镇侯官村
闽侯县上街建筑配套水泥构件厂	null	地址：福建省福州市闽侯县上街镇上街村丹士32号
闽侯县上街厚庭石子场G	null	地址：福建省福州市闽侯县上街镇厚庭村
闽侯县上街厚美村合作基金会	null	地址：福建省福州市闽侯县上街镇厚美村
闽侯县上街侯官培金家俱加工厂G	null	地址：福建省福州市闽侯县上街镇侯官村
闽侯县上街宏阳粘合剂加工场G	null	地址：福建省福州市闽侯县上街镇金屿村
闽侯县上街红日玻璃钢花盆加工场	联系人：李贵民	地址：福建省福州市闽侯县上街镇美岐村
闽侯县上街海产品农副土特产品经营部	老板：陈宝泉	地址：福建省福州市闽侯县上街镇美岐村
闽侯县上街福益电子装配厂	null	地址：福建省福州市闽侯县上街镇沙堤村
闽侯县上街福威塑料加工场	null	地址：福建省福州市闽侯县上街镇新峰新宅44号
闽侯县上街福晖木材加工场	联系人：林福生	地址：福建省福州市闽侯县上街镇新峰村
闽侯县上街陈健木材加工场	联系人：陈健	地址：福建省福州市闽侯县上街镇红峰沙墩
闽侯县上街长征人造宝石工艺品加工场	联系人：欧阳光	地址：福建省福州市闽侯县上街镇建平村董屿３４号
闽侯县上街爱端收花点G	null	地址：福建省福州市闽侯县上街镇金桥19号
闽侯县散装水泥办公室	联系人：陈谟堂	地址：福建省福州市闽侯县甘蔗镇交通路６号
闽侯县榕西物资贸易经销部	null	地址：福建省福州市闽侯县竹岐乡榕西村委大楼
闽侯县榕山腐竹厂	厂长：游家榕	地址：福建省福州市闽侯县白沙镇下浦路５５号
闽侯县荣成燃料有限公司	null	地址：福建省福州市闽侯县青口镇傅竹村
闽侯县秋萍小百店	null	地址：福建省福州市闽侯县洋里乡花桥街
闽侯县轻工装修工程公司	null	地址：福建省福州市闽侯县甘蔗镇集资楼６０２房
闽侯县青洋龙眼综合示范场	null	地址：福建省福州市闽侯县青口镇前洋村
闽侯县青口忠森建筑材料店G	null	地址：福建省福州市闽侯县青口镇青口街
闽侯县青口镇幸福村经济合作社	null	地址：福建省福州市闽侯县青口镇幸福村
闽侯县青口镇青秀村经济合作社	联系人：林从志	地址：福建省福州市闽侯县青口镇青秀村
闽侯县青口镇青林村经济合作社	null	地址：福建省福州市闽侯县青口镇青林村
闽侯县青口镇青口村经济合作社	联系人：孙立忠	地址：福建省福州市闽侯县青口镇青口村
闽侯县青口镇前洋村新洋联队经济合作社	联系人：陈泽文	地址：福建省福州市闽侯县青口镇前洋村
闽侯县青口镇前洋村经济合作社	null	地址：福建省福州市闽侯县青口镇前洋村
闽侯县青口镇农光村经济合作社	null	地址：福建省福州市闽侯县青口镇农光村
闽侯县青口镇穆岭寺文物管理委员会	null	地址：福建省福州市闽侯县青口镇前洋村
闽侯县青口镇明良柴油店	null	地址：福建省福州市闽侯县青口镇联丰村
闽侯县青口镇梅溪村经济合作社	null	地址：福建省福州市闽侯县青口镇梅溪村
闽侯县青口镇梅岭村经济合作社	null	地址：福建省福州市闽侯县青口镇梅岭村
闽侯县青口镇联光村经济合作社	null	地址：福建省福州市闽侯县青口镇联光村
闽侯县青口镇联丰村经济合作社	null	地址：福建省福州市闽侯县青口镇联丰村
闽侯县青口镇莲峰村经济合作社	null	地址：福建省福州市闽侯县青口镇莲峰村
闽侯县青口镇劳动管理站	站长：林松旺	地址：福建省福州市闽侯县青口镇政府
闽侯县青口镇镜上村经济合作社	联系人：陈建兵	地址：福建省福州市闽侯县青口镇镜上村
闽侯县青口镇吉山村经济合作社	null	地址：福建省福州市闽侯县青口镇吉山村
闽侯县青口镇沪屿村经济合作社	null	地址：福建省福州市闽侯县青口镇沪屿村
闽侯县青口镇宏屿经济管理区	null	地址：福建省福州市闽侯县青口镇宏屿经济管理区
闽侯县青口镇宏四村经济合作社	null	地址：福建省福州市闽侯县青口镇宏四村
闽侯县青口镇宏四村合作基金会	null	地址：福建省福州市闽侯县青口镇宏四村
闽侯县青口镇宏三村经济合作社	null	地址：福建省福州市闽侯县青口镇宏三村
闽侯县青口镇红旗村经济合作社	联系人：林祥雪	地址：福建省福州市闽侯县青口镇红旗村
闽侯县青口镇道路运输站	站长：林连奇	地址：福建省福州市闽侯县青口镇政府
闽侯县青口镇大埕村经济合作社	null	地址：福建省福州市闽侯县青口镇大埕村
闽侯县青口镇村里村经济合作社	null	地址：福建省福州市闽侯县青口镇村里村
闽侯县青口则钦日用杂品店	老板：吴则钦	地址：福建省福州市闽侯县青口镇宏屿街９号
闽侯县青口玉山龙成养殖场	null	地址：福建省福州市闽侯县青口镇村里村千家山
闽侯县青口永盛家俱加工场	null	地址：福建省福州市闽侯县青口镇前洋村
闽侯县青口艺光竹编厂	null	地址：福建省福州市闽侯县青口镇沪屿村
闽侯县青口叶晨汽车修理店	老板：叶晨	地址：福建省福州市闽侯县青口镇宏三村
闽侯县青口雪金煤炭店G	null	地址：福建省福州市闽侯县青口镇付竹村过溪新村71号
闽侯县青口信德石材加工场G	null	地址：福建省福州市闽侯县青口镇工业路7号
闽侯县青口新世纪家用电器店	老板：林善锦	地址：福建省福州市闽侯县青口镇建设大厦一层１５号
闽侯县青口新潮经编厂	null	地址：福建省福州市闽侯县青口镇青口工业区
闽侯县青口天工床上用品加工场	null	地址：福建省福州市闽侯县青口镇幸福村溪仔边
闽侯县青口太阳雨商务服务社	null	地址：福建省福州市闽侯县青口镇沪屿村
闽侯县青口三元食杂店	老板：林秀珍	地址：福建省福州市闽侯县青口镇青口街
闽侯县青口全民养殖场	null	地址：福建省福州市闽侯县青口镇镜上村
闽侯县青口其庄劳保用品加工场	联系人：杨其庄	地址：福建省福州市闽侯县青口镇杨厝村
闽侯县青口木水养殖场	null	地址：福建省福州市闽侯县青口镇镜上村后洋
闽侯县青口美英木箱加工户	null	地址：福建省福州市闽侯县青口镇莲峰村
闽侯县青口粮食管理站	null	地址：福建省福州市闽侯县青口镇工业路１１号
闽侯县青口家美草场	联系人：江贵宽	地址：福建省福州市闽侯县青口镇镜上村
闽侯县青口继明汽车修理店	null	地址：福建省福州市闽侯县青口镇新村
闽侯县青口华庆特艺厂	厂长：杨端容	地址：福建省福州市闽侯县青口镇杨厝村
闽侯县青口沪兴工艺竹编厂	null	地址：福建省福州市闽侯县青口镇庄头村
闽侯县青口宏屿新风日用品厂Ｇ	null	地址：福建省福州市闽侯县青口镇吉山村
闽侯县青口冠裕绢彩加工场G	null	地址：福建省福州市闽侯县青口镇青洋村透头3号
闽侯县青口富乐石料加工场	null	地址：福建省福州市闽侯县青口镇升旗村
闽侯县青口福坚建材场	联系人：林福厚	地址：闽侯县青口镜上村
闽侯县青口丰盛粮制品加工场	联系人：林平官	地址：福建省福州市闽侯县青口镇青布村新桥外５０号
闽侯县青口炳秋家具加工店G	null	地址：福建省福州市闽侯县青口镇升强村升桥外
闽侯县旗山石松寺	联系人：释广霖	地址：福建省福州市闽侯县南屿镇中溪村
闽侯县旗山风景区开发建设领导小组办公室	联系人：周敏	地址：福建省福州市闽侯县南屿镇政府
闽侯县鹏飞装饰特艺厂	null	地址：福建省福州市闽侯县青口乡沪屿树旧桥头
闽侯县农业机械监理站	null	地址：福建省福州市闽侯县甘蔗镇甘洲路56号
闽侯县农村合作经济组织南屿经营管理站	null	地址：福建省福州市闽侯县南屿镇南旗水西林１３号
闽侯县农村合作经济竹岐经营管理站	null	地址：福建省福州市闽侯县竹岐乡竹岐街１２５号
闽侯县农村合作经济廷坪经营管理站	null	地址：福建省福州市闽侯县廷坪乡廷坪村里厝２号
闽侯县农村合作经济青口经营管理站	null	地址：福建省福州市闽侯县青口镇青口村
闽侯县农村合作经济荆溪经营管理站	null	地址：福建省福州市闽侯县荆溪镇徐家村
闽侯县农村合作经济鸿尾经营管理站	站长：池金坦	地址：福建省福州市闽侯县鸿尾乡石佛头
闽侯县农村合作经济甘蔗经营管理站	null	地址：福建省福州市闽侯县甘蔗镇校园路５３号
闽侯县农村合作经济白沙镇经营管理站	null	地址：福建省福州市闽侯县白沙镇安平路９０号
福建庆隆汽车驾驶员培训有限公司闽侯分公司	总经理：吴周锋	地址：福建省福州市闽侯县青口镇文华村
福州宝龙源房地产开发有限公司	总经理：王德瑞	地址：福建省福州市闽侯县南屿镇后山村
福州万隆华宇物流有限公司青口分公司	总经理：柳文斌	地址：福建省福州市闽侯县青口镇付竹村
福州明武米业有限公司	总经理：林明武	地址：福建省福州市闽侯县荆溪镇福建省福州粮食批发交易市场工业园区１０座
福州宏晟鞋业有限公司	总经理：林连宏	地址：福建省福州市闽侯县祥谦镇泮洋口工业区（福州台晔塑胶有限公司内）
福州市江洋农场角洋村经济合作管理委员会	联系人：张功清	地址：福建省福州市闽侯县江洋农村角洋村
福州市江洋农场江洋村经济合作管理委员会	联系人：何友伙	地址：福建省福州市闽侯县江洋农场江洋村
福州市江洋农场武竹村经济合作管理委员会	联系人：许淑云	地址：福建省福州市闽侯县江洋农场武竹村
福州市江洋农场彭湖村经济合作管理委员会	联系人：高传弟	地址：福建省福州市闽侯县江洋农场彭湖村
福州五虎山风景绿化工程有限公司	总经理：林建飞	地址：福建省闽侯县祥谦镇辅翼村
福州宏展模具有限公司	总经理：汪星泉	地址：中国 福建 福州市 闽侯县青口镇梅岭村
福州天榄食品有限公司	总经理：翁惠珠	地址：福建省闽侯县白沙镇下浦路５５号
福州千百佳食品有限公司	null	地址：中国 福建 福州市 福州市闽侯县青口镇工业区
福州永晟达食品有限公司	总经理：苏丽明	地址：福建省福州市闽侯县青口镇付竹工业区
福州加洛普汽车配件有限公司	总经理：陈志忠	地址：福建省福州市闽侯县青口投资区（尚干镇过浦村）
迈恩（福州）汽车配件有限公司	总经理：林功金	地址：福建省福州市闽侯县青口投资区
福州西门城食品有限公司	总经理：郑凌志	地址：福建省福州市闽侯县荆溪镇溪下村
福州新天亿食品有限公司	总经理：黄喜群	地址：福建省福州市闽侯县荆溪镇溪下村
福州麦加利食品有限公司	总经理：陈毅辉	地址：福建省福州市闽侯县祥谦镇泮洋村
福州旺美食品有限公司	总经理：李孙宝	地址：福建省福州市闽侯县甘蔗街道甘洲路２９１号
福州天宫食品有限公司	总经理：王瑞算	地址：福建省福州市闽侯县尚干工业区
福州金津食品有限公司	总经理：金宁武	地址：福建省福州市闽侯县南屿镇晓岐村边洲
闽侯县竹岐碧娇饲料店G	null	地址：福建省福州市闽侯县竹岐乡竹岐街35号
闽侯县粮油贸易公司上街经营部	null	地址：福建省福州市闽侯县上街新峰村
闽侯县白沙镇安平粮食饲料店	null	地址：福建省福州市闽侯县白沙街安平路６３号－１
闽侯县南屿供销社付食品批发部	老板：程中秋	地址：福建省福州市闽侯县南屿镇南屿街
闽侯县上街夏英饲料店G	null	地址：福建省福州市闽侯县上街镇新峰村杏山2号
闽侯县南通信誉饲料店	null	地址：福建省福州市闽侯县南通镇南通街
闽侯县青口前洋饲料经营部	null	地址：福建省福州市闽侯县青口镇前洋村
闽侯县粮油购销经营部	null	地址：福建省福州市闽侯县甘蔗镇环城路１３号
闽侯县闽江农业机械公司	null	地址：福建省福州市闽侯县闽江乡峡南村后湾
闽侯县水产公司甘蔗门市部	null	地址：福建省福州市闽侯县甘蔗镇街心路２３号
闽侯县上街镇蔬菜产销领导办公室	null	地址：福建省福州市闽侯县上街镇新商业街
闽侯县大湖乡蔬菜产销办公室	联系人：岳灿华	地址：福建省福州市闽侯县大湖乡政府
闽侯县南通镇蔬菜产销办公室	null	地址：福建省福州市闽侯县南通镇
闽侯县甘蔗粮站城关超级商场	null	地址：福建省福州市闽侯县甘蔗镇街心路34号
福建省闽侯县粮油贸易公司	null	地址：福建省福州市闽侯县甘蔗镇街心路136号
闽侯县军粮供应站	站长：林琦	地址：福建省福州市闽侯县甘蔗镇八一八大道
闽侯县祥谦粮油经营部	null	地址：福建省福州市闽侯县祥谦镇枕峰村
闽侯县廷坪粮站复制品厂	null	地址：福建省福州市闽侯县廷坪乡街心路９号
闽候县水产供销公司白沙购销站	null	地址：福建省福州市闽侯县
福州福利德照明器材有限公司	null	地址：福建省福州市闽侯县青口镇工业路5号
闽侯县鞯蔗镇建新废品收购站	null	地址：福建省福州市闽侯县甘蔗镇横屿村176号
福建省闽侯县闽恒普通钢材有限公司	null	地址：福建省福州市闽侯县闽江峡南钢材市场
闽侯县洋里供销社梧溪购销处	联系人：江本淦	地址：福建省福州市闽侯县洋里乡梧溪村
闽侯县上街振华茉莉花收购点G	null	地址：福建省福州市闽侯县上街镇新峰村
闽侯县甘蔗燕清废品收购店	null	地址：福建省福州市闽侯县甘蔗镇坛石村
闽侯县上街王志茉莉花收购点	联系人：王志	地址：福建省福州市闽侯县上街镇金屿村金桥
闽侯县上街海水茉莉花收购点	null	地址：福建省福州市闽侯县上街镇新峰村
福建迎新非金属矿业有限公司	null	地址：福建省福州市闽侯县白沙镇安民路90号
福建省闽侯县汇源建材砂石有限公司	null	地址：福建省福州市闽侯县甘蔗镇横屿385号
闽侯县来利水泥矿石经营部	null	地址：福建省福州市闽侯县甘蔗镇蔗州路２５２号
福建省闽侯县尚青峰砂石有限公司	总经理：林建永	地址：福建省福州市闽侯县祥谦镇枕峰工业区
福州东隆砂石有限公司	null	地址：福建省福州市闽侯县鸿尾乡元口村
闽侯县竹岐供销社昌隆工艺厂	厂长：林文芳	地址：福建省福州市闽侯县竹岐乡竹岐街134号
闽侯县廷坪供销社罗桥棉百门市部	老板：林循成	地址：福建省福州市闽侯县廷坪乡罗桥村
闽侯县南屿供销社尧沙购销处	联系人：唐建兴	地址：福建省福州市闽侯县南屿镇尧沙村
闽侯县洋里供销社中平购销处	联系人：江本淦	地址：福建省福州市闽侯县小箬乡中平村
闽侯县南屿供销社食杂第一门市部	老板：柳宝钟	地址：福建省福州市闽侯县南屿镇南屿街
闽侯县廷坪供销社尾桥购销处	联系人：林循成	地址：福建省福州市闽侯县廷坪乡尾桥村
闽侯县竹岐供销社竹草编织品厂	null	地址：福建省福州市闽侯县竹岐乡竹岐街１１７号
闽侯县廷坪供销社廷坪食杂门市部	老板：林循成	地址：福建省福州市闽侯县廷坪乡街心路２４号
闽侯县上街供销社新峰生资门市部	null	地址：福建省福州市闽侯县上街镇新峰村
闽侯县廷坪供销社廷坪生资仓库	联系人：林循成	地址：福建省福州市闽侯县廷坪乡街心路２４号
闽侯县甘蔗供销社食品蜜钱厂	厂长：洪启忠	地址：福建省福州市闽侯县甘蔗镇三英村
闽侯县洋里供销社饮食店	老板：江本淦	地址：福建省福州市闽侯县洋里乡花桥村
闽侯县上街供销社金屿购销处	联系人：林仕华	地址：福建省福州市闽侯县上街镇浦口村
闽侯县上街供销社厚美购销处	联系人：林仕华	地址：福建省福州市闽侯县上街镇厚美村
闽侯县洋里供销社尚锦购销处	联系人：江本淦	地址：福建省福州市闽侯县洋里乡尚锦村
闽侯县廷坪供销社廷坪棉百门市部	老板：林循成	地址：福建省福州市闽侯县廷坪乡街心路２４号
闽侯县洋里供销社第二门市部	老板：江本淦	地址：福建省福州市闽侯县洋里乡花桥村
闽侯县洋里供销社洋头购销处	联系人：江本淦	地址：福建省福州市闽侯县洋里乡洋头村
闽侯县竹岐供销社百货批发部	null	地址：福建省福州市闽侯县竹岐乡竹岐街
闽侯县大湖供销社五交门市部	老板：姚心旗	地址：福建省福州市闽侯县大湖乡大湖街
闽侯运输集团公司废品收购分公司	总经理：陈玉金	地址：福建省福州市闽侯县甘蔗镇交通路２号
闽侯县洋里供销社工业品仓库	联系人：江本淦	地址：福建省福州市闽侯县洋里乡新见村
闽侯县大湖供销社生资仓库	联系人：姚心旗	地址：福建省福州市闽侯县大湖乡大湖街
闽侯县洋里供销社生资采购站	站长：江本淦	地址：福建省福州市闽侯县洋里乡绅带村
闽侯县上街供销社沙堤购销处	null	地址：福建省福州市闽侯县上街镇沙堤村
闽侯县洋里供销社张际购销处	联系人：江本淦	地址：福建省福州市闽侯县洋里乡张际村
闽侯县廷坪供销社罗桥食杂门市部	老板：林循成	地址：福建省福州市闽侯县廷坪乡罗桥村
闽侯县洋里供销社小箬生资站	站长：江本淦	地址：福建省福州市闽侯县小箬乡小箬村
闽侯县洋里供销社田当购销处	联系人：江本淦	地址：福建省福州市闽侯县洋里乡田当村
闽侯县大湖供销社大坪购销处	联系人：姚心旗	地址：福建省福州市闽侯县大湖乡大坪村
闽侯县上街供销社联心购销处	联系人：林仕华	地址：福建省福州市闽侯县上街镇联心村
闽侯县上街供销社榕桥购销处	联系人：林仕华	地址：福建省福州市闽侯县上街镇榕桥村
闽侯县洋里供销社第一门市部	老板：江本淦	地址：福建省福州市闽侯县洋里乡花桥村
闽侯县洋里供销社长基购销处	联系人：江本淦	地址：福建省福州市闽侯县洋里乡长基村
闽侯县南屿供销社龙泉大队西坂联营柑桔场	联系人：陈启福	地址：福建省福州市闽侯县南屿镇龙泉村
闽侯县大湖供销社雪峰购销处	联系人：姚心旗	地址：福建省福州市闽侯县大湖乡雪峰村
闽侯县闽江供销社	null	地址：福建省福州市闽侯县闽江乡峡南村
闽侯县廷坪乡供销社罗桥生资仓库	联系人：林循成	地址：福建省福州市闽侯县廷坪乡罗桥村
闽侯县洋里供销社小箬门市部	老板：江本淦	地址：福建省福州市闽侯县小箬乡小箬村
闽侯县南通供销社工会委员会	null	地址：福建省福州市闽侯县南通镇南通街４４号
闽侯县白沙供销社工会委员会	null	地址：福建省福州市闽侯县白沙镇白沙新街１号
福建省闽侯县供销社工会委员会	联系人：李同全	地址：福建省福州市闽侯县甘蔗镇街心路８８号
闽侯县尚干林平瓷砖店	null	地址：福建省福州市闽侯县尚干镇尚干街
闽侯县南屿供销社高岐购销处	联系人：黄光明	地址：福建省福州市闽侯县南屿镇高岐村
闽侯县洋里供销社尚格购销处	联系人：江本淦	地址：福建省福州市闽侯县小箬乡尚格村
闽侯县闽江供销社生资门市部	null	地址：福建省福州市闽侯县闽江乡峡南村
闽侯县大湖乡兰峰农业开发综合场	联系人：林招惠	地址：福建省福州市闽侯县大湖乡墙坪村
闽侯县洋里岭兜养鳗场	null	地址：福建省福州市闽侯县洋里乡岭兜村
闽侯县洋里乡张际农业开发综合场	null	地址：福建省福州市闽侯县洋里乡张际村
闽侯县白沙大目溪启秀食杂扁肉店G	null	地址：福建省福州市闽侯县白沙镇大目溪口村
闽侯县上街赵金五金店	老板：赵金	地址：福建省福州市闽侯县上街镇沙堤村
闽侯县白沙镇文清五金店G	null	地址：福建省福州市闽侯县白沙镇安平路74号
闽侯县青口林强建筑五金店	null	地址：福建省福州市闽侯县青口镇新村108号
闽侯县白沙安平美华建筑五金店G	null	地址：福建省福州市闽侯县白沙镇安平路13号
闽侯县甘蔗甘洲路美群建筑五金店G	null	地址：福建省福州市闽侯县甘蔗镇街心路92号
闽侯县南通明西建筑五金店	null	地址：福建省福州市闽侯县南通镇南通街
闽侯县白沙新街秀云五金店G	null	地址：福建省福州市闽侯县白沙新街97号
闽侯县尚干彤红五金店	null	地址：福建省福州市闽侯县尚干镇大桥边
闽侯县荆溪诗添自行车配件建筑五金店	null	地址：福建省福州市闽侯县荆溪镇徐家村
闽侯县南通德美五金店	null	地址：福建省福州市闽侯县南通街
闽侯县青口建平土木工具五金店	老板：丁建平	地址：福建省福州市闽侯县青口镇青口街
闽侯县白沙庆林五金店	null	地址：福建省福州市闽侯县白沙镇火车站
闽侯县白沙美英布店	null	地址：福建省福州市闽侯县白沙镇新街4号
闽侯县闽江新潮五金店	null	地址：福建省福州市闽侯县闽江峡南街
闽侯县竹岐夏英服装店G	null	地址：福建省福州市闽侯县竹岐乡竹岐街
闽侯县上街林琼家俱店G	null	地址：福建省福州市闽侯县上街镇上街村
闽侯县甘蔗镇淑明家具店G	null	地址：福建省福州市闽侯县甘蔗镇劳动大楼一楼
闽侯县南通炳端家俱店	null	地址：福建省福州市闽侯县南通镇街道
闽侯县赛宝服装店	null	地址：福建省福州市闽侯县洋里乡花桥街
闽侯县洋里欣添服装店	null	地址：福建省福州市闽侯县洋里乡
闽侯县尚干秀玲服装店	null	地址：福建省福州市闽侯县尚干镇尚干街
闽侯县水英服装店	null	地址：福建省福州市闽侯县洋里乡花桥街
闽侯县城关艳云服装店G	null	地址：福建省福州市闽侯县甘蔗镇城关市场二楼
闽侯县白沙佳友时装店G	null	地址：福建省福州市闽侯县白沙镇白沙街
闽侯县竹岐秀玉服装店G	null	地址：福建省福州市闽侯县竹岐乡竹岐街
闽侯县竹岐彩云服装店G	null	地址：福建省福州市闽侯县竹岐乡竹岐街
闽侯县南屿灼娇服装店G	null	地址：福建省福州市闽侯县南屿镇南屿街6号
闽侯县竹岐品林服装店G	null	地址：福建省福州市闽侯县竹岐乡竹岐街108号
闽侯县南通振栋服装店	null	地址：福建省福州市闽侯县南通镇南通街
闽侯县白沙梅榕服装店王G	null	地址：福建省福州市闽侯县白沙镇安平路112号
闽侯县尚干林琴服装店G	null	地址：福建省福州市闽侯县尚干镇尚干街
福建省闽侯县鸿尾农机加油站	站长：陈宜华	地址：福建省福州市闽侯县鸿尾乡３１６国道六桥头
闽侯县青口联丰文彬加油站	null	地址：福建省福州市闽侯县青口镇联丰村
闽侯县南通冠飞加油站	null	地址：福建省福州市闽侯县南通街
闽侯县鸿尾碧云加油站	null	地址：福建省福州市闽侯县鸿尾乡石佛头街
闽侯县鸿尾康谋加油站	null	地址：福建省福州市闽侯县鸿尾乡连塘村
闽侯县南通陈锋家俱店	null	地址：福建省福州市闽侯县南通镇陈厝三联西路
闽侯县甘蔗宏利消防器材商店	老板：蒋利武	地址：福建省福州市闽侯县甘蔗镇福龙新村
闽侯县鸿尾鸿达加油站G	null	地址：福建省福州市闽侯县鸿尾乡奎石村
闽侯县南屿镇天安药店G	null	地址：福建省福州市闽侯县南屿镇南屿街农贸市场６号
闽侯县白沙漠楚加油站G	null	地址：福建省福州市闽侯县白沙镇大目埕村
闽侯县上街供销社医药商店	null	地址：福建省福州市闽侯县上街镇新峰村
闽侯县南通金忠加油点	null	地址：福建省福州市闽侯县南通镇文山洋中厝
闽侯县荆溪秀珍加油站	null	地址：福建省福州市闽侯县荆溪镇徐家村
闽侯县竹岐天源加油站G	null	地址：福建省福州市闽侯县竹岐乡元桥村
闽侯县白沙下浦道宝珠加油点G	null	地址：福建省福州市闽侯县白沙下街道
闽侯县白沙玉兰加油点	联系人：汪玉	地址：福建省福州市闽侯县白沙镇溪口村
闽侯县百货公司甘蔗综合商店	null	地址：福建省福州市闽侯县甘蔗镇街心路97号
闽侯县南通玉花百货店	null	地址：福建省福州市闽侯县南通镇南通街
闽侯县副食品公司甘蔗第一商店	null	地址：福建省福州市闽侯县甘蔗镇街心路６９号
闽侯县上街联滨家电商店	老板：林孝盛	地址：福建省福州市闽侯县上街镇联滨楼
闽侯县上街新奇五交化商店	null	地址：福建省福州市闽侯县上街镇新峰街
福建省闽侯县上街联谊五交商店	null	地址：福建省福州市闽侯县上街镇
闽侯县城关新华汽车配件经营部G	null	地址：福建省福州市闽侯县甘蔗镇入城路
闽侯县甘蔗校园路美娇商店	老板：林美娇	地址：福建省福州市闽侯县甘蔗镇校园路９８号
闽侯县甘蔗国农日杂商店G	null	地址：福建省福州市闽侯县甘蔗镇街心路109号
闽侯县白沙鼎珠日用百货店G	null	地址：福建省福州市闽侯县白沙镇安平路
闽侯县南通金香日用百货店	null	地址：福建省福州市闽侯县南通街23号
闽侯县竹岐乡金云小商店G	null	地址：福建省福州市闽侯县竹岐乡竹岐街28号
闽侯县甘蔗闽百家用电器商店	老板：林兰桂	地址：福建省福州市闽侯县甘蔗镇街心路
闽侯县甘蔗兰金日用百货商店	老板：方兰金	地址：福建省福州市闽侯县甘蔗镇街心路１０５号
闽侯县白沙朝辉商店G	null	地址：福建省福州市闽侯县白沙镇安平路
闽侯县尚干盛业交电商店	null	地址：福建省福州市闽侯县尚干镇尚干街
闽侯县上街红峰建华五交商店Ｇ	null	地址：福建省福州市闽侯县上街镇红峰村
闽侯县鸿尾粮食管理站石佛头粮店	null	地址：福建省福州市闽侯县鸿尾乡石佛头街
闽侯县甘蔗国香碾米店	null	地址：福建省福州市闽侯县甘蔗镇甘洲路46号
闽侯县粮食局荆溪站荆溪粮店	null	地址：福建省福州市闽侯县荆溪镇荆溪村
闽侯县甘蔗油宝花生油行	null	地址：福建省福州市闽侯县甘蔗镇甘洲路80号
闽侯县南屿粮食管理站南屿粮店	null	地址：福建省福州市闽侯县南屿镇桥下路
闽侯县白沙雪金面粉店G	null	地址：福建省福州市闽侯县白沙镇安平路
闽侯县荆溪粮食管理站厚屿粮店	null	地址：福建省福州市闽侯县荆溪镇厚屿村３号
闽侯县廷坪粮站廷坪粮店	null	地址：福建省福州市闽侯县廷坪乡街心路9号
闽侯县粮食局甘蔗粮站第一粮店	null	地址：福建省福州市闽侯县甘蔗镇甘洲路２００号
闽侯县甘蔗粮站第二粮店	老板：陈木花	地址：福建省福州市闽侯县甘蔗镇校园路４８号
闽侯县白沙秀云文具商店	null	地址：福建省福州市闽侯县白沙镇安平路85号
闽侯县甘蔗学林粮店G	null	地址：福建省福州市闽侯县甘蔗镇交通路7号
福建省闽侯县五交化公司甘蔗商店	null	地址：福建省福州市闽侯县甘蔗镇街心路２４号
闽侯县青口镇粮食管理站青口粮店	null	地址：福建省福州市闽侯县青口镇工业路１１号
闽侯县尚干铭惠茶庄	null	地址：福建省福州市闽侯县尚干镇尚干街
闽侯县甘蔗双池茶叶经营部	null	地址：福建省福州市闽侯县甘蔗镇甘洲路15号
闽侯县尚干玉华商店	null	地址：福建省福州市闽侯县尚干镇尚干街
闽侯县鸿尾逸群商店	null	地址：福建省福州市闽侯县鸿尾乡石佛头街１３号
闽侯县白沙良妹建筑五金店G	null	地址：福建省福州市闽侯县白沙镇桥头13号
闽侯县尚干振华钟表小百商店	null	地址：福建省福州市闽侯县尚干镇祥谦路303号
闽侯县白沙由榕碾米店G	null	地址：福建省福州市闽侯县白沙镇埕元村
闽侯县尚干锦章家俱店	老板：陈锦章	地址：福建省福州市闽侯县尚干镇大桥边
闽侯县竹岐秀芳五交商店	null	地址：福建省福州市闽侯县竹岐乡农机站
闽侯县甘蔗坤英五金水暖店	null	地址：福建省福州市闽侯县甘蔗镇入城路
闽侯县宏发化工五金经营部	null	地址：福建省福州市闽侯县甘蔗镇街心路87号
闽侯县甘蔗发盛五金水暖店G	null	地址：福建省福州市闽侯县甘蔗镇入城路
闽侯县闽江雪华五金水暖经营部	null	地址：福建省福州市闽侯县闽江乡峡南村
闽侯县甘蔗镇根泉五金水暖店G	null	地址：福建省福州市闽侯县甘蔗镇入城路
闽侯县甘蔗发水五金水暖店G	null	地址：福建省福州市闽侯县甘蔗镇入城路
闽侯县青口碧月五金水暖店	null	地址：福建省福州市闽侯县青口镇中心街9号
闽侯县荆溪建明家具店	老板：徐建明	地址：福建省福州市闽侯县荆溪镇厚屿村
闽侯县南屿小英家具店	老板：黄小英	地址：福建省福州市闽侯县南屿镇三中对面
闽侯县南屿江口冈兴布厂	null	地址：福建省福州市闽侯县南屿江口后双村
闽侯县城关印刷厂	null	地址：福建省福州市闽侯县甘蔗镇十字东巷１号
闽侯县洁利日用品制刷厂	厂长：张文钟	地址：中国 福建 福州市 闽侯县南通镇泽苗村帮道东20号
福建省闽侯洋溪化工厂	厂长：陈尧天	地址：福建省福州市闽侯县甘蔗镇坛石村
威胜（福州）洁具有限公司	总经理：简美玲	地址：福建省福州市闽侯县荆溪镇桐口村下沙３０号　　法定代表人：简美玲
福州弘日升洁具有限公司	总经理：张聪辉	地址：福建省福州市闽侯县青口投资区
福建省闽侯县慧华工艺厂	厂长：李慧X	地址：福建省福州市闽侯县尚干镇福厚２１公里处
福州敬业酒店家私有限公司	null	地址：福建省福州市闽侯县青口投资区
福建省闽侯璧石工艺厂	null	地址：福建省福州市闽侯县甘蔗镇蔗洲路155号
闽侯县南通工艺厂	厂长：方孝辉	地址：福建省福州市闽侯县南通镇方庄工业区南路５号
闽侯县上街春晖印刷厂	厂长：陈武	地址：福建省福州市闽侯县上街镇金屿村余盛１５７号
闽侯县江口恒鸿帆布厂	null	地址：福建省福州市闽侯县南屿镇江口村后双
闽侯县竹岐乡竹岐村砖瓦厂	null	地址：福建省福州市闽侯县竹岐乡竹岐街回岐头
闽侯县机关后勤汽车修理厂	null	地址：福建省福州市闽侯县甘蔗镇交通路2号
闽侯县江口利达织布厂	厂长：宋瑞安	地址：中国 福建 福州市 闽侯县南屿镇江口村
闽侯县江口楠清绒布厂	null	地址：福建省福州市闽侯县南屿镇江口村
闽侯县南屿江口兴隆织布厂G	null	地址：福建省福州市闽侯县南屿镇江口村过透47号
闽候县青口联丰石料厂	null	地址：福建省福州市闽侯县
福建长利日用化工有限公司	null	地址：福建省福州市闽侯县西郊甘蔗长利科技园
福建省闽侯县鸿尾欣欣工艺厂	null	地址：福建省福州市闽侯县鸿尾乡石佛头街１０７号
闽侯县南屿晓岐工艺厂	null	地址：福建省福州市闽侯县南屿镇晓岐村
福建省闽侯县南通泽苗日用工艺制品厂	null	地址：福建省福州市闽侯县南通镇泽苗村
闽侯县昌隆工艺厂	null	地址：福建省福州市闽侯县甘蔗镇侨园街28号
福建省闽候县尚干闽陶工艺厂	厂长：林宝弟	地址：福建省福州市闽侯县尚干镇福厦路东侧
闽侯县万盛石材工艺厂	厂长：林水坚	地址：福建省福州市闽侯县青口镇工业区７号
闽侯县上街镇中美空心砖厂	null	地址：福建省福州市闽侯县上街镇中美村
闽侯县十字机砖厂	null	地址：福建省福州市闽侯县甘蔗镇十字村
福建省闽侯县三友制帽厂	null	地址：福建省福州市闽侯县南屿镇新联村
福建八闽汽车总厂长征经营部	null	地址：福建省福州市闽侯县西郊徐家村３００号
闽侯县南屿尧沙红星五金工艺厂	null	地址：福建省福州市闽侯县南屿镇尧沙村
闽侯县旺盛烧碱厂	null	地址：福建省福州市闽侯县青口镇付竹村
福州岩隆石业有限公司	总经理：沈国	地址：福建省福州市闽侯县甘蔗镇长江村墩园洲
闽侯县南屿江口兴隆毛巾毯厂	null	地址：福建省福州市闽侯县南屿镇江口九石32号
闽侯县新光玻璃钢厂	null	地址：福建省福州市闽侯县白沙镇联坑７５号
福州和胜汽车配件有限公司	总经理：刘金德	地址：福建省福州市闽侯县青口投资区　　　　　法定代表人：刘金德
闽侯县南屿江口明兴漂染厂	null	地址：福建省福州市闽侯县南屿镇江口村
闽侯县青口镇新兴石粉厂	null	地址：福建省福州市闽侯县青口镇前洋村
闽侯县青口前洋矿石粉厂	null	地址：福建省福州市闽侯县青口前洋村
闽侯县闽江造船厂	null	地址：福建省福州市闽侯县闽江乡峡南村马山尾１０号
福州隆特有机化肥有限公司	null	地址：福建省福州市闽侯县荆溪镇桐口林场
闽侯县青口雪仙饮料厂	null	地址：福建省福州市闽侯县青口镇壶山村
闽侯县三合胶合板厂	厂长：赵淑平	地址：福建省福州市闽侯县荆溪镇桐口桐岭
闽侯县南屿镇青州五金厂	null	地址：福建省福州市闽侯县南屿镇江口村过透122号
闽侯县尚干镇美术工艺厂	null	地址：福建省福州市闽侯县尚干镇福厦公路２０公里处
福建省闽侯百得文具有限公司	总经理：周成接	地址：福建省福州市闽侯县廷坪乡廷坪街
福州仕诚电器有限公司	总经理：何英先AC650657	地址：福建省福州市闽侯县鸿尾乡桥头村　　　　法　人：何英先
福州闽森刨花板有限公司	null	地址：福建省福州市闽侯县闽江乡峡南村
闽侯县青口升旗竹木制品厂	null	地址：福建省福州市闽侯县青口镇青圃新桥外１０号
福建迎新电子计算机有限公司	null	地址：福建省福州市闽侯县上街镇
福州槟榕食品有限公司	总经理：肖传钟	地址：福建省福州市闽侯县甘蔗镇化龙村蔗洲路２０３号
福州雅丽洁卫生用品有限公司	总经理：林礼明	地址：福建省福州市闽侯县西郊墩园洲　　　　　法定代表人：林礼明
闽侯县尚干中文粮食加工厂	厂长：林中文	地址：福建省福州市闽侯县尚干镇南路上道头
福建省闽侯宏武木制品厂	厂长：林武	地址：福建省福州市闽侯县甘蔗镇仕山
福建省闽侯县建盛木材厂	null	地址：福建省福州市闽侯县荆溪镇桐口
闽侯县南屿美英蜜饯加工场	联系人：赵美英	地址：福建省福州市闽侯县南屿镇桐南湖边
闽侯县青口增春酒厂	null	地址：福建省福州市闽侯县青口镇前洋村
福州天鹏饲料有限公司	成立日期：2001/3/27	地址：中国 福建 福州市 闽侯县南屿后山工业区
福建省闽侯后福混合饲料有限公司	总经理：林建灿	地址：福建省福州市闽侯县尚干镇后福村石排洋
福建省闽侯县旺顺文具有限公司	null	地址：福建省福州市闽侯县甘蔗镇大元巷49号
闽侯县多泉食品饮料厂	null	地址：福建省福州市闽侯县荆溪镇文山里5号
福建省闽侯酒厂尚干分厂	null	地址：福建省福州市闽侯县尚干镇后村
福建省闽侯县星锦家具制板厂	null	地址：福建省福州市闽侯县荆溪镇光明村沙溪
闽侯县南屿南井纸箱厂	null	地址：福建省福州市闽侯县南屿南井村
闽侯县荆溪源泉饮料厂	厂长：徐承锦	地址：福建省福州市闽侯县荆溪镇浦前村１４号
福建省闽侯县鸿尾星光木丝板厂G	null	地址：福建省福州市闽侯县鸿尾乡埕头村
闽侯县南方淀粉厂	厂长：林水荣	地址：福建省福州市闽侯县荆溪镇永丰部队综合农场
福建省闽侯县益康饮料厂	厂长：林其光	地址：福建省福州市闽侯县上街镇红峰村
闽侯县尚干富兴饲料厂	null	地址：福建省福州市闽侯县尚干镇福厦路21公里处
福建省闽侯县恒利食品饮料厂	null	地址：福建省福州市闽侯县祥谦禄家村
闽侯县酒厂甘蔗批发部	null	地址：福建省福州市闽侯县甘蔗镇十字街
闽侯县荆溪三友饮料厂	null	地址：福建省福州市闽侯县荆溪镇永丰村
福建省闽侯闽兴纸箱厂	null	地址：福建省福州市闽侯县洋里乡洋里村
福州新闽食品有限公司	null	地址：福建省福州市闽侯县尚干镇寅武江
闽侯县双利五金厂G	null	地址：福建省福州市闽侯县南屿镇江口村九石126号
闽侯县忠彬塑胶有限公司	总经理：卢宝忠	地址：福建省福州市闽侯县南屿镇高岐村工业小区
闽侯县祥谦五金厂	null	地址：福建省福州市闽侯县尚干镇祥谦路
福州起重运输机械厂职工技术协作服务部	null	地址：福建省福州市闽侯县荆溪镇关口村关口３６４号
龙丰祥（福建）食品有限公司	null	地址：福建省福州市闽侯县上街镇上街村
闽侯县懿添五金加工厂	厂长：邱懿添	地址：福建省福州市闽侯县荆溪镇永丰村
闽侯县上街年新豆制品厂	厂长：张守湘	地址：福建省福州市闽侯县上街镇联心村１９号
闽侯县明安五金厂	null	地址：福建省福州市闽侯县荆溪镇光明村沙溪9号
闽侯县尚干建平粮食加工厂	null	地址：福建省福州市闽侯县尚干镇后村村旧石狮
福建省闽侯康华塑料制品有限公司	null	地址：福建省福州市闽侯县青口镇工业路6号
闽侯县上街六桥粮油制品厂	厂长：林春生	地址：福建省福州市闽侯县上街镇过透村３０号
闽侯县南屿龙湖塑料制品厂	null	地址：福建省福州市闽侯县南屿镇龙泉村169号
福建省闽侯县上街鑫阳人造板厂	null	地址：福建省福州市闽侯县上街镇上街村丹屿
闽侯县城关供销社食品蜜饯厂贸易经营部	老板：洪鼎慈	地址：福建省福州市闽侯县甘蔗镇甘洲路２０９号
闽侯县闽东工艺品有限公司	null	地址：福建省福州市闽侯县城关818西路129号
闽侯县鸿辉服装玩具厂	null	地址：福建省福州市闽侯县甘蔗镇墩园洲85号
闽侯县青口宏二印刷厂	null	地址：福建省福州市闽侯县青口镇宏二村
闽侯县白沙大目埕印刷厂	null	地址：福建省福州市闽侯县白沙新街２６号
闽侯县江口利新织布厂	null	地址：福建省福州市闽侯县南屿镇江口青州
福建熔新机床厂劳动服务公司甘蔗门市部	老板：程美云	地址：福建省福州市闽侯县甘蔗镇８１８路
福建熔新机床厂铸造分厂	null	地址：福建省福州市闽侯县白沙镇孔原村
闽侯县南屿粮油加工厂	null	地址：福建省福州市闽侯县南屿镇水西１号
福建省闽候县青口镇壶山粮食加工厂	null	地址：福建省福州市闽侯县
闽侯县飞燕胶合板厂	null	地址：福建省福州市闽侯县荆溪镇港头村
福建双李彩印有限公司	null	地址：福建省福州市闽侯县南屿镇尧沙村
闽侯县祥谦旺盛玩具厂	null	地址：福建省福州市闽侯县祥谦镇洋下村
闽侯县上街玉恒粮食加工场	联系人：林炳行	地址：福建省福州市闽侯县上街镇上街村
闽侯县白沙机械铸造厂	null	地址：福建省福州市闽侯县白沙镇溪头村
闽侯县闽江乡清泉冷饮厂	null	地址：福建省福州市闽侯县闽江乡峡南村
闽侯县三禾特润滑油厂	厂长：林丽玉	地址：福建省福州市闽侯县荆溪镇
闽侯县青口镇镜江饲料厂	null	地址：福建省福州市闽侯县青口镇镜上村112号
闽侯县江口机械铸造厂	厂长：宋发大	地址：福建省福州市闽侯县南屿镇江口村
闽侯县祥谦亨枫饲料加工场	null	地址：福建省福州市闽侯县祥谦镇山前村
闽侯县古山洲凤昌纸盒厂	null	地址：福建省福州市闽侯县荆溪镇古山洲
闽侯县无线电元件厂工会委员会	null	地址：福建省福州市闽侯县甘蔗镇墩园洲５２号
闽侯县尚干朝晖冷饮厂	null	地址：福建省福州市闽侯县尚干镇过浦桥
闽侯县青口文华皮件厂	null	地址：福建省福州市闽侯县青口镇文华村
福州朝晖食品有限公司	null	地址：福建省福州市闽侯县尚干镇场新村
福州海嵘食品有限公司	总经理：郭益顿	地址：福建省福州市闽侯县闽江乡峡南村
福州家乐家食品有限公司	null	地址：福建省福州市闽侯县甘蔗镇818路
闽侯县南通农机修配厂	null	地址：福建省福州市闽侯县南通镇南通街７２号
福州鑫福皮革制品有限公司	null	地址：福建省福州市闽侯县上街镇新联开发区
福建省闽侯县五福塑料厂	null	地址：福建省福州市闽侯县甘蔗镇后山路
福建省闽候二中糖果厂	null	地址：福建省福州市闽侯县尚干镇尚南路78号
闽侯县上街榕兴服装厂	厂长：杨进忠	地址：福建省福州市闽侯县上街镇榕桥村幸福１号
闽侯县白沙服装厂	null	地址：福建省福州市闽侯县白沙镇白沙村
闽侯县宏达制衣厂	null	地址：福建省福州市闽侯县甘蔗镇山前村军民路２８号
闽侯县南屿玉峰服装厂G	null	地址：福建省福州市闽侯县南屿镇南旗村
闽侯县竹岐金城制衣有限公司	null	地址：福建省福州市闽侯县竹岐乡榕东村
闽侯县房地产开发公司太阳能热水器厂	null	地址：福建省福州市闽侯县甘蔗镇山前村后街７１号
闽侯南港鞋业有限公司	总经理：张建章	地址：福建省福州市闽侯县南通镇泽洋村　　　　法定代表人：张建章
福建省闽侯县兴泰服装厂	厂长：王为芳	地址：福建省福州市闽侯县荆溪镇关口１９１号
福建省闽侯盛鑫电子厂	厂长：林振土	地址：福建省福州市闽侯县甘蔗镇环城路６８号
闽侯县祥谦官前空心砖厂	厂长：郭兆明	地址：福建省福州市闽侯县祥谦镇官前村大当
闽侯县甘蔗宏德竹木工艺厂	null	地址：福建省福州市闽侯县甘蔗镇甘洲路263号
闽侯县上街红光纸箱厂Ｇ	null	地址：福建省福州市闽侯县上街镇红峰村
闽侯县尚干镇虎泉饮料厂	null	地址：福建省福州市闽侯县尚干镇五虎路３号
闽侯县上街王派制衣厂	null	地址：福建省福州市闽侯县上街镇金桥村
闽侯县上街金山饮料厂	null	地址：福建省福州市闽侯县上街镇马排竹榄村
闽侯县涧泉饮料厂	null	地址：福建省福州市闽侯县青口镇溪东村５７号
福州浩胜食品机械有限公司	null	地址：福建省福州市闽侯县上街镇
福州达钟电机有限公司	成立日期：2001/3/28	地址：中国 福建 福州市 福建省福州市闽侯县青口镇青口投资区
福州职业技术学院	院长：孙芳仲	地址：闽侯县上街镇榕桥村、福州市广达路５５号
