福州浩威金属制品有限公司	总经理：胡英	地址：福建闽侯县兰圃工业区318号
福建省九兴投资有限责任公司	总经理：陈	地址：闽侯县甘蔗街道校园路21号后
福建优建建筑科技有限公司	总经理：蔡	地址：福建省福州市闽侯县上街镇科技东路3号福州高新区海西高新技术产业园创新园一期10#楼1
闽侯县南通方敏生服装加工场	联系人：方	地址：福建省福州市闽侯县南通镇方庄村
闽侯县闽旺农业专业合作社	联系人：林	地址：福建省福州市闽侯县白沙镇上岐村上岐70号
闽侯县富城农业专业合作社	联系人：林	地址：闽侯县廷坪乡汶合村九里11号
闽侯县洋里德群家庭农场	联系人：陈	地址：福建省福州市闽侯县洋里乡绅带村桥里自然村水槽亭
闽侯县鸿尾耕慧家庭农场	联系人：陈	地址：福建省福州市闽侯县鸿尾乡南坑村
福建溪源种德生态农业有限公司	总经理：潘	地址：闽侯县上街镇溪源宫村罗丰片
福州宏华家居制造有限公司	总经理：黄	地址：福建省福州市闽侯县竹岐乡榕西村中埕67号厂房三层
福州鸿祥运输有限公司	总经理：卢	地址：福建省福州市闽侯县南屿镇忠观街3号旗山商贸街商住楼9号楼1层07店面
闽侯县大山里工艺品商行	联系人：黄	地址：福建省福州市闽侯县上街镇上街四房（林友钦宅）
福建华粮米业有限公司	总经理：林	地址：福建省福州市闽侯县荆溪镇福州市粮食批发交易市场1座19号
闽侯县南通镇洲头跳龙门锦鲤育苗场	联系人：黄	地址：福建省福州市闽侯县南通镇洲头村里洋
福州云众数据科技有限公司	总经理：林	地址：福建省福州市闽侯县科技东路3号福州高新区海西高新技术产业园创新园一期10#楼1层158室
福建蓝城信息科技有限公司	总经理：林	地址：福建省福州市闽侯县科技东路3号福州高新区海西高新技术产业园创新园一期10#楼1层166室
闽侯县五福茶叶有限公司	总经理：洪	地址：闽侯县五福茶叶有限公司
福建久策气体销售有限公司	总经理：何	地址：福建省福州市闽侯县南屿镇117县道新联村福州高新区两园安置房一期一标段裙楼三层3-002
福州海峡龙祥建设有限责任公司	总经理：彭	地址：闽侯县祥谦镇福厦公路（324）国道西侧21公里处
福建鑫善源农业开发有限公司	总经理：林	地址：福建省福州市闽侯县尚干镇后村村后埕1号
闽侯县丰达竹木制品有限公司	总经理：方	地址：闽侯县竹岐乡竹岐村
福州市闽侯县王府建材有限公司	总经理：陈	地址：福州市闽侯县祥谦镇辅翼村福建豪峰金属制品有限公司厂房三整座
福州迁旺家家居股份有限公司	总经理：李	地址：福建省福州市闽侯县上街镇马保村闽侯县艺根玻璃有限公司4#厂房3楼
闽侯县仙门山食用菌专业合作社	联系人：王	地址：福建省闽侯县洋里乡仙门村岩头4号
闽侯县墨轩教育咨询有限公司	总经理：洪	地址：福州市闽侯县上街镇蔗洲村学生街2号楼211室
闽侯县鸿尾紫藤家庭农场	联系人：罗	地址：福建省福州市闽侯县鸿尾乡南坑村
福州臻顺建筑劳务有限公司	总经理：陈	地址：闽侯县上街镇沙堤村中洲片
福建森朗贸易有限公司	总经理：林	地址：福建省福州市闽侯县甘蔗街道入城路东方花园6#501
闽侯县旭丰工艺品有限公司	总经理：方	地址：闽侯县南通镇方庄
福州兴诺机械工业有限公司	总经理：卢	地址：福建省福州市闽侯县南屿镇高岐村福州海量管道器材有限公司6#综合整座
福州博红森实业有限公司	总经理：陈	地址：福建省福州市闽侯县上街镇建平村金上大道博仕后家园1#06店
福州印象行天下汽车租赁有限公司	总经理：林	地址：福建省福州市闽侯县祥谦镇中院村中院47号
福州市邂逅巴黎餐饮管理有限公司	总经理：李小姐	地址：福州市闽侯县上街镇庄南村博仕后缘墅
福州经炜家居饰品有限公司	总经理：沈	地址：闽侯县甘蔗街道大元村
闽侯县鸿尾乡雪英农林综合场	联系人：谢	地址：福建省福州市闽侯县鸿尾乡南元村垄门池
福州泰茂机电科技有限公司	总经理：罗	地址：闽侯县青口镇新城西路58号博雅星城凯景大酒店910单元
闽侯县白沙后义洋农业综合开发示范场	联系人：张	地址：福建省福州市闽侯县白沙镇安平路67号
福州快捷快递有限公司	总经理：杨	地址：闽侯县祥谦镇辅澜路3号1#厂房整座
福州亚鼎汽车贸易有限公司	总经理：李	地址：福州市闽侯县青口镇宏四村马路街50号茂泰花园1#楼1层07店面
福州闽都网络技术工程有限公司	总经理：余	地址：闽侯县
闽侯县华盛农业专业合作社	联系人：聂	地址：闽侯县廷坪乡池坑村上弯37号
福州鑫时尚家纺有限公司	总经理：王	地址：闽侯县荆溪镇光明村
福州众行汽车销售有限公司	总经理：张	地址：福建省福州市闽侯县尚干镇祥通路11-2号
福州银宝汽车服务有限公司	总经理：许	地址：福州市闽侯县尚干镇良安路8号江浩尚景园5号楼806
闽侯县大邱坪生态种养殖专业合作社	联系人：朱	地址：闽侯县鸿尾乡古洋村外境16号
闽侯县新春医药有限公司	总经理：王	地址：闽侯县上街镇国宾大道2号博仕后公馆商业广场A12#楼一层24、25店面
福州贝林工艺品有限公司	总经理：肖	地址：闽侯县荆溪镇荆溪村
福建经帆建筑劳务有限公司	总经理：马	地址：福建省闽侯县上街镇沙堤村后街66号
福州佶盛典当行有限公司	总经理：周	地址：福建省福州市闽侯县甘蔗街道昙石山东大道10号综合楼一层
闽侯县新晖企业管理有限公司	总经理：郑	地址：闽侯县甘蔗街道昙石山西大道98号新城丽景B区10#楼2层212店面
福州阳光钱柜音乐会所有限公司	总经理：林	地址：福建省闽侯县青口镇付竹村富竹大厦三层
闽侯县上街美刻妆容美容中心（普通合伙）	联系人：杨	地址：福建省福州市闽侯县上街镇博仕后公馆3号楼3-4号店
闽侯县总部园房地产有限公司	总经理：林	地址：闽侯县甘蔗街道八一八西路185号
福建长大建设有限公司	总经理：林	地址：闽侯县甘蔗街道昙石山西大道98号新城丽景B区12#楼503单元
闽侯县如果电子商务有限公司	总经理：卢	地址：福建省福州市闽侯县南通镇街西排东起第六直
闽侯县益康生农业专业合作社	联系人：鄢	地址：闽侯县五都村榜尾洋
福州联亿汽车配件有限公司	总经理：林	地址：闽侯县祥谦镇兰圃村住宅小区
闽侯县富利民食品有限公司	总经理：吕	地址：闽侯县竹岐乡竹岐村
闽侯县峰龙山农业专业合作社	联系人：何	地址：闽侯县白沙镇白沙村
闽侯县肆年传媒有限公司	总经理：周	地址：闽侯县上街镇岐安村（福州地区大学新校区体育场地东南附属楼）
世纪民生（福州）蔬菜有限公司	总经理：林	地址：闽侯县南通镇福州市海峡蔬菜批发市场精品场位106号
闽侯县华烨工艺品有限公司	总经理：王	地址：闽侯县荆溪镇港头村坛山29号
福州市甲午农业开发有限公司	总经理：欧	地址：福州市闽侯县竹岐乡竹岐村虎鼻头
福州泓一金属制品有限公司	总经理：王	地址：闽侯县竹岐乡竹西溪口116号2号厂房
福州智能时代电子科技有限公司	总经理：赖	地址：福建省福州市闽侯县科技东路3号福州高新区海西高新技术产业园创新园10#楼1层142室
闽侯县宏丰达金属制品有限公司	总经理：郭	地址：闽侯县祥谦镇中院村（原祥谦中院中心小学内）
福州佳胜贸易有限公司	总经理：吴	地址：福建省福州市闽侯县青口镇宏四村
福州有聊影视文化有限公司	总经理：盘	地址：福建省福州市闽侯县科技东路8号福州高新区海西高新技术产业园创业大厦B区1层159室
闽侯县鑫瑞杰贸易有限公司	总经理：李	地址：闽侯县大湖乡珍山村1号
福州新竹科技园发展有限公司	总经理：何	地址：福建省福州市闽侯县科技东路8号福州高新区海西高新技术产业园创业大厦B区2层205室
闽侯县尚干鸿哲商务信息咨询服务部	老板：吴	地址：福建省福州市闽侯县尚干镇新榕路1号新榕小区02幢19号店铺
闽侯县若水生花生物科技有限公司	总经理：张	地址：闽侯县上街镇岐安村（福州地区大学新校区体育场地东南附属楼）
福州卓尔物流有限公司	总经理：杨	地址：福州市闽侯县祥谦镇辅澜路3号福州皇杰实业有限公司研发楼五层501室
闽侯县彦铭贸易有限公司	总经理：徐	地址：闽侯县甘蔗街道洽浦村洽浦193号
福州盛科计算机网络信息技术有限公司	总经理：叶	地址：闽侯县上街镇岐安村（福州地区大学城新校区体育场地东南附属楼）
福州鑫辉达设备租赁有限公司	总经理：林	地址：福州市闽侯县上街镇浦口村
福建荣捷万仕德汽车销售服务有限公司	总经理：姜	地址：福建省福州市闽侯县青口镇新城西路62号博雅星城16#楼16店面
福州上仟贸易有限公司	总经理：陈	地址：福州市闽侯县上街镇建平路99号福建高速物流园12#130-131
闽侯县永诚包装制品有限公司	总经理：宋	地址：福建省福州市闽侯县甘蔗街道大元巷102号
福州亚博天汽车贸易有限公司	总经理：念	地址：福建省闽侯县青口镇新城路62号博雅星城2#楼1层03店面
闽侯县野狼贸易有限公司	总经理：林	地址：闽侯县上街镇美岐小区二期5座107室
福州城森园林景观工程有限公司	总经理：唐	地址：福建省福州市闽侯县南屿镇南前村土溪厝3号
福州市情定依身贸易有限公司	总经理：王	地址：闽侯县上街镇岐头村5-6号
闽侯县洋里诗尧工艺品加工场	联系人：江	地址：福建省福州市闽侯县洋里乡洋里村洋里街西路107号
上海奉贤建设发展（集团）有限公司福州分公司	总经理：钱	地址：福建省福州市闽侯县南屿镇旗山集中工业区8号楼二层
闽侯县千家山农业专业合作社	联系人：林	地址：闽侯县甘蔗镇军民路12号五层楼房
闽侯县众彩广告传媒有限公司	总经理：林	地址：闽侯县祥谦镇枕峰村上塘125号
福州三友装修有限公司	总经理：畅	地址：福建省福州市闽侯县甘蔗街道入城路南侧
青峰（福州）传媒有限公司	总经理：林	地址：闽侯县青口镇升旗村青口街53号
福州市闽侯县圆柏贸易有限公司	总经理：毛	地址：福建省福州市闽侯县上街镇国宾大道338号英泰第一城B区商住楼5#619单元
闽侯县祥顺农林开发有限公司	总经理：邓	地址：福建省福州市闽侯县竹岐乡竹岐村
福州秋实园贸易有限公司	总经理：陈	地址：福州市闽侯县上街镇庄南路1号“博仕后缘墅“E2#103
闽侯县仙和祥原生态农业有限公司	总经理：王	地址：福建省福州市闽侯县洋里乡仙门村坝头自然村3号
福州三友和贸易有限公司	总经理：陈	地址：闽侯县甘蔗街道昙石山西大道98号新城丽景B区10#楼2层214店面
福建神州美景健康管理有限公司	总经理：陈	地址：福州市闽侯县科技东路8号福州高新区海西高新技术产业园创业大厦B区1层157室
福建根艺达工艺品有限公司	总经理：陈	地址：福建省闽侯县上街镇国宾大道1号闽都大庄园沿街商住9#楼1层147店面
福州市闽侯县科阳金属制品有限公司	总经理：陈	地址：福州市闽侯县上街镇沙堤村（闽侯县鑫龙寿五金机械有限公司）2#厂房4层405
福州九易传媒有限公司	总经理：林	地址：闽侯县甘蔗街道入城路横屿233号一楼店面
福建省煜景装饰设计有限公司	总经理：聂	地址：闽侯县上街镇国宾大道276号综合商场7层
福州菜鸟工艺品有限公司	总经理：蔡	地址：闽侯县上街镇闽都大庄园165号店面
福州市耀辉广告有限公司	总经理：李先生	地址：闽侯县上街镇建平村金上大道博仕后家园2#08号1层
福州诚辉工艺品有限责任公司	总经理：方先生	地址：闽侯县南通镇方庄工业区
福建通盛酒店设备有限公司闽侯设备分厂	厂长：芦先生	地址：闽侯县南屿镇元峰村、流洲村（福州光华百特饲料有限公司）1#
福州德利原生态农业科技开发有限公司	总经理：萧先生	地址：闽侯县白沙镇井下村村委会办公楼
闽侯县车饰界汽车服务有限公司	总经理：郑先生	地址：闽侯县青口镇前洋新洋68号
福建闽裕服饰有限公司	总经理：张先生	地址：福州市闽侯县荆溪镇溪口工业区徐家村169号1#厂房
福州祥宝工艺品有限公司	总经理：许先生	地址：闽侯县上街镇岐头村7-3号
福州德丰汽车贸易有限公司	总经理：黄先生	地址：福州市闽侯县上街镇源通东路59号尚书耕天下8号楼一层商铺
闽侯县鸿尾宏力胜农业开发基地	联系人：刘先生	地址：闽侯县鸿尾乡岩石村官坪
闽侯县白沙镇明光优质橄榄培育基地	联系人：张明光	地址：闽侯县白沙镇大濑村群众山
福建鸿盈建设工程发展有限公司	总经理：赵文标	地址：闽侯县荆溪镇荆溪村徐家村232
福州新建邦汽车运输有限公司	总经理：胡文钊	地址：闽侯县祥谦镇枕峰工业区
福建兰蕙贸易有限公司闽侯汽车销售服务分公司	总经理：朱芳芳	地址：闽侯县南屿镇后山村宅山88号（福建中元艺术品有限公司）厂房一、二层
香冠园（福州）食品有限公司	总经理：刘顺祥	地址：福州市闽侯县祥谦镇澜澄村新街20号
福州精美工艺品有限公司	总经理：徐光明	地址：闽侯县上街镇岐头村3号
闽侯县祥谦溢嘉鞋业有限公司	总经理：吴华?	地址：闽侯县祥谦镇泮洋村
闽侯县粤湘居海鲜大酒楼有限公司	总经理：吴仙明	地址：闽侯县上街大学城蔗洲村2号商业网点第一幢第二层第1-8号店面
福建省闽侯县布洛森贸易有限公司	总经理：欧阳家祚	地址：福建省闽侯县上街镇国宾大道338号英泰第一城B区12#楼302单元
福州捷鑫制冷设备有限公司	总经理：程诒君	地址：闽侯县青口镇青口村
福州尚品国际酒店有限公司	总经理：黄幸福	地址：闽侯县青口镇义溪路88号办公楼
福州春源食品有限公司闽侯分公司	总经理：林秋先生	地址：闽侯县甘蔗街道闽侯经济技术开发区东岭路3号
福州金兄弟工艺品有限公司	总经理：金雨先生	地址：闽侯县上街镇新洲村
闽侯县跃丰贸易有限公司	总经理：郑美忠	地址：闽侯县青口镇壶山村陶精路3号“千家花园”1#店面35
福州金雕艺仁工艺品有限公司	总经理：王金仁	地址：闽侯县上街镇岐头村39号
闽侯县胜业贸易有限公司	总经理：张先生	地址：闽侯县上街镇新峰村上街商贸中心1#11号店
中建三局第三建设工程有限责任公司闽侯分公司	总经理：陈先生	地址：闽侯县甘蔗街道昙石山中大道118号新城丽景A区5#楼301单元
闽侯县子曰教育咨询有限公司	总经理：薛先生	地址：闽侯县上街大学城广贤路第壹幢第贰层第壹号
闽侯县建辉夹芯板有限公司	总经理：刘先生	地址：闽侯县荆溪镇徐家村委会旁
福州市鼎睿运动用品有限公司	总经理：林先生	地址：闽侯县荆溪镇永丰村（闽侯丰华工艺品有限公司1座2层）
福州力芯光电有限公司	总经理：陈先生	地址：闽侯县祥谦镇洋下村十字路
福州锦平贸易有限公司	总经理：李先生	地址：闽侯县鸿尾乡超乾村（鸿尾乡人民政府）8#楼
福州贸兴包装有限公司闽侯县甘蔗分公司	总经理：翁先生	地址：闽侯县甘蔗街道大元村陈店湖工业区（福州贸兴包装有限公司）7#楼整座
福州市东冈子茶业有限公司	总经理：田丽丽	地址：福州市闽侯县南屿镇高岐村岸里43号
福州市新诺美环境科技有限公司	总经理：郑伟先生	地址：闽侯县上街镇科技东路海西高新技术产业园创新园10号楼1层106室
福州市印象金牌广告有限公司	总经理：薛娇玲	地址：闽侯县青口镇青秀村（林良准房屋）
福州腾飞龙工艺品有限公司	总经理：岑才达	地址：闽侯县上街镇建平村（金宝钦房屋）
福州星之杰汽车贸易有限公司	总经理：陈娜斌	地址：闽侯县尚干镇中心街贵和楼一层106店面
福建宝岛眼镜（连锁）有限公司闽侯第四经营部	老板：林东先生	地址：闽侯县上街镇闽江学院第三食堂一层24号店
福建吉特瑞生物科技有限公司	总经理：袁平先生	地址：福州市闽侯县上街镇科技东路福州高新区“海西高新技术产业园”创新园10号楼1层
福州华商进出口有限公司	总经理：曾华禄	地址：闽侯县上街镇红峰村
福州市新薛航汽车贸易有限公司	总经理：彭东先生	地址：福州市闽侯县青口镇前洋村新洋63-5号
闽侯县和泽食品有限公司	总经理：林泉先生	地址：闽侯县南通镇延宅村
闽侯县荆溪兆先淡水养殖场	联系人：董先生	地址：闽侯县荆溪镇埔前村21号
闽侯县敏顺园林开发有限公司	总经理：陈先生	地址：闽侯县甘蔗街道横屿村普通住宅B3#705
闽侯县香吉品贸易有限公司	总经理：黄先生	地址：闽侯县上街镇上街村（赵华金）自用房整座二楼203
闽侯县欣贵族汽车服务有限公司	总经理：潘兆基	地址：闽侯县南通镇陈厝村卫星69号4#厂房一层
闽侯县洋里坑里洋农场	联系人：张先生	地址：闽侯县洋里乡田?村坑里洋
闽侯县竹岐五金工艺铁皮加工场	联系人：张先生	地址：闽侯县竹岐乡榕西村
焙客瑞（福州）食品有限公司	总经理：曾先生	地址：闽侯县上街镇马保村后园路36号1#仓库5层
正大欧瑞信（福建）生物科技有限公司	总经理：李先生	地址：福州市闽侯县经济技术开发区（二期）东岭路
闽侯县祥谦秀秀日用品店	老板：杨先生	地址：闽侯县祥谦镇泮洋大?
闽侯县尚干中心街中山门诊部	老板：张先生	地址：闽侯县尚干镇中心街（林氏祠堂旁）
闽侯县尚干金太郎蛋糕坊	联系人：林先生	地址：闽侯县尚干镇过浦村市场新村9号
闽侯县尚干聪颖屋孕婴生活馆	联系人：柯先生	地址：闽侯县尚干镇祥谦路310号
闽侯县上街中凯建材店	老板：吴先生	地址：闽侯县上街镇新峰村梧洋
闽侯县上街天使之都生活超市	联系人：柯先生	地址：闽侯县上街镇源通东路118号钱隆学府15#楼首层3、4号
闽侯县上街丽铭复印店	老板：徐先生	地址：闽侯县上街镇福建师范大学旗山校区文化街56号
闽侯县上街二十二区服装店	老板：吴先生	地址：闽侯县上街镇大学城国宾大道233号博仕后购物广场3-2#-136区位
闽侯县上街鼎艺手工画工作室	联系人：谢先生	地址：闽侯县上街镇博仕后家园B区3#楼619室
闽侯县上街城市之外咖啡屋	联系人：林先生	地址：闽侯县上街镇闽都大庄园健身馆内
闽侯县青口秋平瓷砖店	老板：林先生	地址：闽侯县青口镇团结村
闽侯县南屿信勇日用品店	老板：江先生	地址：闽侯县南屿镇南屿街
闽侯县南屿堂春大药房	联系人：宋先生	地址：闽侯县南屿镇南井村上井
闽侯县南屿水密码奶茶店	老板：邱先生	地址：闽侯县南屿镇南旗村闽侯三中路口
闽侯县南屿三维电器店	老板：李先生	地址：闽侯县南屿镇南井生活小区1#6-2店面
闽侯县南屿金辉石材加工店	老板：刘先生	地址：闽侯县南屿镇南旗村
闽侯县南屿鼎邦汽车租赁服务部	老板：陈先生	地址：闽侯县南屿镇南旗村
闽侯县南屿艾童母婴用品店	老板：陈先生	地址：闽侯县南屿镇南旗村
闽侯县南通开和玻璃店	老板：潘先生	地址：闽侯县南通镇南通街
闽侯县荆溪安健汽车租赁服务部	老板：李先生	地址：闽侯县荆溪镇关东村西境102号
闽侯县甘蔗新爱科渔具店	老板：江先生	地址：闽侯县甘蔗街道南山安置房一层叁号店
闽侯县甘蔗城关市场章秋水产品店	老板：程先生	地址：闽侯县甘蔗街道城关第一市场内
闽侯县甘蔗兵戈茗馨茶艺会所	所长：苏先生	地址：闽侯县甘蔗交通路56号5号店面
闽侯县白沙豪林摩托车行	联系人：林先生	地址：闽侯县白沙镇白沙村埕元王依生厝
闽侯县中程机械租赁有限公司	总经理：程礼辉	地址：闽侯县荆溪镇港头村
福州吉盛工艺品有限公司	总经理：黄娟先生	地址：闽侯县上街镇新峰村、红峰村7#205单元
福州榕缘木业有限公司	总经理：吴锦城	地址：闽侯县上街镇建平村四中
闽侯县盛隆工艺品有限公司	总经理：洪秀贞	地址：闽侯县甘蔗街道陈店湖工业区10号
闽侯县闽瑞珍源蔬果农民专业合作社	联系人：林杏香	地址：闽侯县大湖乡珍山村1号
闽侯县佳联丰贸易有限公司	总经理：余丽蓉	地址：闽侯县上街镇源通禾路59号尚书耕天下花园1#楼1001单元
福州世盛汽车销售服务有限公司	总经理：杨坚先生	地址：福州市闽侯县祥谦镇兰圃村
福建省闽侯县马岚山生态农业有限公司	总经理：陈宽敏	地址：闽侯县大湖乡后井村
闽侯县万德福贸易有限责任公司	总经理：赵绣华	地址：闽侯县上街镇源通东路118号福晟学府2#楼一号店
福建省菁蕙花卉园艺有限公司	总经理：张献民	地址：闽侯县荆溪镇关东村东境41号
福州宏美实业有限公司闽侯分公司	总经理：宿建强	地址：闽侯县荆溪镇古山洲村福州大世界橄榄有限公司
闽侯金辉工艺品有限公司	总经理：唐炜崧	地址：福州市闽侯县南通镇罗洲村村里1-1号1#综合楼2层
闽侯县志实贸易有限公司	总经理：何娇先生	地址：闽侯县青口镇新城西路62号博雅星城19#楼1层07店面
福州宝云贸易有限公司	总经理：王宝云	地址：福州市闽侯县南通农产品物流中心海峡副食品批发市场2113
闽侯县馨宿商务酒店	老板：陈宝荣	地址：闽侯县甘蔗街道昙石山西大道98号新城丽景B区12号楼204至213店面
闽侯县新辉亮包装品厂	厂长：林伟先生	地址：闽侯县尚干镇虎山路
闽侯县康祥耐皿制品厂	厂长：朱宗政	地址：闽侯县竹岐乡白龙村318号（天顺公司内）
闽侯县海纳家居饰品有限公司	总经理：叶震先生	地址：闽侯县甘蔗街道十字村陈店湖工业集中区
闽侯县富家门业有限公司	总经理：江高富	地址：闽侯县竹岐乡春风村庄边桥
福州永百惠贸易有限公司	总经理：郑培展	地址：闽侯县南通镇海峡蔬菜批发市场南区10#101号店
福州市闽侯县木华天宝工艺馆	联系人：蔡俊先生	地址：闽侯县上街镇岐安村浦兴路浦安小区12栋205号
福州时代华庭家居饰品有限公司	总经理：林昌新	地址：闽侯县甘蔗街道长江村（叶建兴、黄恒松产权）
福州快连货运代理有限公司	总经理：连泉强	地址：闽侯县上街镇中美村高速物流园2号楼210号
福州金艺堂工艺品有限公司	总经理：金宁鑫	地址：闽侯县上街镇新洲村（金庭云住宅）
福州辉胜达环保科技有限公司	总经理：缪石书	地址：闽侯县青口镇船尾长楼村（福建鑫上华钢制品有限公司内）
福建省百盛建设发展有限公司闽侯分公司	总经理：林华龙	地址：闽侯县荆溪镇关口村364号
闽侯县仙人岗林果基地	联系人：吴秀莺	地址：闽侯县白沙镇马坑村仙人岗
福州天缘鑫贸易有限公司	总经理：张智职	地址：闽侯县白沙镇白沙安平路35号
福州益品生物科技有限公司	总经理：方先生	地址：福州市闽侯县甘蔗街道铁岭西路15号第三栋第三层
闽侯县绿榕果蔬专业合作社	联系人：黄先生	地址：闽侯县南通镇洲头村东43号
苏州市东吴物业管理有限公司福州分公司	总经理：刘先生	地址：福州市闽侯县上街镇福州大学行政北楼西101室
福州市福艺轩工艺品有限公司	总经理：林先生	地址：闽侯县上街镇新峰村44号
福建杰荣不锈钢商用设备有限公司	总经理：王先生	地址：闽侯县南屿镇元峰村、流洲村（福州光华百特饲料有限公司）4#
闽侯县甘蔗蓬蒂园艺场	联系人：徐先生	地址：闽侯县甘蔗镇三英村洲尾弄16号
福州金华彩钢夹芯板有限公司	总经理：钱先生	地址：闽侯县青口镇前洋村
福州养心生态农业开发有限公司	总经理：黄先生	地址：闽侯县鸿尾乡溪元村石峡3号
闽侯县上街毅族领地根艺馆	联系人：张先生	地址：闽侯县上街镇国宾大道338号英泰第一城B区3#楼413单元
闽侯县上街天顺木根雕工艺品店	老板：陈先生	地址：闽侯县上街镇榕桥村联丰11号
福州海峡副食品批发市场祥如商行	联系人：高先生	地址：闽侯县南通镇闽侯县南通镇海峡副食品批发市场1137号店
闽侯县上街旺龙电动车配件修理店	老板：郑先生	地址：闽侯县上街镇金屿村金桥2号第2间店
闽侯县白沙秀逸形象沙龙	联系人：陈先生	地址：闽侯县白沙镇安平路108号（二层）
闽侯县南屿阿胖土菜馆	联系人：宋先生	地址：闽侯县南屿镇江口村
闽侯县南通祚旺五金店	老板：郭先生	地址：闽侯县南通镇罗洲村
闽侯县上街云映小吃店	老板：林先生	地址：闽侯县上街红峰村商贸街一楼林汉挺房
闽侯县上街容乐服饰店	老板：郑先生	地址：闽侯县上街镇福建师范大学旗山校区文化街3号-2店
闽侯县南通忠钽便利店	老板：卢先生	地址：闽侯县南通镇马腾村
闽侯县祥谦建林食杂店	老板：郑先生	地址：闽侯县祥谦镇卜洲村中厝
闽侯县青口野狼服饰商店	老板：程先生	地址：闽侯县青口镇农光村新城路博雅星城20#店面07
闽侯县万科汇开发有限公司	总经理：肖先生	地址：闽侯县上街镇人民政府125号
福州善根缘工艺品有限公司	总经理：郑先生	地址：闽侯县上街镇马排村马州8号
福州市东岸光网科技有限公司	总经理：张先生	地址：闽侯县甘蔗街道昙石山西大道33号源泉大酒店七层
闽侯县桃田现代农业专业合作社	联系人：郑先生	地址：闽侯县荆溪镇桃田村桃田69号
福州闽福美工艺品有限公司	总经理：林先生	地址：闽侯县上街镇中美村
闽侯县远新工贸有限公司	总经理：林先生	地址：闽侯县青口镇红旗村、升旗村（福州均顺汽车配件有限公司内）
福州市闽侯星海源玻璃有限公司	总经理：欧先生	地址：闽侯县上街镇上街村三橄榄1号
福州鑫荣达装饰工程有限公司	总经理：王先生	地址：闽侯县甘蔗街道墩园洲工业区
福州市瑞康医疗器械有限公司	总经理：吴先生	地址：闽侯县荆溪镇永丰村
盛德佳（福建）投资有限公司	总经理：陈先生	地址：闽侯县上街镇金屿村南楼411
福建省闽乾建设工程有限公司	总经理：洪先生	地址：闽侯县甘蔗街道恒心路70号昙石村公建房（昙石山博物馆安置房）5#楼201单元
闽侯县南屿云龙水产养殖场	联系人：陈先生	地址：闽侯县南屿镇双龙村半月溪
闽侯县荆溪一强五金建材商行	联系人：林先生	地址：闽侯县荆溪镇关口村4号
闽侯县上街新峰小许米店	老板：许先生	地址：闽侯县上街镇新峰村新宅26号
闽侯县甘蔗闽诚制冷机电维修部	老板：苏先生	地址：闽侯县甘蔗街道昙石山中大道118号新城丽景A区8#楼806单元
闽侯县甘蔗泉翔电器商场	联系人：黄先生	地址：闽侯县甘蔗街道昙石村昙石安康路1#1-10店面
闽侯县荆溪柳春尼彩手机店	老板：吴先生	地址：闽侯县荆溪镇入园路
福州粮食批发交易市场厚道粮行	联系人：郭先生	地址：闽侯县荆溪镇福州市粮食批发交易市场5座9、10号
闽侯县青口文华服装商店	老板：杨先生	地址：闽侯县青口镇前街村53号
闽侯县南屿一茗茶叶店	老板：宋先生	地址：闽侯县南屿镇南旗水西林
闽侯县甘蔗江林装卸服务队	队长：程先生	地址：闽侯县甘蔗街道双池村
闽侯县甘蔗好实惠床上用品店	老板：李先生	地址：闽侯县甘蔗街道侨园街1号从南向北第二间
闽侯县青口中信广告用品商行	联系人：李先生	地址：闽侯县青口镇宏四村马路街50号茂泰花园1#楼1层08店面
闽侯县鸿尾昌涌涂料店	老板：张先生	地址：闽侯县鸿尾乡石佛头街130号
闽侯县鸿尾兴花化妆品店	老板：温先生	地址：闽侯县鸿尾乡农贸市场内
闽侯县甘蔗南山伟发钢材店	老板：黄先生	地址：闽侯县甘蔗街道甘洪路北侧南山安置房一层16、17号
闽侯县甘蔗耀华矿泉水销售店	老板：程先生	地址：闽侯县甘蔗福龙新村7号楼1层01店面
闽侯县鸿尾郑香莲水性涂料店	老板：郑先生	地址：闽侯县鸿尾乡超?村石佛头街
闽侯县荆溪叶鸿辉中西医结合诊所	所长：叶先生	地址：闽侯县荆溪镇徐家村235号
闽侯县凤仪萱牛角制品有限公司	总经理：黄先生	地址：闽侯县南屿镇中溪村溪坂7号
福州结善缘木雕有限公司	总经理：张先生	地址：闽侯县上街镇红峰村尚街根艺创意园1号楼1层18号
福建倪世海峡投资有限公司	总经理：林先生	地址：福建省闽侯县南通镇南通街108号
闽侯县上街新胜辉铁件加工场	联系人：陆先生	地址：闽侯县上街镇榕桥村太山仔
闽侯县兴洪农业开发有限公司	总经理：洪先生	地址：闽侯县甘蔗街道洽浦村212号
正荣（闽侯）投资发展有限公司	总经理：吴先生	地址：福建省福州市闽侯县上街镇马保村
闽侯县和协仓储有限公司	总经理：黄先生	地址：闽侯县青口镇新城路62号博雅星城18#楼631单元
福建省闽侯县修元生物科技有限公司	总经理：黄先生	地址：闽侯县白沙镇大目埕村溪口38号
福州市闽杰医疗器械有限公司	总经理：张先生	地址：闽侯县竹岐乡国宾大道616号13#厂房第3层A区
福建省信通置业有限公司	总经理：林先生	地址：福州市闽侯县南屿镇南井村新桥头（闽侯县南屿搬运站内）
福州乐福工艺品有限公司	总经理：王先生	地址：闽侯县上街镇岐头村14号
福州优展机械设备有限公司	总经理：吴先生	地址：闽侯县青口镇农光村新城博雅星城19#楼1层03店面
福州东森家居有限公司	总经理：蔡先生	地址：闽侯县甘蔗街道双池村（福建省闽侯县顺顺食品有限公司内）
闽侯县莲池果蔬专业合作社	联系人：林先生	地址：闽侯县小箬乡小箬村
福州原点标识设计有限公司	总经理：魏先生	地址：闽侯县荆溪镇荆溪村（福州艾密克汽车配件有限公司5#厂房第6层）
福州苏平工艺品有限公司	总经理：苏先生	地址：闽侯县上街镇建平村
闽侯县恒之达喷涂设备有限公司	总经理：吴先生	地址：闽侯县荆溪镇光明村中截42号一层
福州市闽侯县纽艾迪工艺品有限公司	总经理：陈先生	地址：闽侯县鸿尾乡超乾村
福州旺顺明工艺品有限公司	总经理：陈先生	地址：闽侯县上街镇沙堤村前街5号
福州安吉思汽车有限公司	总经理：陈先生	地址：闽侯县青口镇海峡汽车文化广场一期汽车超市三层D318单元
福州安德生工艺品有限公司	总经理：吴先生	地址：闽侯县竹岐乡苏洋村苏洋10号
闽侯县南通城祥工艺品加工场	联系人：陈先生	地址：闽侯县南通镇罗洲村村?
闽侯县岭秀果林农场	联系人：林先生	地址：闽侯县廷坪乡盘岭村上盘岭30号
福州硕海木雕有限公司	总经理：林先生	地址：闽侯县上街镇红峰村上街展示交易中心1号楼三层29号
福州瑞安思贸易有限责任公司	总经理：张先生	地址：闽侯县鸿尾乡石佛头街158号
福州市瑞通信息技术有限公司	总经理：陈维焰	地址：闽侯县甘蔗街道双福社区3#602室（原五福园洋里乡干部集资楼602室）
闽侯县南通阳光宝宝婴幼儿奶粉店	老板：王先生	地址：闽侯县南通镇南通街32号
闽侯县青口易淘服装商店	老板：陈先生	地址：闽侯县青口镇农光村新城路博雅星城12#店面29
闽侯县上街宜佳小百货店	老板：王先生	地址：闽侯县上街镇金屿村金桥2号楼第3间店
闽侯县青口易阳五金店	老板：林先生	地址：闽侯县青口镇红旗村青长路
闽侯县荆溪双林日杂店	老板：林先生	地址：闽侯县荆溪镇荆溪村
闽侯县南通一国盲人推拿店	老板：林先生	地址：闽侯县南通镇南通街
福州海峡副食品批发市场陈如金干货商行	联系人：陈先生	地址：闽侯县南通镇海峡副食品批发市场3154号店
闽侯县甘蔗恒欣劳保用品店	老板：毛先生	地址：闽侯县甘蔗街道员工公寓2#-04店铺
闽侯县南屿御龙轩饮食店	老板：罗先生	地址：闽侯县南屿镇后山村（吴国榕厝）
福州海峡副食品批发市场胜前商行	联系人：蒋先生	地址：闽侯县南通镇海峡副食品批发市场3127号店
闽侯县荆溪福祥废品收购经营部	老板：黄先生	地址：闽侯县荆溪镇关口村93号
闽侯县南通淑铿日杂店	老板：潘先生	地址：闽侯县南通泽苗街
闽侯县南通唐明华铝合金加工店	老板：陈先生	地址：闽侯县南通镇泽苗村帮道北3号
闽侯县白沙永鑫隆便利店	老板：林先生	地址：闽侯县白沙镇南洋小区9号
闽侯县荆溪悦翔电信专营店	老板：林先生	地址：闽侯县荆溪镇入园路211号
闽侯县上街李梅云电焊店	老板：李先生	地址：闽侯县上街镇红峰村沙墩文明村第一层店1间
福建海峡文化产业股权投资管理有限公司	总经理：龚智坚	地址：福建闽侯县甘蔗镇校园路52号
福州中建壶山房地产开发有限公司	总经理：吴闽兴	地址：闽侯县青口镇壶山村新南公寓1#301
福州市华通建筑劳务有限公司	总经理：黄政先生	地址：闽侯县南屿镇南旗村旗顶尾
福建省金屿鸿贸易有限公司	总经理：林夏彬	地址：闽侯县上街镇英泰第一城商住楼K1/10#2层06室
闽侯县杰胜贸易有限公司	总经理：聂桃妹	地址：闽侯县甘蔗镇化龙村
闽侯县白沙顺利农业综合开发基地	联系人：李体明	地址：闽侯县白沙镇大目溪村洋中
闽侯县白沙官罗洋农林开发基地	联系人：叶邦清	地址：闽侯县白沙镇林柄村156号
闽侯县尽善农业开发有限公司	总经理：林善春	地址：闽侯县青口镇境上村
福州博源信机电设备有限公司	总经理：黄建安	地址：闽侯县青口镇壶山村东南千家花园3#402
泰康人寿保险股份有限公司福建分公司福州南屿营销服务部	老板：潘郭峰	地址：闽侯县南屿镇后山村三层（旗山饭店隔壁）
闽侯县春林家禽养殖专业合作社	联系人：俞国龙	地址：闽侯县南通镇瓜山村
闽侯红与黑家具有限公司	总经理：李功福	地址：闽侯县荆溪镇关东村东境96号
福州市闽侯县画通图文设计有限公司	总经理：林贤宾	地址：闽侯县荆溪镇古山洲73号
闽侯县鼎盛贸易有限公司	总经理：程文秋	地址：闽侯县甘蔗街道校园路53号
华福证券有限责任公司闽侯街心路证券营业部	老板：黄辉	地址：闽侯县甘蔗街道街心路32号首邑商业步行街A区1-5号楼2商业用房
闽侯县艺达盛贸易有限公司	总经理：程文艺	地址：闽侯县甘蔗街道海京楼6A107店
福州泓星艺家居制造有限公司	总经理：王磊	地址：闽侯县白沙镇白沙村埕元自然村
福建驰宇群发汽车销售服务有限公司	总经理：杨群	地址：福州市闽侯县青口镇新榕路1号海峡汽车文化广场一期汽车超市内第三层A区10号商铺
闽侯县华誉贸易有限公司	总经理：谢奕涵	地址：福建省福州市闽侯县上街镇美岐小区1#楼608
闽侯县五都水产良种养殖场	联系人：林本兴	地址：闽侯县南屿镇五都村
闽侯县共创车辆事务有限公司	总经理：林良荣	地址：闽侯县青口镇壶山村东南千家花园4#301
闽侯县杜坞水产场	联系人：王斯清	地址：闽侯县荆溪镇永丰村杜坞
福州沃野农业综合开发有限公司	总经理：王天华	地址：福州市闽侯县大湖乡东姚村帮山6号
福建苏宁电器有限公司闽侯博仕后店	老板：宋晓辉	地址：闽侯县上街国宾大道233号博仕后家园B区3-2#楼
闽侯县祥谦精工泡塑制品厂	厂长：林清	地址：闽侯县祥谦镇泮洋村沣祥野营用品有限公司内
福州邦杨工艺有限公司	总经理：温秀清	地址：闽侯县鸿尾乡桥头村坂头29号
福州商祺经贸有限公司闽侯上街分公司	总经理：冉鑫	地址：闽侯县上街镇新峰村梧洋村8号
闽侯县峰祥贸易有限公司	总经理：黄志良	地址：福州市闽侯县南通镇海峡副食品批发市场
闽侯县五新农业专业合作社	联系人：赖金梓	地址：闽侯县甘蔗818西路130号401室
福建省天龙山投资有限公司	总经理：何军华	地址：闽侯县甘蔗街道昙石山中大道118号新城丽景A区1#楼2层205店面
福建省天龙山贸易有限公司	总经理：郑卫明	地址：闽侯县甘蔗街道昙石山中大道118号新城丽景A区1#楼2层208店面
福州海味总厨贸易有限公司	总经理：林平	地址：闽侯县马腾村福州海峡冻品批发市场交易市场店面F-16、F-17、F-18
闽侯榕蓉电子信息工程有限公司	总经理：杨春兴	地址：闽侯县青口镇沪屿村山头下100号
闽侯县丰泽贸易有限公司	总经理：连永水	地址：闽侯县上街镇新峰村上街商贸中心1#11号店3层
闽侯县锦润贸易有限公司	总经理：罗小英	地址：闽侯县上街镇新峰村上街商贸中心1#11号店5层
闽侯县祥谦蚬草场	联系人：林秀峰	地址：闽侯县祥谦镇江中村
闽侯县祥谦柑桔场	联系人：郭新明	地址：闽侯县祥谦镇江中村
闽侯县祥谦农场	联系人：林成丰	地址：闽侯县祥谦镇江中村祥谦农场
闽侯县祥谦五灵岩果林场	联系人：林钦明	地址：闽侯县祥谦镇岐尾村五灵岩果林厂
闽侯县祥谦果林场	联系人：林钦明	地址：闽侯县祥谦镇三溪口新村
福建诚誉市政工程有限公司	总经理：林依?	地址：福建省闽侯县上街镇美岐村委办公大楼四层
闽侯县天安二手车交易服务有限公司	总经理：曾文芳	地址：福州市闽侯县尚干镇（福州市青口投资区内）福州市海峡汽车文化广场一期汽车超市一层D区109#
闽侯县中宝天虹二手车交易服务有限公司	总经理：陈武	地址：福州市闽侯县尚干镇（福州市青口投资区内）福州市海峡汽车文化广场一期汽车超市一层D区112#
闽侯县大脚山农业综合开发有限公司	总经理：林永清	地址：闽侯县荆溪镇关口村
福州鑫开元农业机械有限公司闽侯服务部	老板：罗邦国	地址：闽侯县南通镇海峡蔬菜批发市场南区10号楼5B店
闽侯县南湖蔬菜农民专业合作社	联系人：刘宝?	地址：闽侯县南通镇南通村
福州市三俊工贸有限公司	总经理：石安贵	地址：闽侯县南通镇洲头村
闽侯沃达丰贸易有限公司	总经理：程觅	地址：闽侯县青口镇农光村新城路博雅星城16#308单元
闽侯县普精模具工业有限公司	总经理：刘宪朗	地址：闽侯县青口镇祥青路39号
福州三辉建筑设备租赁有限公司	总经理：张端辉	地址：闽侯县上街镇金屿村金桥19号
福州奇丽雅工贸有限公司	总经理：徐太敏	地址：闽侯县上街镇新峰村上街商贸中心1#07店面
闽侯喜来登汽车租赁有限公司	总经理：林继治	地址：闽侯县尚干镇东升村B幢304号
闽侯县北方众博燃油系统维修有限公司	总经理：王成明	地址：闽侯县祥谦镇兰圃村公路边3号
福州市闽侯荣兴建筑材料有限公司	总经理：林文荣	地址：闽侯县祥谦镇岐尾村岐尾191号
福州福信昌橡塑有限公司	总经理：方雄生	地址：闽侯县祥谦镇祥青路6号（福建鑫盛玻璃有限公司5#车间第三层）
福建省闽侯县农资公司祥谦第二经营部	老板：林伟	地址：闽侯县祥谦镇洋下村
福州艺鑫达工贸有限公司	总经理：周而兵	地址：闽侯县竹岐乡榕东村榕东398号厂房
闽侯乾龙投资有限公司	总经理：吴	地址：福建省闽侯县大湖乡箬洋村小廷坪
闽侯三煌电子有限公司	总经理：何	地址：闽侯县青口镇宏四村
闽侯县方舟电子设备有限公司	总经理：王	地址：闽侯县上街镇闽都大庄园太阳座601＃
闽侯县金钢农机服务有限公司	总经理：余	地址：闽侯县甘蔗镇火车站旗下新村
福州市晟烽试剂贸易有限公司	总经理：蔡	地址：闽侯县上街镇闽都大庄园47#102
闽侯县佳炜科技农业综合农场	联系人：林	地址：闽侯县荆溪镇埔前村上宅
福建弘仁机电实业有限公司	总经理：吴	地址：闽侯县南屿镇高岐村福州石将工艺品有限公司2#研发楼第三层
福州佳净洗涤有限公司	总经理：刘	地址：闽侯县上街镇新峰村3#506
福州市闽侯县恒信文化传播有限公司	总经理：谢	地址：闽侯县上街镇英泰第一城A区商住楼18号
闽侯县豪顺汽车服务部	老板：王	地址：闽侯县白沙镇新城店面15#楼第一间
闽侯县枕峰冠闽林业有限公司	总经理：林	地址：闽侯县祥谦镇枕峰村
闽侯县协东电子厂	厂长：施	地址：闽侯县南屿镇南井村榕屿
闽侯县廷坪清枝食用菌基地	联系人：肖清枝	地址：闽侯县廷坪乡西山村法矿9号
福州嘉富包装有限公司	总经理：Gary John Guernier	地址：福州市闽侯县荆溪镇桐口村181号福州百事可乐饮料有限公司内
闽侯县红日工艺品有限公司	总经理：王斯华	地址：闽侯县荆溪镇关口村172号
闽侯县天籁果蔬专业合作社	联系人：叶大勇	地址：闽侯县竹岐乡榕东村榕东22号
闽侯县上街木莲饭庄岐安分店	老板：林木莲	地址：闽侯县上街镇岐安村商业中心A楼二层
闽侯县鑫源餐饮管理有限公司	总经理：程忠林	地址：闽侯县南屿镇南旗村
闽侯县沙建砂石有限公司	总经理：吴谋德	地址：闽侯县白沙镇白沙村
闽侯县丽健医药咨询有限公司	总经理：李丽芳	地址：闽侯县鸿尾乡超乾村121号
闽侯县康特医药咨询有限公司	总经理：高爱国	地址：闽侯县鸿尾乡超乾村石佛头街288号
闽侯县金源餐饮管理有限公司	总经理：程元鼎	地址：闽侯县南屿镇中溪村
福州涂立佳涂料有限公司	总经理：阮昌忠	地址：闽侯县荆溪镇永丰村
闽侯县佳顺汽车租赁有限公司	总经理：廖勇	地址：闽侯县甘蔗街道流洋16号
福建融旗沥青混凝土工程有限公司	总经理：陈学雄	地址：闽侯县荆溪镇桐口村
福州友乐电器有限公司	总经理：李善明	地址：闽侯县甘蔗镇入城路南侧5号楼第8间店面
福州兴源森投资有限公司	总经理：郑志辉	地址：福州市闽侯县甘蔗街道陈店湖工业区1#生产用房三层
闽侯县悦达磨具品厂	厂长：林夏贞	地址：闽侯县白沙镇白沙村埕元11号
福州裕丰五金制品有限公司	总经理：杨岳锋	地址：闽侯县青口镇青口投资区
闽侯县恒顺生态农业综合开发有限公司	总经理：严银花	地址：闽侯县大湖乡马?村
福州融祥商贸有限公司	总经理：唐一峰	地址：闽侯县南屿镇高岐工业区
福建六和贸易有限公司	总经理：林谢明	地址：福建省闽侯县南屿镇旗山万佛寺院内
福州嘉利德斯汽车贸易有限公司闽侯分公司	总经理：叶聪	地址：闽侯县上街镇国宾大道1#闽都大庄园沿街商住12#楼
闽侯县鸿伟工艺品有限公司	总经理：许巧燕	地址：闽侯县鸿尾乡溪元村36号
闽侯县洋中金银花种植专业合作社	联系人：陈依保	地址：闽侯县大湖乡上苑村洋中15号
福州豆之源豆业有限公司	总经理：张功成	地址：闽侯县荆溪镇永丰村88号
福州福晟金属有限公司	总经理：黄秀珍	地址：闽侯县祥谦镇洋下村
福州华鑫模具有限公司	总经理：黄孙俊	地址：闽侯县祥谦镇洋下村
闽侯县榕岸蔬菜专业合作社	联系人：林文金	地址：闽侯县竹岐乡榕东村（榕东村部）
福州桑穆斯建材有限公司	总经理：李建奇	地址：福州市闽侯县青口镇青秀村旦元下
闽侯县裕峰果林开发有限公司	总经理：陈	地址：闽侯县甘蔗街道环城路159号
闽侯县玉兰工艺厂	厂长：何	地址：闽侯县荆溪镇古山洲村洲头福州景健工艺品有限公司内
闽侯县洋里文栏格蔬菜专业合作社	联系人：林	地址：闽侯县洋里乡茶苑村33号
闽侯县鑫源园林绿化有限公司	总经理：甘	地址：闽侯县青口镇溪东村
闽侯县新兴隆机械沙加工厂	厂长：张	地址：闽侯县上街镇厚美村三坝前
闽侯县欣宏工艺品有限公司	总经理：邓	地址：闽侯县上街镇岐安村
闽侯县上街乾园快捷酒店	老板：陈	地址：闽侯县上街镇联心村（创业楼）
闽侯县榕兴林木有限公司	总经理：余	地址：闽侯县白沙镇白沙新城闽兴大道10#304
闽侯县坤茂汽车配件有限公司	总经理：张	地址：闽侯县青口镇梅岭村
闽侯县金牛农业机械有限公司	总经理：谢	地址：闽侯县甘庶街道环城路157号
闽侯恒信混凝土有限公司	总经理：江列?	地址：福建省闽侯县南屿镇窗厦村
福建大森林林业有限责任公司	总经理：张诚	地址：福建省闽侯县南通镇洲头村
福建洛钢重型钢构有限公司闽侯分公司	总经理：孙贞刚	地址：福建省闽侯县荆溪镇永丰村亭下３２号
闽侯县田野旺农业种养示范场	联系人：张依明	地址：福建省闽侯县荆溪镇厚屿村小桥7号
闽侯县新合力包装材料有限公司	总经理：郑翠英	地址：福建省闽侯县鸿尾乡奎石村牛头山工业区
闽侯县元达贸易有限公司	总经理：李金美	地址：福建省闽侯县甘蔗镇三福小区６０１（闽侯县邮政局）
闽侯县乐悠游会务服务有限公司	总经理：余素容	地址：福建省闽侯县甘蔗镇甘洲路341号
闽侯县宏辉贸易有限公司	总经理：张学宏	地址：福建省闽侯县甘蔗镇818西路
闽侯县闽豪贸易有限公司	总经理：林强	地址：福建省闽侯县甘蔗镇８１８大道南侧东方花园３＃１０７－１０８
闽侯县甘蔗邑都鑫酒楼	联系人：陈为玲	地址：福建省闽侯县甘蔗街道迎宾路
福州阜康家居有限公司	总经理：王海龙	地址：福建省闽侯县甘蔗街道山前村克姆湖
闽侯县大湖恒顺畜牧场	联系人：严银花	地址：福建省闽侯县大湖乡马乾村32号
闽侯县白沙院埕村王建华养猪场	联系人：王建华	地址：福建省闽侯县白沙镇院埕村
闽侯县东顺废品回收有限公司	总经理：谢其美	地址：福建省闽侯县白沙镇上岐村
福建省闽侯老根工艺馆	联系人：叶玉辉经理	地址：福州市闽侯县上街镇中心小学后门28号
太仓市城厢镇海弟食品便利店	老板：吴玉珍	地址：福建省闽侯县青口镇
福州新安德鲁森食品有限公司师大二店	老板：黄健	地址：福建省闽侯县上街福建师范大学新校区一层１１２号店面
福州豪鲜食品有限公司	总经理：颜随贤	地址：福建省福州市闽侯县祥谦镇枕峰村道头尾２０号
闽侯县巧芳食品有限公司	总经理：崔吉花	地址：福建省福州市闽侯县白沙镇长坪园３号
福州正吉食品有限公司	总经理：陈光	地址：福建省福州市闽侯县上街镇红峰村
丰源塑胶鞋服有限公司	总经理：林原	地址：福建省闽侯县青口联丰福厦路36公里处
闽侯县南阳鞋服有限公司	总经理：陈秋	地址：福建省福州市闽侯县南通镇陈厝村
福建省闽侯县健辉金属制品有限公司	总经理：王振辉	地址：闽侯县祥谦镇虎山村王厝79号
福州鑫联众金属有限公司	总经理：陈舞	地址：闽侯县青口镇付竹工业小区
中国移动通信集团福建有限公司上街大学城中医营业厅	联系人：林松波	地址：闽侯县上街福建中医学院生活区综合楼一层店面
闽侯县宏帝通信服务有限公司	总经理：叶小兵	地址：福建省福州市闽侯县祥谦镇卜洲村
福建移动通信有限责任公司闽候分公司甘蔗街心营业厅	联系人：程圣蔼	地址：福建省福州市闽侯县甘蔗镇街心路１３６号
福建移动通信有限责任公司闽候分公司荆溪营业厅	联系人：程圣蔼	地址：福建省福州市闽侯县荆溪镇徐家村
福州锦龙运输有限公司	总经理：吴古海	地址：福建省福州市闽侯县祥谦镇枕峰工业区
闽侯县金鼎家居装饰用品有限公司	总经理：林中	地址：福建省闽侯县甘蔗镇陈店湖工业区
福州东久装饰材料有限公司	总经理：邱文益	地址：福建省福州市闽侯县荆溪镇
福州星月家居装饰用品有限公司	总经理：林山	地址：福建省福州市闽侯县荆溪镇
中国网络通信集团公司福州市闽侯营销中心	联系人：廖建强	地址：福建省福州市闽侯县甘蔗镇八一八西路１６５号
闽侯县供销社资产营运管理中心	联系人：潘仁亮	地址：福建省闽侯县甘蔗街道街心路88号
福州大洋物业管理有限公司	总经理：邱青艺	地址：福建省闽侯县上街镇大洋鹭洲会所
福州盛达鸿工程管理有限公司	总经理：林继和	地址：福建省福州市闽侯县上街镇浦口村
福建青口科技有限公司	总经理：林捷凌	地址：福建福州闽侯县祥谦镇洋下村
中国石油天然气股份有限公司福建福州闽侯盟顺加油站	站长：施典伟	地址：福建省福州市闽侯县荆溪镇荆溪村
福建和一生物科技有限公司	总经理：丁玉瑞	地址：闽侯县荆溪镇关西村
福州博智生物有限公司	总经理：陈灿理	地址：福建省福州市闽侯县大湖乡雪峰村
福建省闽侯县联旺工艺厂	厂长：张兴发	地址：闽侯县荆溪镇后屿村小桥38号
福建省闽侯县宝闽电子仪器联营厂	厂长：林善仁	地址：福建省闽侯县祥谦镇泮洋村
闽侯县永平手套辅料厂	厂长：曾章永	地址：福建省闽侯县南屿镇六十份村六十份
闽侯县江口利群纺织厂	厂长：宋孝进	地址：福建省闽侯县南屿镇流洲村浦口小队
闽侯县清大榕壹涂料厂	厂长：郑金发	地址：福建省闽侯县南屿镇高岐工业区
闽侯县星光纸箱厂	厂长：蒋孝勇	地址：福建省闽侯县荆溪镇７４２７工厂
闽侯县宇英工艺厂	厂长：陈宗雨	地址：福建省闽侯县鸿尾乡埕头村知青点
闽侯县闽佳工艺厂	厂长：陈杰	地址：福建省闽侯县鸿尾乡埕头村３１６国道旁
闽侯县大湖乡瑞恒食品加工厂	厂长：宋秋奇	地址：福建省闽侯县大湖乡湖新路7号
福建省闽侯生凤养殖厂	厂长：程文梁	地址：福建省闽侯县白沙镇汶溪村
闽侯县白沙兴龙工艺厂	厂长：陈新龙	地址：福建省闽侯县白沙镇马坑村部队库房
福州市闽侯县福辉食品厂	厂长：陈毅辉	地址：福建省闽侯县祥谦镇枕峰村
福州市闽侯县纯心窗帘加工厂	厂长：詹纯心	地址：福建省闽侯县荆溪镇徐家村(农机技术学校内)
闽侯县欧雅工艺厂	厂长：钟庆云	地址：福建省福州市闽侯县甘蔗甘洲路
闽侯县云林工艺厂	厂长：张周林	地址：福建省福州市闽侯县荆溪镇徐家村七四二七工厂
闽侯县鑫鸿水泥制品厂	厂长：王松伟	地址：福建省福州市闽侯县南屿镇双龙村
闽侯县江口立立纺织厂	厂长：宋立明	地址：福建省福州市闽侯县南屿镇江口村九石
福建省闽侯县宏福工艺厂	厂长：沈金朝	地址：福建省福州市闽侯县鸿尾乡超乾村
闽侯县喜香源食品厂	厂长：邱平	地址：福建省福州市闽侯县上街镇３１６国道旁（闽侯县上街线带厂内）
闽侯县华林涂料厂	厂长：林振光	地址：福建省福州市闽侯县尚干镇厚福村山边
闽侯县海佳食品加工厂	厂长：林永星	地址：福建省福州市闽侯县青口镇团结村新桥里
闽侯县福达包装厂	厂长：林永波	地址：福建省福州市闽侯县甘蔗镇五福村五福巷２０号
闽侯县创兴金属家具厂	厂长：林龙国	地址：福建省福州市闽侯县荆溪镇溪下村
闽侯县兴永胜工艺制品厂	厂长：林锦源	地址：福建省福州市闽侯县尚干镇乌门新村５８号
闽侯县诚家水泥砖厂	厂长：林家成	地址：福建省福州市闽侯县荆溪桐口村桐溪桥边
闽侯县兴乐园食品饮料厂	厂长：侯林炜	地址：福建省福州市闽侯县上街镇岐头村
闽侯县迅捷工艺包装厂	厂长：方建介	地址：福建省福州市闽侯县南通镇方庄村
福州盖山转印加工厂	厂长：陈生,林明	地址：福建省闽侯县福州仓山区盖山
闽侯县碧云纸箱厂	厂长：陈碧云	地址：福建省福州市闽侯县上街镇建平村董屿２７号
福建雷凯诺节能环保装备有限公司	总经理：戴美玲	地址：闽侯县铁岭工业集中区
闽侯县盈源环保工程有限公司	总经理：郑建平	地址：福建省闽侯县甘蔗镇街心路１４２号（电信大楼）
福州市闽侯兴福源环保有限公司	总经理：杨振兴	地址：福建省福州市闽侯县青口镇付竹村
闽侯县天驱贸易物流经营部	老板：王依生	地址：福建省福州市闽侯县白沙埕元３４号
闽侯县天驱贸易物流有限公司	总经理：王依生	地址：福建省福州市闽侯县白沙镇埕元顶３３号
黑龙江省华宇物流集团福州华宇货运有限公司青口营业部	老板：王国柱	地址：福建省福州市闽侯县青口镇付竹村文明路２５号
福建福中汽车配件有限公司 外贸部	老板：林东碧,卢慈兰	地址：福建省闽侯县祥谦镇兰圃工业区
闽侯县顺发汽车租赁有限公司	总经理：林成溪	地址：福建省闽侯县上街镇闽都大庄园７９＃
闽侯县安顺汽车租赁服务有限公司	总经理：林炳和	地址：福建省闽侯县南屿镇后山村中石化加油站边
家家乐汽车租聘有限公司	总经理：程群,程仁	地址：福建省闽侯县
福州闽运汽车驾驶培训有限公司闽侯分公司	总经理：聂达文	地址：闽侯县上街镇（新峰村）国滨大道一座202座
福建省格尔发汽车销售服务有限公司	总经理：缪朋铃	地址：福建省福州市闽侯县青口镇汽配城一号展厅
福建华威汽车运输集团有限公司闽侯客运分公司	总经理：毛建军	地址：福建省福州市闽侯县甘蔗镇三英村
闽侯县顺程汽车驾驶员培训有限公司	总经理：卢赛平	地址：福建省福州市闽侯县荆溪镇桐口村
闽侯县祥顺汽车运输有限公司	总经理：林龙标	地址：福建省福州市闽侯县尚干镇后村村南脚盛３１６国道南侧
闽侯县畅达汽车运输有限公司	总经理：李秀华	地址：福建省福州市闽侯县甘蔗镇双池村
福基汽车装饰材料（上海）有限公司福州办事处	联系人：范明建	地址：福建省福州市闽侯县青口镇新城陶庄小区陶精楼一层
闽侯县富欣制冷机电设备有限公司	总经理：余清锦	地址：福建省闽侯县青口镇千家山花园10幢302室
福州九嘉机电设备有限公司	总经理：陈文照	地址：福建省闽侯县竹岐乡竹岐村
闽侯县明辉机电有限公司	总经理：黄建辉	地址：福建省闽侯县荆溪镇厚屿村小桥42号(生产场所：桐口村福州同泰电子有限公司内)
福州永发机电工程技术有限公司	总经理：付卫空	地址：福建省福州市闽侯县青口镇吉山村Ａ－８幢
福建允丹传动机械有限公司	总经理：郑美芳	地址：闽侯县祥谦镇肖家道村
闽侯县洋里百鎏机械维修店	老板：陈百鎏	地址：福建省闽侯县洋里
福州市林立精密机械有限公司	总经理：方雄生	地址：福建省闽侯县青口镇付
闽侯县利成机械厂	厂长：林系明	地址：福建省福州市闽侯县青口镇莲峰村
闽侯县联翔木工机械厂	厂长：林文信	地址：福建省福州市闽侯县荆溪镇荆溪村
福州鑫诚辉机械模具有限公司	总经理：林善文	地址：福建省福州市闽侯县青口镇汽配城内１８号
闽侯县晶鑫机械配件有限公司	总经理：林亨锋	地址：福建省福州市闽侯县祥谦镇澜澄村
福建省闽侯县鑫诚豪机械配件有限公司	总经理：胡湛	地址：福建省福州市闽侯县青口镇青口汽配交易市场内８号楼
福州华链通用机械有限公司	总经理：包积奇	地址：福建省福州市闽侯县南屿镇中溪村
福建盈茂服装实业有限公司	总经理：谢玲	地址：闽侯县铁岭工业集中区
福建省闽侯县青顺衬里厂	null	地址：福建省福州市闽侯县青口镇杨厝村
福建省闽侯县青口镇泽成食杂店	null	地址：福建省福州市闽侯县青口镇前洋村
福建省闽侯县青口镇艳光修理店	null	地址：福建省福州市闽侯县青口镇青口街
福建省闽侯县奇珍工贸有限公司	null	地址：福建省福州市闽侯县尚干镇
福建省闽侯县漆器木画厂	null	地址：福建省福州市闽侯县甘蔗镇大元巷７５号
福建省闽侯县普通教育督导室	null	地址：福建省福州市闽侯县交通路６０号
福建省闽侯县平利沙石有限公司	总经理：卞得玉	地址：福建省福州市闽侯县甘蔗镇化龙村八一八西路９５号
福建省闽侯县农副产品开发公司	null	地址：福建省福州市闽侯县甘蔗镇街心路８８号
福建省闽侯县南屿龙泉漆器厂	null	地址：福建省福州市闽侯县南屿龙泉土牛３４号
福建省闽侯县南屿江口漂染二厂	null	地址：福建省福州市闽侯县南屿镇江口村
福建省闽侯县南屿江口木画厂	null	地址：福建省福州市闽侯县南屿镇江口村青洲３４号
福建省闽侯县南通镇农机管理站	null	地址：福建省福州市闽侯县南通镇帮道桥边
福建省闽侯县南通泽苗毛拂厂	null	地址：福建省福州市闽侯县南通镇泽苗村４４号
福建省闽侯县南港贸易有限公司	null	地址：福建省福州市闽侯县南屿镇江口村
福建省闽侯县闽珠贸易有限公司	null	地址：福建省福州市闽侯县荆溪镇厚屿村198号
福建省闽侯县闽江渔械厂	null	地址：福建省福州市闽侯县闽江乡峡南村
福建省闽侯县闽材有限公司	null	地址：福建省福州市闽侯县尚干福厦路21公里处
福建省闽侯县绿色蔬菜基地	null	地址：福建省福州市闽侯县荆溪镇关口村西山26号
福建省闽侯县隆达工贸有限公司	null	地址：福建省福州市闽侯县甘蔗镇甘洲路359号
福建省闽侯县联发物资商业贸易有限公司	总经理：林榕秋	地址：福建省福州市闽侯县甘蔗镇街心路１２号
福建省闽侯县利民农牧开发有限公司	null	地址：福建省福州市闽侯县白沙镇孔源村
福建省闽侯县晶辉灯饰公司	null	地址：福建省福州市闽侯县尚干镇尚南路
福建省闽侯县荆溪厚屿特艺厂G	null	地址：福建省福州市闽侯县荆溪镇厚屿村187号
福建省闽侯县金洋机械制造有限公司	null	地址：福建省福州市闽侯县荆溪镇关口村364号
福建省闽侯县金田竹木工艺开发公司	null	地址：福建省福州市闽侯县洋里乡金田村
福建省闽侯县吉源建材有限公司	null	地址：福建省福州市闽侯县甘蔗镇蔗洲192号
福建省闽侯县华辉工艺制品	null	地址：福建省福州市闽侯县荆溪镇港头村121号
福建省闽侯县湖子坑综合养殖场	null	地址：福建省福州市闽侯县白沙镇孔源村
福建省闽侯县厚美土特产加工厂	null	地址：福建省福州市闽侯县上街镇厚美村
福建省闽侯县鸿宇通信发展有限公司	null	地址：福建省福州市闽侯县甘蔗镇街心路142号
福建省闽侯县鸿尾石狮竹编厂	null	地址：福建省福州市闽侯县鸿尾乡桥头村
福建省闽侯县鸿尾南园草竹厂	null	地址：福建省福州市闽侯县鸿尾乡桥头街１２号
福建省闽侯县鸿尾联新竹编厂	null	地址：福建省福州市闽侯县鸿尾乡石佛头街４６号
福建省闽侯县鸿尾奎石富华竹编厂	null	地址：福建省福州市闽侯县鸿尾乡奎石村
福建省闽侯县鸿尾建芳竹草制品厂	null	地址：福建省福州市闽侯县鸿尾乡石佛头街
福建省闽侯县鸿尾华福竹编厂G	null	地址：福建省福州市闽侯县鸿尾乡石佛头街
福建省闽侯县鸿尾华福竹编厂	null	地址：福建省福州市闽侯县鸿尾乡石佛头街
福建省闽侯县宏业汽车机电贸易有限公司	null	地址：福建省福州市闽侯县尚干镇重阳楼503号
福建省闽侯县宏辉特艺有限公司	null	地址：福建省福州市闽侯县甘蔗镇甘洲路１５号
福建省闽侯县恒通物资贸易公司	null	地址：福建省福州市闽侯县荆溪镇荆溪村
福建省闽侯县和盛化轻贸易有限公司	null	地址：福建省福州市闽侯县上街镇联宾大楼1223号
福建省闽侯县国防动员委员会	联系人：胡光永	地址：福建省福州市闽侯县甘蔗镇交通路５号
福建省闽侯县甘蔗机械厂	null	地址：福建省福州市闽侯县甘蔗镇校园路６３号
福建省闽侯县福兴贸易有限公司	总经理：刘景平	地址：福建省福州市闽侯县荆溪镇永丰村浦口
福建省闽侯县福瓷电器厂	null	地址：福建省福州市闽侯县鸿尾乡石佛头街313号
福建省闽侯县丰隆木画厂	null	地址：福建省福州市闽侯县甘蔗镇大元村侨园街75号
福建省闽侯县大湖竹木家俱特艺厂	null	地址：福建省福州市闽侯县大湖竹木家俱特艺厂
福建省闽侯县承锦白果厂	null	地址：福建省福州市闽侯县荆溪镇埔前村７８号
福建省闽侯县车辆购置附加费征收管理办公室	null	地址：福建省福州市闽侯县甘蔗镇交通路２号
福建省闽侯县奔斯达工贸有限公司	null	地址：福建省福州市闽侯县甘蔗镇校园路２３号
福建省闽侯县白沙运输公司	null	地址：福建省福州市闽侯县白沙镇火车路
福建省闽侯县白沙贸易经营部	null	地址：福建省福州市闽侯县白沙镇安平路71号
福建省闽侯县白沙立体养殖场	联系人：江列清	地址：福建省福州市闽侯县白沙镇大目埕源口
福建省闽侯天福商贸有限公司	null	地址：福建省福州市闽侯县洋里乡仙洋村
福建省闽侯盛鸿贸易有限公司	null	地址：福建省福州市闽侯县鸿尾乡政府内
福建省闽侯尚格竹草编织厂	null	地址：福建省福州市闽侯县洋里乡尚格村
福建省闽侯三井农业综合开发有限公司	null	地址：福建省福州市闽侯县甘蔗镇街心路28号
福建省闽侯榕中建福新型建材厂	null	地址：福建省福州市闽侯县竹岐乡榕中村
福建省闽侯群峰工贸有限公司	null	地址：福建省福州市闽侯县南屿镇江口村129号
福建省闽侯农工商贸易总公司大森地板木厂	null	地址：福建省福州市闽侯县荆溪镇白头村
福建省闽侯闽升石油制品服务站	站长：张捍平	地址：福建省福州市闽侯县竹岐乡春风村３１６国道２０公里处
福建省闽侯绿达花木有限公司	null	地址：福建省福州市闽侯县上街镇沙堤村中洲１１０号
福建省闽侯龙福活性炭有限公司	null	地址：福建省福州市闽侯县白沙镇后溪村
福建省闽侯康发养殖有限公司	null	地址：福建省福州市闽侯县荆溪镇关中村
福建省闽侯荆溪经济开发公司	null	地址：福建省福州市闽侯县荆溪镇荆溪村徐家村２３６号
福建省汽车运输总公司枕峰车队	null	地址：福建省福州市闽侯县祥谦镇枕峰村
福建省汽车运输总公司峡南运输站	null	地址：福建省福州市闽侯县闽江乡峡南村
福建省汽车运输总公司福州公司枕峰车队	null	地址：福建省福州市闽侯县祥谦乡枕峰村
福建省闽侯金龙经济技术开发公司	null	地址：福建省福州市闽侯县甘蔗镇校园路13号
福建省闽侯金辉工贸有限公司	总经理：林能杰	地址：福建省福州市闽侯县祥谦镇兰圃村
福建省闽侯鸿宇花圃有限公司	null	地址：福建省福州市闽侯县荆溪镇光明村
福建省闽侯鸿信发展有限公司	总经理：马昌武	地址：福建省福州市闽侯县甘蔗镇街心路１４２号
福建省闽侯鸿通发展有限公司	总经理：徐学穆	地址：福建省福州市闽侯县甘蔗镇街心路１４２号
福建省闽侯宏屿企业集团隆强养殖有限公司	总经理：吴秋强	地址：福建省福州市闽侯县青口镇宏屿经济管理区
福建省闽侯宏兴工贸有限公司	总经理：杨大兴	地址：福建省福州市闽侯县小箬乡福田村２２号
福建省闽侯福其工贸有限公司	null	地址：福建省福州市闽侯县青口镇梅岭村梅新路65号
福建省闽侯东方汽车物资贸易部	老板：李友春	地址：福建省福州市闽侯县甘蔗镇街心路60号
福建省闽侯地毯厂	null	地址：福建省福州市闽侯县甘蔗镇八一八西路
福建省闽侯大穆旅游实业发展有限公司	总经理：薛美连	地址：福建省福州市闽侯县白沙镇梧桐村１号
福建省闽侯诚顺建材贸易有限公司	总经理：黄燕娟	地址：福建省福州市闽侯县祥谦镇枕峰村黄土山洲开发区
福建省闽侯彩艳水泥漆厂	null	地址：福建省福州市闽侯县祥谦镇卜洲洋里村
福建省鸿宇农业综合开发有限公司	总经理：李克义	地址：福建省福州市闽侯县南屿镇尧沙村尧沙洲
福建省方星电气有限公司成套电器分公司	null	地址：福建省福州市闽侯县祥谦镇工业区
福建省方星电气有限公司	成立日期：1996/4/18	地址：中国 福建 福州市 福州市闽侯县祥谦工业区
福建省东方陶艺有限公司闽侯分公司	null	地址：福建省福州市闽侯县南通镇古城村云亭
福建联华皮革工业有限公司	总经理：陈裔林	地址：福建省福州市闽侯县祥谦镇枕峰村　　　　法　人：陈裔林
福建华信建陶有限公司	总经理：张林森	地址：福建省福州市闽侯县祥谦镇枕峰村
福建衡盛淀粉有限公司	总经理：郑勋	地址：福建省福州市闽侯县闽江乡峡南村
福建省国防科技工业供销公司闽侯摩托车配件部	null	地址：福建省福州市闽侯县甘蔗镇818大道2号
福建省公路稽征闽候稽征所	null	地址：福建省福州市闽侯县洪山乡杨桥西咱211号
福建多友山城旅游开发有限公司	总经理：李贻兵	地址：福建省福州市闽侯县十八重溪第三重溪
福建锻冲件厂闽侯经销部	null	地址：福建省福州市闽侯县甘蔗镇入城路
福建东方实业有限公司闽侯种养殖基地	null	地址：福建省福州市闽侯县南屿镇五都村
福鸿水禽畜立体养殖科技开发有限公司	总经理：张章林	地址：福建省福州市闽侯县鸿尾乡奎石村８号
福建闽侯县南通建材有限公司	null	地址：福建省福州市闽侯县南通镇洲头村
福建富艺耐火建材有限公司	null	地址：福建省福州市闽侯县洋里乡
福建省盛达电泵开发有限责任公司	null	地址：福建省福州市闽侯县荆溪联濂３１２
福建省农资集团闽侯县公司闽江经营部	null	地址：福建省福州市闽侯县闽江乡峡南村后湾２６号
福建省农资集团闽侯县公司鸿尾分公司	null	地址：福建省福州市闽侯县鸿尾乡石佛头街１０５号
福州舒翔机床配件制造有限公司	成立日期：1997/12/25	地址：中国 福建 福州市 福州闽侯县甘蔗街道陈店湖工业区
闽侯县甘蔗衡器门市部	null	地址：福建省福州市闽侯县甘蔗镇校园路６８号
闽侯县甘蔗恒盛铝业装璜店	老板：程文平	地址：福建省福州市闽侯县甘蔗镇入城路
闽侯县甘蔗荷花食杂店G	null	地址：福建省福州市闽侯县甘蔗镇街心路
闽侯县甘蔗好运来食品加工场G	null	地址：福建省福州市闽侯县甘蔗镇五福村下井巷62号
闽侯县甘蔗豪华音响店	null	地址：福建省福州市闽侯县甘蔗镇街心路41号
闽侯县甘蔗桂珍农机配件店G	null	地址：福建省福州市闽侯县甘蔗镇校园路44号
闽侯县甘蔗工艺美术店G	null	地址：福建省福州市闽侯县甘蔗镇街心路22号
闽侯县甘蔗根财水暧器材店G	null	地址：福建省福州市闽侯县甘蔗镇甘洲路51号
闽侯县甘蔗福英食杂店G	null	地址：福建省福州市闽侯县甘蔗镇双池老人会楼下
闽侯县甘蔗董成摩托车配件店G	null	地址：福建省福州市闽侯县甘蔗镇街心路74号
闽侯县甘蔗鼎煌食杂店G	null	地址：福建省福州市闽侯县甘蔗镇街心路123号
闽侯县甘蔗道熙灶具店G	null	地址：福建省福州市闽侯县甘蔗镇入城路
闽侯县甘蔗道发木箱厂	null	地址：福建省福州市闽侯县甘蔗镇横屿３１５号
闽侯县甘蔗大地礼仪庆典服务社	联系人：林其光	地址：福建省福州市闽侯县甘蔗镇侨园街２号
闽侯县甘蔗城峰陶酱店G	null	地址：福建省福州市闽侯县甘蔗镇甘洲路119号
闽侯县甘蔗诚心海鲜楼	联系人：林桂英	地址：福建省福州市闽侯县甘蔗镇街心路１５５号
闽侯县甘蔗昌盛蔬菜加工场	null	地址：福建省福州市闽侯县甘蔗镇三英村
闽侯县甘蔗碧霞食杂店G	null	地址：福建省福州市闽侯县甘蔗镇街心路206号
闽侯县甘蔗必瑞铝合金加工店G	null	地址：福建省福州市闽侯县甘蔗甘洲路48号
闽侯县甘蔗宝英化装品店G	null	地址：福建省福州市闽侯县甘蔗镇街心路44号
闽侯县甘蔗巴斯望商行	null	地址：福建省福州市闽侯县甘蔗镇街心路41号
闽侯县甘蔗爱娇小百货G	null	地址：福建省福州市闽侯县甘蔗镇街心路73号
闽侯县甘洪路郊区段扩建工作领导小组	联系人：张心浩	地址：福建省福州市闽侯县交通路２号
闽侯县妇女儿童服务公司	null	地址：福建省福州市闽侯县甘蔗镇交通路２号
闽侯县福厦漳公路交通整治领导小组办公室	null	地址：福建省福州市闽侯县闽江乡峡南村
闽侯县福闽食品贸易有限公司	null	地址：福建省福州市闽侯县青口镇青秀村新道头1号
闽侯县泛亚脱胎漆器厂	null	地址：福建省福州市闽侯县荆溪镇永丰村浦里8号
闽侯县发展新型建筑材料领导小组办公室	null	地址：福建省福州市闽侯县甘蔗镇交通路6号
闽侯县杜乌储运处综合服务部	老板：陈兴雄	地址：福建省福州市闽侯县荆溪镇永丰村
闽侯县东升竹编厂G	null	地址：福建省福州市闽侯县甘蔗山前村
闽侯县第四次人口普查领导小组办公室	null	地址：福建省福州市闽侯县甘蔗镇交通路２号
闽侯县大目溪水电利用开发有限公司	总经理：林启金	地址：福建省福州市闽侯县白沙镇联坑７５号
闽侯县大湖月兰糕饼加工场	联系人：陈月兰	地址：福建省福州市闽侯县大湖乡大湖街
闽侯县大湖雪英食杂店G	null	地址：福建省福州市闽侯县大湖乡大坪街
闽侯县大湖乡中草药试验种植基地	联系人：宋秋奇	地址：福建省福州市闽侯县大湖乡洋山村
闽侯县大湖乡洋山村公路指挥部	null	地址：福建省福州市闽侯县大湖乡洋山村
闽侯县大湖乡乡镇企业办公室	联系人：宋其枢	地址：福建省福州市闽侯县大湖乡政府内
闽侯县大湖乡双溪综合茶果场	联系人：林夫瑞	地址：福建省福州市闽侯县大湖乡双溪村
闽侯县大湖乡蔬菜生产试验场	联系人：岳灿华	地址：福建省福州市闽侯县大湖乡兰田村
闽侯县大湖乡墙坪村桥下村小组	null	地址：福建省福州市闽侯县大湖乡墙坪桥下村
闽侯县大湖乡六锦公路建设指挥部	null	地址：福建省福州市闽侯县大湖乡六锦村
闽侯县大湖乡流动人口协调小组办公室	null	地址：福建省福州市闽侯县大湖乡政府内
闽侯县大湖乡劳动就业服务站	null	地址：福建省福州市闽侯县大湖乡人民政府91号
闽侯县大湖乡兰田岭蔬菜基地	null	地址：福建省福州市闽侯县大湖乡兰田村过岭
闽侯县大湖乡后井蔬菜开发公司	总经理：吴仁龙	地址：福建省福州市闽侯县大湖乡后井村
闽侯县大湖乡大湖村大湖村民小组	联系人：杨则栋	地址：福建省福州市闽侯县大湖乡大湖村
闽侯县大湖乡大池村老区茶果场	null	地址：福建省福州市闽侯县大湖乡大池村
闽侯县大湖乡菜峰农业综合开发场	联系人：许守新	地址：福建省福州市闽侯县大湖乡坂头村
闽侯县大湖乡宝溪护林联防站	null	地址：福建省福州市闽侯县大湖乡林业站内
闽侯县大湖天岗坪农牧业综合开发公司	null	地址：福建省福州市闽侯县大湖乡雪峰村
闽侯县大湖天宝兴菜果场	null	地址：福建省福州市闽侯县大湖乡雪峰福古线81公里处
闽侯县大湖山锥粟场	联系人：黄碧珠	地址：福建省福州市闽侯县大湖乡新塘村
闽侯县大湖赛华食杂店	老板：马赛华	地址：福建省福州市闽侯县大湖乡大坪街
闽侯县大湖漠扬食杂店	老板：谟扬	地址：福建省福州市闽侯县大湖乡大坪街
闽侯县大湖民政办	联系人：林施忠	地址：福建省福州市闽侯县大湖乡政府
闽侯县大湖粮食管理站	null	地址：福建省福州市闽侯县大湖乡大湖街４０号
闽侯县大湖湖联食杂店G	null	地址：福建省福州市闽侯县大湖乡大湖街97号
闽侯县大湖国税所	null	地址：福建省福州市闽侯县大湖乡
闽侯县大湖桂清食杂店G	null	地址：福建省福州市闽侯县大湖乡大湖街
闽侯县大湖高岭土开发公司	总经理：刘尊松	地址：福建省福州市闽侯县大湖乡大湖村
闽侯县筹建县医院工作小组	null	地址：福建省福州市闽侯县甘蔗镇卫生局
闽侯县城关雄寨日用杂品店G	null	地址：福建省福州市闽侯县甘蔗镇城关市场
闽侯县城关秋丽食杂店G	null	地址：福建省福州市闽侯县甘蔗镇城关市场
闽侯县城关建材厂化工涂料经营部	null	地址：福建省福州市闽侯县甘蔗镇街心路27号
闽侯县城关茶果厂	null	地址：福建省福州市闽侯县甘蔗镇环城路１０９号
闽侯县城关宝英蔬菜摊	联系人：程宝英	地址：福建省福州市闽侯县城关市场
闽侯县茶叶示范场	null	地址：福建省福州市闽侯县洋里乡金田村
闽侯县茶果食杂公司第三门市部	老板：金昌经	地址：福建省福州市闽侯县甘蔗镇街心路１８号
闽侯县茶果食杂公司第二门市部	老板：张世旦	地址：福建省福州市闽侯县甘蔗镇街心路１８号
闽侯县残疾人服务社	联系人：李伯芳	地址：福建省福州市闽侯县甘蔗镇交通路２号
闽侯县白沙作铭冷作修配店G	null	地址：福建省福州市闽侯县白沙镇火车路13-7号
闽侯县白沙综合养殖场	联系人：冯金弟	地址：福建省福州市闽侯县白沙镇白沙新街
闽侯县白沙竹草制品厂	null	地址：福建省福州市闽侯县白沙镇仙山边５６号
闽侯县白沙珠妹床上用品店G	null	地址：福建省福州市闽侯县白沙镇安平路137号
闽侯县白沙智秋食杂店G	null	地址：福建省福州市闽侯县白沙镇安平路118号
闽侯县白沙芝兰日杂店	null	地址：福建省福州市闽侯县白沙镇安平路８５号
闽侯县白沙镇香食杂店G	null	地址：福建省福州市闽侯县白沙镇埕元村
闽侯县白沙镇农村合作基金会	null	地址：福建省福州市闽侯县白沙镇安平路135号
闽侯县白沙镇流动人口协调小组办公室	null	地址：福建省福州市闽侯县白沙镇政府内
闽侯县白沙镇林柄村合作基金会	null	地址：福建省福州市闽侯县白沙镇林柄村委
闽侯县白沙镇联体运输经营	null	地址：福建省福州市闽侯县白沙镇白沙街刘厝程
闽侯县白沙镇孔元昌和食杂店G	null	地址：福建省福州市闽侯县白沙镇孔元村105号
闽侯县白沙镇道路运输站	null	地址：福建省福州市闽侯县白沙镇埕园村
闽侯县白沙镇大目埕村合作基金会	null	地址：福建省福州市闽侯县白沙镇大目埕村
闽侯县白沙镇白沙村黎明村民小组	null	地址：福建省福州市闽侯县白沙镇白沙村
闽侯县白沙玉琴酱店G	null	地址：福建省福州市闽侯县白沙火车站46号
闽侯县白沙永固日杂店G	null	地址：福建省福州市闽侯县白沙镇新街61号
闽侯县白沙瀛山古寺	联系人：释修定	地址：福建省福州市闽侯县白沙镇车船站
闽侯县白沙迎宾食杂店G	null	地址：福建省福州市闽侯县白沙镇孔元村165号
闽侯县白沙依美音响店	null	地址：福建省福州市闽侯县白沙镇工商楼
闽侯县白沙雪英小百店G	null	地址：福建省福州市闽侯县白沙镇白沙新街
闽侯县白沙秀英粮复制品店G	null	地址：福建省福州市闽侯县白沙镇新街
闽侯县白沙兴农农化服务部	老板：陈秋生	地址：福建省福州市闽侯县白沙镇白沙村埕元１６号
闽侯县白沙新生金银饰品加工店G	null	地址：福建省福州市闽侯县白沙镇安平路55号
闽侯县白沙溪头贤模食杂店G	null	地址：福建省福州市闽侯县白沙镇溪头村
闽侯县白沙文英修理店G	null	地址：福建省福州市闽侯县白沙镇火车路13－5号
闽侯县白沙文钦水产摊G	null	地址：福建省福州市闽侯县白沙安平路228号
闽侯县白沙文林食杂店G	null	地址：福建省福州市闽侯县白沙镇埕元村10号
闽侯县白沙文建食杂店G	null	地址：福建省福州市闽侯县白沙镇埕元村3号
闽侯县白沙天钟食杂店G	null	地址：福建省福州市闽侯县白沙镇大目溪口
闽侯县白沙汤院澡堂服务部	null	地址：福建省福州市闽侯县白沙镇汤院村
闽侯县白沙孙琴食杂店G	null	地址：福建省福州市闽侯县白沙镇安平路187号
闽侯县白沙淑芳小百店G	null	地址：福建省福州市闽侯县白沙镇安平路116号
闽侯县白沙世明五金修补店G	null	地址：福建省福州市闽侯县白沙镇新村
闽侯县白沙三和日杂店G	null	地址：福建省福州市闽侯县白沙镇新街15号
闽侯县白沙赛珠灶具店G	null	地址：福建省福州市闽侯县白沙镇埕元村
闽侯县白沙瑞香针织品店G	null	地址：福建省福州市闽侯县白沙镇安平路98号
闽侯县白沙瑞芳食杂店G	null	地址：福建省福州市闽侯县白沙镇白沙街136号
闽侯县白沙秋英塑料加工场	null	地址：福建省福州市闽侯县白沙镇下浦路
闽侯县白沙秋实种籽店G	null	地址：福建省福州市闽侯县白沙镇新街69号
闽侯县白沙秋桂食杂店G	null	地址：福建省福州市闽侯县白沙镇楼格村7号
闽侯县白沙庆成汽车配件店	null	地址：福建省福州市闽侯县白沙镇埕元村92号
闽侯县白沙巧敏日杂店G	null	地址：福建省福州市闽侯县白沙镇新街尾
闽侯县白沙其健食杂店G	null	地址：福建省福州市闽侯县白沙镇孔元村
闽侯县白沙齐元日杂店G	null	地址：福建省福州市闽侯县白沙镇白沙街
闽侯县白沙乃金锯木场	null	地址：福建省福州市闽侯县白沙镇木帆社闽建内
闽侯县白沙秒金金银饰品加工店G	null	地址：福建省福州市闽侯县白沙镇新街17号
闽侯县白沙美英灶具店	null	地址：福建省福州市闽侯县白沙镇火车站路197号
闽侯县白沙林星化工店G	null	地址：福建省福州市闽侯县白沙镇白沙新街
闽侯县白沙林弟食杂店G	null	地址：福建省福州市闽侯县白沙镇埕元村
闽侯县白沙列文小百店G	null	地址：福建省福州市闽侯县白沙镇安平路172号
闽侯县白沙梨荣食杂店G	null	地址：福建省福州市闽侯县白沙镇孔源村91号
闽侯县白沙兰金日杂店G	null	地址：福建省福州市闽侯县白沙镇安平路149号
闽侯县白沙兰花日杂店G	null	地址：福建省福州市闽侯县白沙镇安平路277号
闽侯县白沙锦云灶具店G	null	地址：福建省福州市闽侯县白沙镇埕元村6号
闽侯县白沙金云农机配件店G	null	地址：福建省福州市闽侯县白沙镇火车站
闽侯县白沙金香食杂店	老板：郑金香	地址：福建省福州市闽侯县白沙镇新街１３号
闽侯县白沙建筑物资综合经营部	null	地址：福建省福州市闽侯县白沙镇安平路46号
闽侯县白沙建盛石料场	联系人：林永辉	地址：闽侯县白沙镇梧桐下村
闽侯县白沙回春食杂店G	null	地址：福建省福州市闽侯县白沙镇新街48号
闽侯县白沙花金食杂店G	null	地址：福建省福州市闽侯县白沙镇埕元村7号
闽侯县白沙洪漳床上用品店G	null	地址：福建省福州市闽侯县白沙镇安平路139号
闽侯县白沙过山湖新城开发村	村长：张开发	地址：福建省福州市闽侯县白沙镇安平路
闽侯县白沙国增食杂店G	null	地址：福建省福州市闽侯县白沙镇火车路86号
闽侯县白沙福比装璜材料店	老板：潘福比	地址：福建省福州市闽侯县白沙镇白沙街
闽侯县白沙鼎雄时装缝纫店G	null	地址：福建省福州市闽侯县白沙镇新街26号
闽侯县白沙第二砂石场	null	地址：福建省福州市闽侯县白沙镇沙坝头溪口村
闽侯县白沙超英家用电器店G	null	地址：福建省福州市闽侯县白沙镇白沙街村委楼下
闽侯县白沙彩榕铝合金装璜场	联系人：章文彩	地址：福建省福州市闽侯县白沙镇大目溪村
闽侯县白沙伯建劳保用品店	老板：陈伯建	地址：福建省福州市闽侯县白沙镇埕元６８号
闽侯县白沙必强水产摊G	null	地址：福建省福州市闽侯县白沙镇白沙村刘厝里99号
闽侯县白沙宝霖农机修配店	null	地址：福建省福州市闽侯县白沙镇新街138号
闽侯县白沙白雪粉笔加工场	null	地址：福建省福州市闽侯县白沙镇埕元村
闽侯县白沙爱楠汽车配件店G	null	地址：福建省福州市闽侯县白沙镇安平路129号
闽侯尚干龙峰建材加工厂G	null	地址：福建省福州市闽侯县尚干镇后福村
闽侯上街凤山鸭毛加工厂	null	地址：福建省福州市闽侯县上街镇红峰村都巡
闽侯青口美珠食杂店	null	地址：福建省福州市闽侯县青口镇市场
闽侯鸿尾天鹤竹编厂	null	地址：福建省福州市闽侯县鸿尾乡奎石村８２号
闽侯福江山农产品有限公司（工商已吊销）	联系人：工35	地址：福建省福州市闽侯县南通村苏板自然村
闽侯倒南通陈铭灶具店	null	地址：福建省福州市闽侯县南通镇南通街
闽侯白沙瑞金食杂店G	null	地址：福建省福州市闽侯县白沙镇溪口村
闽侯白沙果蔬新产品试验场	联系人：李家斩	地址：福建省福州市闽侯县白沙镇楼格村
飞达电线（福建）有限公司	null	地址：福建省福州市闽侯县荆溪镇荆溪村
福州鑫信源家居工艺品有限公司	null	地址：中国 福建 福州市 福州市闽侯县详谦镇枕峰１幢３号楼
闽侯县金桥培训学校	校长：康泽宇	地址：福建省福州市闽侯县甘蔗街道校园路
闽侯县翔隆商贸有限责任公司	总经理：林颖	地址：福建省福州市闽侯县甘蔗镇八一八西路８６号
闽侯县甘蔗燕鑫化妆品经营部	老板：吴春燕	地址：福建省福州市闽侯县甘蔗镇８１８大道海京广场１号店
闽侯县苏晃工艺有限公司	总经理：陈由苏	地址：福建省福州市闽侯县荆溪镇桐口工业区
闽侯县顺兴新型墙材有限公司	总经理：吴贞灿	地址：福建省福州市闽侯县甘蔗街道南山村南岭
闽侯县闽飞工艺厂	厂长：叶孝舒	地址：福建省福州市闽侯县鸿尾乡牛头山工业区
闽侯县闽江南岸南屿防洪堤路建设有限公司	总经理：李春敏	地址：福建省福州市闽侯县上街镇侨联大楼二层
闽侯县金源种苗有限公司	总经理：张传安	地址：福建省福州市闽侯县甘蔗镇三英村蔗洲路１５号
闽侯县铭禹水产有限公司	总经理：林开禹	地址：福建省福州市闽侯县上街镇榕桥村
闽侯县长盛泡沫制品厂	厂长：斯琴	地址：福建省福州市闽侯县白沙镇汶溪村长坪园
闽侯县金钢农机服务部	老板：余朝钦	地址：福建省福州市闽侯县甘蔗镇火车站旗下新村
闽侯县大湖乡六锦老区农业综合开发有限公司	总经理：王德明	地址：福建省福州市闽侯县大湖乡六锦村
闽侯县福闽工艺品有限公司	总经理：江志萍	地址：福建省福州市闽侯县荆溪镇厚屿村
闽侯县钰翔钻探劳务队	队长：林春	地址：福建省福州市闽侯县甘蔗镇化龙村亭下街后弄３３号
闽侯县白沙草竹编工艺厂	厂长：郑文流	地址：福建省福州市闽侯县白沙镇白沙村
闽侯县鑫隆再生资源利用有限公司	总经理：张雪春	地址：福州市闽侯县青口工业区青顺大厦三楼
闽侯县铁岭发展有限公司	总经理：李春敏	地址：福建省福州市闽侯县荆溪镇政府
闽侯县竹岐乡榕东蘑菇标准化示范基地	联系人：林莲金	地址：福建省福州市闽侯县竹岐乡榕东村
闽侯县祥谦镇渔（避风）港建设领导小组	联系人：黄恒祥	地址：福建省福州市闽侯县祥谦镇政府大院内
闽侯县清秀沼气开发有限公司	总经理：林晓秋	地址：福建省福州市闽侯县青口镇青口街６９号
闽侯县吉诺商务服务有限公司	总经理：贾小平	地址：福建省福州市闽侯县上街镇金桥花园
闽侯县华泰金属制品有限公司	总经理：陈景峰	地址：福建省福州市闽侯县青口镇吉山新村
闽侯县博来工艺品有限公司	总经理：陈武来	地址：福建省福州市闽侯县甘蔗镇陈店湖工业区
闽侯县闽升工艺制品有限公司	总经理：黄武桂	地址：福建省福州市闽侯县白沙镇南山洋工业区
闽侯华辉橡塑制品有限公司	总经理：刘先生	地址：福建省福州市闽侯县祥谦镇中院工业区
闽侯县天华工艺品有限公司	总经理：黄天华	地址：福建省福州市闽侯县南屿镇新联村岭东６８号
闽侯县尚干祥禾木画厂	厂长：张进瑞	地址：福建省福州市闽侯县尚干镇后村兰脚盛
闽侯县仙峰果场	联系人：潘如淼	地址：福建省福州市闽侯县大湖乡仙山村
闽侯县国宾大道景观改造项目建设指挥部	老板：杨传金	地址：福建省福州市闽侯县甘蔗镇交通路２号
闽侯县旭日工艺有限公司	总经理：许宝清	地址：福建省福州市闽侯县甘蔗镇工业区
闽侯县白沙国荣砂石场	联系人：卞国荣	地址：福建省福州市闽侯县白沙火车路２２１号
闽侯县白沙微利电脑培训班	联系人：张华	地址：福建省福州市闽侯县白沙镇安平路１２６号
青口镇新型农村合作医疗管理委员会	联系人：程道龙	地址：福建省福州市闽侯县青口镇政府内
闽侯县南通连宝皮蛋加工场	成立日期：2007/6/1	地址：中国 福建 福州市 福州市闽侯县南通镇洲洋
闽侯县澳拓雅工艺家?有限公司	总经理：廖业菘	地址：福建省福州市闽侯县甘蔗陈店湖工业区
闽侯晶鑫工艺品有限公司	总经理：陈先生	地址：福建省福州市闽侯县沪屿村
闽侯县鑫晶消防电子设备经营部	老板：张名洪	地址：福建省福州市闽侯县白沙镇埕元１９２号
闽侯县荆溪永丰工艺瓶厂	厂长：林永量	地址：福建省福州市闽侯县荆溪镇永丰村
闽侯县圣宇工艺有限责任公司	总经理：潘圣进	地址：福建省福州市闽侯县南通镇南通村
闽侯县城乡建设管理监察大队南通中队	队长：潘锋	地址：福建省福州市闽侯县南通镇南通街１０８号
闽侯县天牛顶农业研发中心	联系人：王家升	地址：福建省福州市闽侯县甘蔗镇入城路
闽候县雅赏工艺品有限公司	总经理：林先生	地址：福建省福州市闽侯县闽侯县甘蔗工业开发区B座
闽候县宏艺工艺品有限公司	总经理：林先生	地址：福建省福州市闽侯县荆溪镇厚屿村62号
闽侯县闽鹰工艺厂	厂长：张章鹰	地址：福建省福州市闽侯县鸿尾乡超?村大湖边
闽侯县贞旺工艺厂	厂长：林丁旺	地址：福建省福州市闽侯县鸿尾乡牛头山工业区
闽侯县薇雅工艺厂	厂长：王良煌	地址：福建省福州市闽侯县小箬乡尚格村里湖７号
闽侯县甘蔗明航家具店	老板：张德辉	地址：福建省福州市闽侯县甘蔗镇城路１６１号
闽侯县甘蔗振明藤器家俱店	老板：程振玉	地址：福建省福州市闽侯县甘蔗镇甘洲路２７９号
闽侯县甘蔗汀兰家俱店	null	地址：福建省福州市闽侯县甘蔗镇劳动大楼楼下
闽侯县南通华兴装饰家俱店G	null	地址：福建省福州市闽侯县南通陈厝村
闽侯县甘蔗木平家俱店G	null	地址：福建省福州市闽侯县甘蔗镇甘洲路343号
闽侯县上街孝星水暖店G	null	地址：福建省福州市闽侯县上街红峰村
闽侯县洋里世昌商店	null	地址：福建省福州市闽侯县洋里乡绅带村
闽侯县白沙月榕日用百货店G	null	地址：福建省福州市闽侯县白沙镇安平路125号
闽侯县青口美芳五金交电商店	老板：林美芳	地址：福建省福州市闽侯县青口镇市场
闽侯县洋里智灼商店	null	地址：福建省福州市闽侯县洋里乡安仁村
闽侯县荆溪古山洲昌浩商店G	null	地址：福建省福州市闽侯县荆溪古山洲村137号
闽侯县甘蔗月钗装璜商店	null	地址：福建省福州市闽侯县甘蔗镇街心路119号
闽侯县白沙文登建筑五金日用商店G	null	地址：福建省福州市闽侯县白沙镇埕园村94号
福建省闽侯县洋里绅带村陈晃商店	null	地址：福建省福州市闽侯县洋里乡绅带村
闽侯青口秋英水暖店	null	地址：福建省福州市闽侯县青口镇青口街
闽侯县白沙仁孝家具商店G	null	地址：福建省福州市闽侯县白沙镇桥头
甘蔗闽电电线商店	null	地址：福建省福州市闽侯县甘蔗镇818路南侧8号楼
闽侯县白沙闽兴石化商店G	null	地址：福建省福州市闽侯县白沙镇埕元村45号
闽侯县甘蔗宝银商店G	null	地址：福建省福州市闽侯县甘蔗镇街心路79号
闽侯县上街镇五交化商店	null	地址：福建省福州市闽侯县上街镇红峰村
闽侯县南通志让商店	null	地址：福建省福州市闽侯县南通街28号
闽侯县上街新峰王芳商店G	null	地址：福建省福州市闽侯县上街新峰村
闽侯县城关琳珊自选商店G	null	地址：福建省福州市闽侯县甘蔗镇街心路131号
闽侯县洋里欣端商店	null	地址：福建省福州市闽侯县洋里乡花桥村
闽侯县荆溪明雄商店	null	地址：福建省福州市闽侯县荆溪镇桐口村
闽侯县白沙美玉商店G	null	地址：福建省福州市闽侯县白沙镇新街12号
闽侯县城关供销社建材门市部	null	地址：福建省福州市闽侯县甘蔗镇十字村甘洲路２０６号
闽侯县荆溪夏迷文化用品店	null	地址：福建省福州市闽侯县荆溪镇徐家村
闽侯县白沙大众书店	null	地址：福建省福州市闽侯县白沙镇新街9号
闽侯县白沙萍萍文化用品店G	null	地址：福建省福州市闽侯县白沙镇白沙街工商所楼下
闽侯县城关华大钟表店G	null	地址：福建省福州市闽侯县甘蔗镇街心路31号
闽侯县白沙巧华化妆品店G	null	地址：福建省福州市闽侯县白沙镇新街54号
闽侯县南通飞涛钟表店	null	地址：福建省福州市闽侯县南通镇南通街
闽侯县白沙玉玲鞋帽店G	null	地址：福建省福州市闽侯县白沙镇安平56号
闽侯县甘蔗方青鞋帽店G	null	地址：福建省福州市闽侯县甘蔗镇街心路44号
闽侯县甘蔗永凝芳化妆品店	老板：李鹏	地址：福建省福州市闽侯县甘蔗镇街心路６９号
闽侯县白沙以建鞋店G	null	地址：福建省福州市闽侯县白沙镇新村45号
闽侯县南屿学区书店	null	地址：福建省福州市闽侯县南屿镇南屿街
闽侯县素珍灯具店	老板：洪素珍	地址：福建省福州市闽侯县甘蔗镇街心路９７号
闽侯县荆溪兴发建材经营部	null	地址：福建省福州市闽侯县荆溪镇永丰村杜乌
闽侯县南通宝月玻璃店	null	地址：福建省福州市闽侯县南通街
闽侯县房地产建材经营部	null	地址：福建省福州市闽侯县甘蔗镇８１８大道南侧
闽侯县南通恒发玻璃店	null	地址：福建省福州市闽侯县南通镇南通街尾
闽侯县南通苏洋建材店	null	地址：福建省福州市闽侯县南通镇东厝街
闽侯县南通新星五金灯具店	null	地址：福建省福州市闽侯县南通镇南通街
闽侯县白沙如渠鞋帽店G	null	地址：福建省福州市闽侯县白沙镇安平路152号
闽侯县上街供销社新峰日杂门市部	老板：林仕华	地址：福建省福州市闽侯县上街镇新峰村
闽侯县洋里供销社农具日杂门市部	老板：江本淦	地址：福建省福州市闽侯县洋里乡花桥村
闽侯县荆溪依娇图书文具店	null	地址：福建省福州市闽侯县荆溪镇徐家村
闽侯县南通真权文化用品店	null	地址：福建省福州市闽侯县南通街56号
闽侯县甘蔗永贤日用塑料制品店	null	地址：福建省福州市闽侯县甘蔗镇街心路28号
闽侯县甘蔗秀丽化妆品商店G	null	地址：福建省福州市闽侯县甘蔗镇街心路29号
闽侯县白沙暖人其他食品店G	null	地址：福建省福州市闽侯县白沙镇白沙新街13号
闽侯县大湖乡后井马岚山蔬菜场	联系人：刘用和	地址：福建省福州市闽侯县大湖乡后井村
闽侯县大湖乡反季节基业菜场	null	地址：福建省福州市闽侯县大湖乡反季节基业菜场
闽侯县大湖乡双溪村联合菜场	联系人：林夫赛	地址：福建省福州市闽侯县大湖乡双溪村
福建省闽侯县大湖乡珍山牛崖山菜场	null	地址：福建省福州市闽侯县大湖乡珍山牛崖山
闽侯县甘蔗卫东其他副食品商店G	null	地址：福建省福州市闽侯县甘蔗镇街心路121号
闽侯县仙山蔬菜场	null	地址：福建省福州市闽侯县大湖乡仙山村
福州市闽侯大湖乡东姚地坪后菜场	null	地址：福建省福州市闽侯县大湖乡东姚村
福州市闽侯县大湖官山老区菜场	null	地址：福建省福州市闽侯县大湖乡大湖村
福州闽侯大湖反季节蔬菜新兴菜场	null	地址：福建省福州市闽侯县大湖乡兰田村
闽侯县南屿玉田百货其食品商店	null	地址：福建省福州市闽侯县南屿镇南屿街新桥头
闽侯县甘蔗坤生其他副食品店G	null	地址：福建省福州市闽侯县甘蔗镇交通路23号
闽侯县祥谦镇辅翼蔬菜场	null	地址：福建省福州市闽侯县祥谦镇辅翼村
闽侯县甘蔗秀群五金店	老板：程秀群	地址：福建省福州市闽侯县街心路
闽侯县茶果公司贸易商店	老板：郑伯龙	地址：福建省福州市闽侯县甘蔗镇街心路１８号
闽侯县甘蔗镇粮站校园自选商店	null	地址：福建省福州市闽侯县甘蔗镇蔗洲路245号
闽侯县青口金来鞋店	老板：吴国富	地址：福建省福州市闽侯县青口镇青口街
闽侯县白沙秀玲鞋帽店G	null	地址：福建省福州市闽侯县白沙镇安平路212号
闽侯县甘蔗洪斌钟表店	null	地址：福建省福州市闽侯县甘蔗镇街心路75号
闽侯县闽江供销社百货商店	null	地址：福建省福州市闽侯县闽江乡峡南村
福州市闽侯七四二七综合商店	null	地址：福建省福州市闽侯县荆溪乡徐家村３０１号
闽侯县白沙幼玉其他副食品店G	null	地址：福建省福州市闽侯县白沙镇市场
闽侯县甘蔗粮站自选商店	null	地址：福建省福州市闽侯县甘蔗镇甘洲路２０２号
闽侯县竹岐友谊化妆品店G	null	地址：福建省福州市闽侯县竹岐乡竹岐村
闽侯县大湖供销社综合百货门市部	老板：姚心旗	地址：福建省福州市闽侯县大湖乡大湖街５４号
闽侯县南屿供销社百货门市部	老板：黄一华	地址：福建省福州市闽侯县南屿镇南屿街
闽侯县大湖供销社江洋商店棉百门市部	老板：姚心旗	地址：福建省福州市闽侯县大湖乡江洋村
闽侯县大湖供销社百货门市部	老板：姚心旗	地址：福建省福州市闽侯县大湖乡大湖街５４号
闽侯县副食品公司甘蔗第二商店	null	地址：福建省福州市闽侯县甘蔗镇交通路４号
闽侯县食品公司礼品商店	null	地址：福建省福州市闽侯县甘蔗镇街心路106号
闽侯县医药公司宏达医药商店	老板：周方	地址：福建省福州市闽侯县青口镇新城
闽侯县甘蔗幼弟油漆店	null	地址：福建省福州市闽侯县甘蔗镇甘洲路８号
闽侯县甘蔗道淞加油点G	null	地址：福建省福州市闽侯县甘蔗入城路
闽侯县双溪施生加油站	null	地址：福建省福州市闽侯县大湖乡双巨村
闽侯县甘蔗丽华玩具商店G	null	地址：福建省福州市闽侯县甘蔗镇甘洲路189号
闽侯县青口宏明加油点	null	地址：福建省福州市闽侯县青口镇宏屿村
闽侯县白沙华珍加油点G	null	地址：福建省福州市闽侯县白沙镇下浦路
闽侯县闽江福峡竹工艺品店	老板：张新尔	地址：福建省福州市闽侯县闽江乡峡南村
闽侯县上街艺华工艺品经销部	null	地址：福建省福州市闽侯县上街镇新峰村
闽侯县甘蔗苍榕工艺品商店	null	地址：福建省福州市闽侯县招待所１０５号
闽侯县盛德家电商场	null	地址：福建省福州市闽侯县甘蔗镇城关入城路
闽侯县甘蔗镇用星涂料店	null	地址：福建省福州市闽侯县甘蔗九五部队
闽侯县南屿美如加油站	站长：陈美如	地址：福建省福州市闽侯县南屿镇柳厝村
闽侯县永丰道淞加油站	null	地址：福建省福州市闽侯县荆溪镇永丰村
闽侯县白沙伯建加油站	null	地址：福建省福州市闽侯县白沙镇埕元村
闽侯县祥谦枕峰君晖加油站	站长：刘爱伍	地址：福建省福州市闽侯县祥谦镇枕峰村
闽侯县白沙仁光加油站	null	地址：福建省福州市闽侯县白沙镇联坑村灵峰
闽侯县竹岐崇波加油点G	null	地址：福建省福州市闽侯县竹岐乡竹岐街28号
闽侯县上街朝阳小学	null	地址：福建省福州市闽侯县上街镇中美村
闽侯县鸿尾南坑小学	null	地址：福建省福州市闽侯县鸿尾乡南坑村
闽侯县鸿尾南下小学	null	地址：福建省福州市闽侯县鸿尾乡南下村
闽侯县南屿柳浪小学	校长：刘勤官	地址：福建省福州市闽侯县南屿镇柳浪村
闽侯县南屿双龙小学	null	地址：福建省福州市闽侯县南屿镇龙泉村
闽候县白沙唐举小学	null	地址：福建省福州市闽侯县白沙镇唐举村
闽候县青口霞墓小学	null	地址：福建省福州市闽侯县青口镇布岭村霞墓
闽候县小箬中平小学	校长：卓正乐	地址：福建省福州市闽侯县小箬乡中平村
闽候县廷坪池坑小学	null	地址：福建省福州市闽侯县廷坪乡池坑村
闽候县洋里田　小学	null	地址：福建省福州市闽侯县洋里乡田　村
闽侯县西台中心小学	null	地址：福建省福州市闽侯县青口镇西台村
闽侯县闽江中心小学	null	地址：福建省福州市闽侯县闽江乡峡南村
闽侯县南屿后山小学	null	地址：福建省福州市闽侯县南屿镇后山村
闽侯县洋里乡花桥村委会新宅联队	队长：江梅青	地址：福建省福州市闽侯县洋里乡花桥村
闽侯县祥谦镇?前村民委员会	null	地址：福建省福州市闽侯县祥谦镇?前村
闽侯县大湖乡兰田村民委员会	联系人：胡春棋	地址：福建省福州市闽侯县大湖乡兰田村
闽侯县洋里乡花桥村委会堡里联队	队长：江学作	地址：福建省福州市闽侯县洋里乡花桥村堡里
闽侯县甘蔗镇三英村民委员会	null	地址：福建省福州市闽侯县甘蔗镇三英村
闽侯县荆溪镇桐口村民委员会	null	地址：福建省福州市闽侯县荆溪镇桐口村
闽侯县荆溪镇仁洲村民委员会	null	地址：福建省福州市闽侯县荆溪镇仁洲村
闽侯县南屿镇流洲村民委员会	null	地址：福建省福州市闽侯县南屿镇流洲村
闽侯县南屿镇南前村民委员会	null	地址：福建省福州市闽侯县南屿镇南前村
闽侯县南通镇马腾村民委员会	null	地址：福建省福州市闽侯县南通镇马腾村
闽侯县南屿镇新联村民委员会	联系人：陈怀	地址：福建省福州市闽侯县南屿镇新联村
闽侯县荆溪镇厚屿村民委员会	联系人：林光进	地址：福建省福州市闽侯县荆溪镇厚屿村
闽侯县南通泽洋村民委员会	联系人：周明桂	地址：福建省福州市闽侯县南通镇泽洋村
闽侯县洋里乡大仑村民委员会	null	地址：福建省福州市闽侯县洋里乡大仑村
闽侯县上街镇青洲村民委员会	联系人：杨标	地址：福建省福州市闽侯县上街镇青洲村
闽侯县大湖乡仙山村民委员会	null	地址：福建省福州市闽侯县大湖乡仙山村
闽侯县洋里乡洋里村民委员会	联系人：江美付	地址：福建省福州市闽侯县洋里乡洋里村
闽侯县洋里乡金田村民委员会	null	地址：福建省福州市闽侯县洋里乡金田村
闽侯县青口镇农光村民委员会	联系人：施忠弟	地址：福建省福州市闽侯县青口镇农光村
闽侯县大湖乡坂头村民委员会	null	地址：福建省福州市闽侯县大湖乡坂头村
闽侯县上街镇上街村民委员会经济开发领导小组	联系人：林升忠	地址：福建省福州市闽侯县上街镇上街村
闽侯县洋里乡刘洋村民委员会	null	地址：福建省福州市闽侯县洋里乡刘洋村
闽侯县大湖乡茶坪村民委员会	null	地址：福建省福州市闽侯县大湖乡茶坪村
闽侯县大湖乡碾坑村民委员会	联系人：梁治利	地址：福建省福州市闽侯县大湖乡碾坑村
闽侯县荆溪镇溪下村民委员会	联系人：胡辉平	地址：福建省福州市闽侯县荆溪镇溪下村
闽侯县南通镇廷宅村民委员会	联系人：张明	地址：福建省福州市闽侯县南通镇廷宅村
闽侯县鸿尾乡奎石村民委员会	联系人：黄恒銮	地址：福建省福州市闽侯县鸿尾乡奎石村
闽侯县甘蔗镇流洋村民委员会	null	地址：福建省福州市闽侯县甘蔗镇流洋村
闽侯县南屿镇中溪村民委员会	null	地址：福建省福州市闽侯县南屿镇中溪村
闽侯县祥谦镇官前村民委员会	联系人：郭新明	地址：福建省福州市闽侯县祥谦镇官前村
闽侯县甘蔗镇计划生育办公室	null	地址：福建省福州市闽侯县甘蔗镇校园路５３号
闽侯县大湖乡新塘村民委员会	null	地址：福建省福州市闽侯县大湖乡新塘村
闽侯县洋里乡新见村民委员会	null	地址：福建省福州市闽侯县洋里乡新见村民委员会
闽侯县竹岐乡春风村民委员会	null	地址：福建省福州市闽侯县竹岐乡春风村
闽侯县洋里乡张际村民委员会	null	地址：福建省福州市闽侯县洋里乡张际村
闽侯县大湖乡箬洋村民委员会	null	地址：福建省福州市闽侯县大湖乡箬洋村
闽侯县小箬乡湖柄村民委员会	null	地址：福建省福州市闽侯县小箬乡湖柄村
闽侯县南屿镇柳浪村民委员会	联系人：8	地址：福建省福州市闽侯县南屿镇柳浪村
闽侯县闽江前进村民委员会	联系人：朱祖铭	地址：福建省福州市闽侯县闽江乡前进村
闽侯县南屿镇窗厦村民委员会	null	地址：福建省福州市闽侯县南屿镇窗厦村
闽侯县荆溪镇光明村民委员会	null	地址：福建省福州市闽侯县荆溪镇光明村
闽侯县闽江乡兴星村民委员会	联系人：连木好	地址：福建省福州市闽侯县闽江乡新建村
闽侯县南屿镇龙泉村民委员会	null	地址：福建省福州市闽侯县南屿镇龙泉村
闽侯县南屿元峰村民委员会	null	地址：福建省福州市闽侯县南屿镇元峰村
闽侯县洋里乡安仁村民委员会	null	地址：福建省福州市闽侯县洋里乡安仁村
闽侯县大湖乡岭头村民委员会	null	地址：福建省福州市闽侯县大湖乡岭头村
闽侯县上街镇榕侨村民委员会	null	地址：福建省福州市闽侯县上街镇榕桥村
闽侯县大湖乡后洋村民委员会	null	地址：福建省福州市闽侯县大湖乡后洋村
闽侯县南通镇泽苗村民委员会	null	地址：福建省福州市闽侯县南通镇泽苗村泽道
闽侯县大湖乡大坪村民委员会	null	地址：福建省福州市闽侯县大湖乡大坪村
闽侯县南屿镇后山村民委员会	联系人：黄道棋	地址：福建省福州市闽侯县南屿镇后山村
闽侯县甘蔗镇长江村民委员会	null	地址：福建省福州市闽侯县甘蔗长江村长江巷85号
闽侯县洋里乡洋头村民委员会	null	地址：福建省福州市闽侯县洋里乡洋头村
闽侯县南屿镇尚旗村民委员会	null	地址：福建省福州市闽侯县南屿镇尚旗村
闽侯县大湖乡上苑村民委员会	联系人：严仁龙	地址：福建省福州市闽侯县大湖乡上苑村
闽侯县廷坪乡计划生育办公室	null	地址：福建省福州市闽侯县廷坪乡廷坪村
闽侯县佛教协会	联系人：释广霖	地址：福建省福州市闽侯县甘蔗镇八一八西路１３６号
闽侯县小箬乡中平村民委员会	null	地址：福建省福州市闽侯县小箬乡中平村
闽侯县鸿尾乡计生办公室	联系人：张文	地址：福建省福州市闽侯县鸿尾乡政府
闽侯县大湖乡大湖村民委员会	联系人：杨则栋	地址：福建省福州市闽侯县大湖乡大湖街
闽侯县青口镇青圃里村民委员会	null	地址：福建省福州市闽侯县青口镇青圃里村
闽侯县闽江乡和平村民委员会	null	地址：福建省福州市闽侯县闽江乡和平村
闽侯县大湖乡珍山村民委员会	null	地址：福建省福州市闽侯县大湖乡珍山村
闽侯县上街镇沙堤村民委员会经济开发领导小组	联系人：赵民光	地址：福建省福州市闽侯县上街镇沙堤村
闽侯县南通镇泽洋村委会文洋联队	队长：张冠强	地址：福建省福州市闽侯县南通镇泽洋村
闽侯县上街镇新峰村委会	null	地址：福建省福州市闽侯县上街镇新峰村委会
闽侯县南通镇泽洋村委会莲湖联队	队长：欧拱新	地址：福建省福州市闽侯县南通镇泽洋村
闽侯县大湖乡马乾村民委员会	null	地址：福建省福州市闽侯县大湖乡马乾村民委员会
闽侯县闽江乡新建村民委员会	联系人：张碧珍	地址：福建省福州市闽侯县闽江乡新建村
闽侯县洋里乡绅带村民委员会	null	地址：福建省福州市闽侯县洋里乡绅带村
闽侯县闽江乡峡南村民委员会	null	地址：福建省福州市闽侯县闽江乡峡南村
闽侯县甘蔗镇山前村民委员会	null	地址：福建省福州市闽侯县甘蔗镇山前村
闽侯县荆溪镇关中村民委员会	null	地址：福建省福州市闽侯县荆溪镇关中村
闽侯县尚干镇后厝村民委员会	联系人：林朝官	地址：福建省福州市闽侯县尚干镇后厝村
闽侯县洋里乡花桥村民委员会	联系人：江欣枢	地址：福建省福州市闽侯县洋里乡花桥村
闽侯县青口镇宏四村民委员会	null	地址：福建省福州市闽侯县青口镇宏四村
闽侯县南屿镇六十份村民委员会	null	地址：福建省福州市闽侯县南屿镇六十份村
闽侯县上街镇厚庭村民委员会	联系人：陈科荣	地址：福建省福州市闽侯县上街镇厚庭村
闽候县公安局青口派出所	null	地址：福建省福州市闽侯县青口镇
闽侯县公安局闽江派出所	所长：林佑秋	地址：福建省福州市闽侯县闽江乡峡南村后湾6号
闽侯县老年人体育协会	null	地址：福建省福州市闽侯县甘蔗八一八路
闽侯县公安局侯官水上派出所	null	地址：福建省福州市闽侯县上街镇侯官村
闽侯县公安消防大队	队长：黄兴发	地址：福建省福州市闽侯县甘蔗镇校园路１２８号
闽侯县道路交通安全协会	null	地址：福建省福州市闽侯县甘蔗镇长江村墩园洲68号
闽侯县公安局上街派出所	null	地址：福建省福州市闽侯县上街镇商业街
福建省监狱管理局罪犯收押中心工会委员会闽侯大队分会	联系人：陈谟恩	地址：福建省福州市闽侯县白沙镇孔原村
闽侯县公安局尚干派出所	所长：叶家飞	地址：福建省福州市闽侯县尚干镇祥谦路１１２号
闽侯县上街东兴副食品有限公司	null	地址：福建省福州市闽侯县上街镇沙堤村
福建省闽侯县大元减速机厂	null	地址：福建省福州市闽侯县甘蔗镇大元村侨园街３４号
闽侯县洋里小箬笔杆厂	厂长：陈由标	地址：福建省福州市闽侯县小箬乡小箬村
福建省闽侯县洋里小箬建荣笔艺厂Ｇ	null	地址：福建省福州市闽侯县洋里乡小箬村
福州龙霖电子有限公司（工商已吊销）	联系人：王龙霖	地址：福建省福州市闽侯县祥谦镇泮洋村　　　　法　人：王龙
闽侯县甘蔗镇十字粮食加工厂	厂长：陈正雄	地址：福建省福州市闽侯县甘蔗镇十字村服务楼
闽侯县南屿一品香食品厂	null	地址：福建省福州市闽侯县南屿六十份村2号
福州鼓风机厂工贸公司豆乳厂	null	地址：福建省福州市闽侯县荆溪镇永丰亭下32号
闽侯县竹岐旺联食品厂	厂长：叶仁朗	地址：福建省福州市闽侯县竹岐乡榕东村２０６号
福建省闽侯县青口梅溪塑料厂	null	地址：福建省福州市闽侯县青口镇梅溪村
闽侯县上街侯官塑料厂	厂长：陈友强	地址：福建省福州市闽侯县上街镇侯官村
闽侯县宏泉食品厂	厂长：洪彪	地址：福建省福州市闽侯县甘蔗镇山前万寿山５５号
闽侯县甘蔗双池粮食加工厂	厂长：林兰兰	地址：福建省福州市闽侯县甘蔗镇甘洲路５号
福建福州壮志绿色食品有限公司	总经理：程景春	地址：福建省福州市闽侯县甘蔗镇长江村　　　　法定代表人：程景春
福建省闽侯县减速机厂	null	地址：福建省福州市闽侯县甘蔗镇蔗洲路７６号
闽侯县华盛工艺皮件厂	厂长：林仁章	地址：福建省福州市闽侯县甘蔗镇侨园路１２号
闽侯县绿泉居食品厂	null	地址：福建省福州市闽侯县甘蔗镇32295部队
福建省闽侯东方塑料厂	null	地址：福建省福州市闽侯县白沙镇埕元村７０号
南昌衡器总厂闽侯分厂	null	地址：福建省福州市闽侯县甘蔗镇军民路7号
闽侯县上街邱阳三福人造板厂	null	地址：福建省福州市闽侯县上街镇红丰村
闽侯县朝升食品厂	厂长：洪朝生	地址：福建省福州市闽侯县甘蔗镇洽浦村１２７号
福建省闽侯县锦美水产食品有限公司	null	地址：福建省福州市闽侯县上街镇厚美村
闽侯金涛塑胶有限公司	总经理：林金香	地址：福建省福州市闽侯县南屿镇高岐村
福建省闽侯福闽保健食品厂	null	地址：福建省福州市闽侯县竹岐乡竹岐村
闽侯县无线电元件二厂	null	地址：福建省福州市闽侯县甘蔗镇街心路１２６号三层楼
闽侯县青口富兴塑料制品厂	null	地址：福建省福州市闽侯县青口镇表布中心街８９号
福建省闽侯天德饮料食品厂	null	地址：福建省福州市闽侯县尚干镇尚南路
福州鼓风机厂工贸公司	null	地址：福建省福州市闽侯县荆溪镇永丰亭下３２号
闽侯县祥谦凤港新兴塑料厂	null	地址：福建省福州市闽侯县祥谦镇凤港村
闽侯县上街镇涛伦橡塑厂	厂长：林涛	地址：福建省福州市闽侯县上街镇上街村新峰
福建省闽侯县挺盛制冷设备厂	null	地址：福建省福州市闽侯县荆溪镇古山洲村
闽侯县青口龙豪塑料制品厂	null	地址：福建省福州市闽侯县青口镇宏屿村
闽侯县清旺胶板厂	厂长：叶元清	地址：福建省福州市闽侯县荆溪镇港头村７４号
福建省闽侯县康达电子厂	null	地址：福建省福州市闽侯县鸿尾乡鸿尾村
闽侯县尚干陶江机械铸造厂	null	地址：福建省福州市闽侯县尚干镇山边
福州顶丰纸业有限公司	总经理：梁永坚	地址：福建省福州市闽侯县上街镇侯官村
福建省闽侯县雅洁卫生纸品厂	null	地址：福建省福州市闽侯县甘蔗镇墩园洲
闽侯县祥谦南红米酒厂	null	地址：福建省福州市闽侯县尚干镇红星村
福州东昌机械模具有限公司	总经理：傅重熙J	地址：福建省福州市闽侯县青口投资区　　　　　
福建省闽侯县曙光阀门厂	厂长：程建彬	地址：福建省福州市闽侯县甘蔗镇十字村委大楼
闽侯县由由纸箱厂	null	地址：福建省福州市闽侯县甘蔗镇坛石村３１２号
闽侯县祥谦诺乐饮料厂	厂长：林善耀	地址：福建省福州市闽侯县祥谦镇肖家道
闽侯县青耀卫生纸厂	null	地址：福建省福州市闽侯县青口镇宏二村
福建省闽侯县上街福联光学元件厂	null	地址：福建省福州市闽侯县上街镇联心村
闽侯县东晨光学仪器厂	厂长：黄东风	地址：闽侯县南屿镇江口村
福建省闽侯县天源纸品有限公司	null	地址：福建省福州市闽侯县上街镇马保村
闽侯县三和五金厂	null	地址：福建省福州市闽侯县荆溪镇永丰村32270部队
闽侯县尚干胜达工艺厂	厂长：林美娟	地址：福建省福州市闽侯县尚干镇后村４０号
福建省闽侯县白沙茶叶精制厂	null	地址：福建省福州市闽侯县白沙镇大濑村
闽侯县青口村里造纸厂	厂长：叶发登	地址：福建省福州市闽侯县青口镇村里村
闽侯县青口青龙饮料厂	null	地址：福建省福州市闽侯县青口镇幸福村环南路64号
福建省闽侯闽京兴茶业有限公司	总经理：林兆星	地址：福建省福州市闽侯县尚干镇尚南路３９号
福建省闽侯造纸厂	null	地址：福建省福州市闽侯县南屿镇高岐村11号
福建省闽侯橡胶制品有限公司销售处	null	地址：福建省福州市闽侯县白沙镇火车路116号
福建省闽侯县洋里文化用品厂	null	地址：福建省福州市闽侯县洋里乡小箬村
福州鼓风机厂职工技术协作服务部	null	地址：福建省福州市闽侯县荆溪镇永丰村３２号
福建省闽侯县祥泰纸业有限公司	null	地址：福建省福州市闽侯县详谦镇江中村
福建省闽侯酱厂白沙门市部	null	地址：福建省福州市闽侯县白沙镇安平路136号
闽侯县白沙金珠粮食加工店G	null	地址：福建省福州市闽侯县白沙镇火车路农资仓库
福州百联食品有限公司第三食品厂	厂长：章建忠	地址：福建省福州市闽侯县第二中学内
福建省闽侯县维康食品厂	厂长：福利	地址：福建省福州市闽侯县荆溪镇永丰村浦里２４号
福州南怡塑料制品有限公司	null	地址：福建省福州市闽侯县南屿镇
福建省闽侯县福隆酿酒厂	厂长：林功柳	地址：福建省福州市闽侯县青口镇幸福村环东路
闽侯县大湖制酒厂	null	地址：福建省福州市闽侯县大湖乡大坪村
闽侯县南屿旗山酒厂	厂长：叶忠官	地址：福建省福州市闽侯县南屿镇甲岐村
福建省闽侯县祥谦造纸厂	null	地址：福建省福州市闽侯县祥谦镇澜澄村
闽侯县橡胶制品有限公司工会委员会	联系人：林建华	地址：福建省福州市闽侯县白沙镇下埔路５５号
闽侯县宏屿纸板厂	null	地址：福建省福州市闽侯县青口镇宏屿村
闽侯县工艺美术玩具厂	null	地址：福建省福州市闽侯县上街镇联心村
闽侯县荆溪南方家具厂	null	地址：福建省福州市闽侯县荆溪镇流洋村16号
闽侯县南通曹浦美术工艺厂	null	地址：福建省福州市闽侯县南通镇银安村
闽侯县南通镇泽苗制刷厂	null	地址：福建省福州市闽侯县南通镇泽苗邦道东20号
福建省闽侯县白沙龙港空心砖厂	null	地址：福建省福州市闽侯县白沙镇马坑村
闽侯县上街中美空心砖厂	null	地址：福建省福州市闽侯县上街镇中美村
闽侯县祥谦岐尾第一机砖厂	null	地址：福建省福州市闽侯县祥谦镇岐尾村
福建省闽侯县廷坪工艺厂	null	地址：福建省福州市闽侯县甘蔗镇甘洲路１５号
闽侯县跃进胶水厂	null	地址：福建省福州市闽侯县青口镇前洋村39号
闽侯县城关芹江工艺厂	厂长：方振云	地址：福建省福州市闽侯县甘蔗镇大源巷５号
闽侯县南屿闽辉家俱厂	厂长：唐辉	地址：福建省福州市闽侯县南屿镇尧沙村
闽侯县木头王木地板厂	厂长：陈天清	地址：福建省福州市闽侯县祥谦镇福厦路２１公里
闽侯县南港华美家具厂	厂长：陈文华	地址：福建省福州市闽侯县南屿镇南旗旗顶尾
闽侯县天宏家俱厂	null	地址：福建省福州市闽侯县祥谦镇枕峰村上塘133号
闽侯县南屿南井机砖厂	null	地址：福建省福州市闽侯县南屿南井村
福建省闽侯县鸿尾仁秋竹木工艺厂	null	地址：福建省福州市闽侯县鸿尾乡鸿尾村239号
闽侯县南通廷宅廷前机砖厂	null	地址：福建省福州市闽侯县南通镇廷宅村
闽侯县祥谦禄家机砖厂	null	地址：福建省福州市闽侯县祥谦镇禄家村
福建省闽侯宇恒天然油脂厂	null	地址：福建省福州市闽侯县白沙镇汶溪村
闽侯县南屿镇村下木器厂	null	地址：福建省福州市闽侯县南屿镇村下村
闽侯县竹岐榕中木器厂	null	地址：福建省福州市闽侯县竹岐乡榕中村
闽侯县耀英塑料雨衣厂	null	地址：福建省福州市闽侯县甘蔗镇墩园州50号
福州市白沙钙镁磷厂劳务站	null	地址：福建省福州市闽侯县白沙镇火车路
闽侯县鸿尾坚利工艺厂	null	地址：福建省福州市闽侯县鸿尾乡大横村前厝23号
闽侯县顺兴印刷厂	null	地址：福建省福州市闽侯县甘蔗镇交通路５号
福建省闽侯华兴工艺品有限公司	null	地址：福建省福州市闽侯县甘蔗镇军民路30号
闽侯县竹岐荣文工艺厂	null	地址：福建省福州市闽侯县竹岐乡罗详村
闽侯县南通泽洋文洋机砖厂	厂长：张承俭	地址：福建省福州市闽侯县南通镇文洋村
福建省闽侯县建荣竹木工艺有限公司	null	地址：福建省福州市闽侯县洋里村
福建省闽侯县华联电容器厂	null	地址：福建省福州市闽侯县南屿镇陈厝里２号
闽侯县食品厂工会委员会	null	地址：福建省福州市闽侯县甘蔗镇山前村
闽侯县南溪饲料加工厂	null	地址：福建省福州市闽侯县青口镇宏屿村马路街
