福州浩威金属制品有限公司	总经理：胡英	地址：福建闽侯县兰圃工业区318号
福建省九兴投资有限责任公司	总经理：陈	地址：闽侯县甘蔗街道校园路21号后
福建优建建筑科技有限公司	总经理：蔡	地址：福建省福州市闽侯县上街镇科技东路3号福州高新区海西高新技术产业园创新园一期10#楼1
闽侯县南通方敏生服装加工场	联系人：方	地址：福建省福州市闽侯县南通镇方庄村
闽侯县闽旺农业专业合作社	联系人：林	地址：福建省福州市闽侯县白沙镇上岐村上岐70号
闽侯县富城农业专业合作社	联系人：林	地址：闽侯县廷坪乡汶合村九里11号
闽侯县洋里德群家庭农场	联系人：陈	地址：福建省福州市闽侯县洋里乡绅带村桥里自然村水槽亭
闽侯县鸿尾耕慧家庭农场	联系人：陈	地址：福建省福州市闽侯县鸿尾乡南坑村
福建溪源种德生态农业有限公司	总经理：潘	地址：闽侯县上街镇溪源宫村罗丰片
福州宏华家居制造有限公司	总经理：黄	地址：福建省福州市闽侯县竹岐乡榕西村中埕67号厂房三层
福州鸿祥运输有限公司	总经理：卢	地址：福建省福州市闽侯县南屿镇忠观街3号旗山商贸街商住楼9号楼1层07店面
闽侯县大山里工艺品商行	联系人：黄	地址：福建省福州市闽侯县上街镇上街四房（林友钦宅）
福建华粮米业有限公司	总经理：林	地址：福建省福州市闽侯县荆溪镇福州市粮食批发交易市场1座19号
闽侯县南通镇洲头跳龙门锦鲤育苗场	联系人：黄	地址：福建省福州市闽侯县南通镇洲头村里洋
福州云众数据科技有限公司	总经理：林	地址：福建省福州市闽侯县科技东路3号福州高新区海西高新技术产业园创新园一期10#楼1层158室
福建蓝城信息科技有限公司	总经理：林	地址：福建省福州市闽侯县科技东路3号福州高新区海西高新技术产业园创新园一期10#楼1层166室
闽侯县五福茶叶有限公司	总经理：洪	地址：闽侯县五福茶叶有限公司
福建久策气体销售有限公司	总经理：何	地址：福建省福州市闽侯县南屿镇117县道新联村福州高新区两园安置房一期一标段裙楼三层3-002
福州海峡龙祥建设有限责任公司	总经理：彭	地址：闽侯县祥谦镇福厦公路（324）国道西侧21公里处
福建鑫善源农业开发有限公司	总经理：林	地址：福建省福州市闽侯县尚干镇后村村后埕1号
闽侯县丰达竹木制品有限公司	总经理：方	地址：闽侯县竹岐乡竹岐村
福州市闽侯县王府建材有限公司	总经理：陈	地址：福州市闽侯县祥谦镇辅翼村福建豪峰金属制品有限公司厂房三整座
福州迁旺家家居股份有限公司	总经理：李	地址：福建省福州市闽侯县上街镇马保村闽侯县艺根玻璃有限公司4#厂房3楼
闽侯县仙门山食用菌专业合作社	联系人：王	地址：福建省闽侯县洋里乡仙门村岩头4号
闽侯县墨轩教育咨询有限公司	总经理：洪	地址：福州市闽侯县上街镇蔗洲村学生街2号楼211室
闽侯县鸿尾紫藤家庭农场	联系人：罗	地址：福建省福州市闽侯县鸿尾乡南坑村
福州臻顺建筑劳务有限公司	总经理：陈	地址：闽侯县上街镇沙堤村中洲片
福建森朗贸易有限公司	总经理：林	地址：福建省福州市闽侯县甘蔗街道入城路东方花园6#501
闽侯县旭丰工艺品有限公司	总经理：方	地址：闽侯县南通镇方庄
福州兴诺机械工业有限公司	总经理：卢	地址：福建省福州市闽侯县南屿镇高岐村福州海量管道器材有限公司6#综合整座
福州博红森实业有限公司	总经理：陈	地址：福建省福州市闽侯县上街镇建平村金上大道博仕后家园1#06店
福州印象行天下汽车租赁有限公司	总经理：林	地址：福建省福州市闽侯县祥谦镇中院村中院47号
福州市邂逅巴黎餐饮管理有限公司	总经理：李小姐	地址：福州市闽侯县上街镇庄南村博仕后缘墅
福州经炜家居饰品有限公司	总经理：沈	地址：闽侯县甘蔗街道大元村
闽侯县鸿尾乡雪英农林综合场	联系人：谢	地址：福建省福州市闽侯县鸿尾乡南元村垄门池
福州泰茂机电科技有限公司	总经理：罗	地址：闽侯县青口镇新城西路58号博雅星城凯景大酒店910单元
闽侯县白沙后义洋农业综合开发示范场	联系人：张	地址：福建省福州市闽侯县白沙镇安平路67号
福州快捷快递有限公司	总经理：杨	地址：闽侯县祥谦镇辅澜路3号1#厂房整座
福州亚鼎汽车贸易有限公司	总经理：李	地址：福州市闽侯县青口镇宏四村马路街50号茂泰花园1#楼1层07店面
福州闽都网络技术工程有限公司	总经理：余	地址：闽侯县
闽侯县华盛农业专业合作社	联系人：聂	地址：闽侯县廷坪乡池坑村上弯37号
福州鑫时尚家纺有限公司	总经理：王	地址：闽侯县荆溪镇光明村
福州众行汽车销售有限公司	总经理：张	地址：福建省福州市闽侯县尚干镇祥通路11-2号
福州银宝汽车服务有限公司	总经理：许	地址：福州市闽侯县尚干镇良安路8号江浩尚景园5号楼806
闽侯县大邱坪生态种养殖专业合作社	联系人：朱	地址：闽侯县鸿尾乡古洋村外境16号
闽侯县新春医药有限公司	总经理：王	地址：闽侯县上街镇国宾大道2号博仕后公馆商业广场A12#楼一层24、25店面
福州贝林工艺品有限公司	总经理：肖	地址：闽侯县荆溪镇荆溪村
福建经帆建筑劳务有限公司	总经理：马	地址：福建省闽侯县上街镇沙堤村后街66号
福州佶盛典当行有限公司	总经理：周	地址：福建省福州市闽侯县甘蔗街道昙石山东大道10号综合楼一层
闽侯县新晖企业管理有限公司	总经理：郑	地址：闽侯县甘蔗街道昙石山西大道98号新城丽景B区10#楼2层212店面
福州阳光钱柜音乐会所有限公司	总经理：林	地址：福建省闽侯县青口镇付竹村富竹大厦三层
闽侯县上街美刻妆容美容中心（普通合伙）	联系人：杨	地址：福建省福州市闽侯县上街镇博仕后公馆3号楼3-4号店
闽侯县总部园房地产有限公司	总经理：林	地址：闽侯县甘蔗街道八一八西路185号
福建长大建设有限公司	总经理：林	地址：闽侯县甘蔗街道昙石山西大道98号新城丽景B区12#楼503单元
闽侯县如果电子商务有限公司	总经理：卢	地址：福建省福州市闽侯县南通镇街西排东起第六直
闽侯县益康生农业专业合作社	联系人：鄢	地址：闽侯县五都村榜尾洋
福州联亿汽车配件有限公司	总经理：林	地址：闽侯县祥谦镇兰圃村住宅小区
闽侯县富利民食品有限公司	总经理：吕	地址：闽侯县竹岐乡竹岐村
闽侯县峰龙山农业专业合作社	联系人：何	地址：闽侯县白沙镇白沙村
闽侯县肆年传媒有限公司	总经理：周	地址：闽侯县上街镇岐安村（福州地区大学新校区体育场地东南附属楼）
世纪民生（福州）蔬菜有限公司	总经理：林	地址：闽侯县南通镇福州市海峡蔬菜批发市场精品场位106号
闽侯县华烨工艺品有限公司	总经理：王	地址：闽侯县荆溪镇港头村坛山29号
福州市甲午农业开发有限公司	总经理：欧	地址：福州市闽侯县竹岐乡竹岐村虎鼻头
福州泓一金属制品有限公司	总经理：王	地址：闽侯县竹岐乡竹西溪口116号2号厂房
福州智能时代电子科技有限公司	总经理：赖	地址：福建省福州市闽侯县科技东路3号福州高新区海西高新技术产业园创新园10#楼1层142室
闽侯县宏丰达金属制品有限公司	总经理：郭	地址：闽侯县祥谦镇中院村（原祥谦中院中心小学内）
福州佳胜贸易有限公司	总经理：吴	地址：福建省福州市闽侯县青口镇宏四村
福州有聊影视文化有限公司	总经理：盘	地址：福建省福州市闽侯县科技东路8号福州高新区海西高新技术产业园创业大厦B区1层159室
闽侯县鑫瑞杰贸易有限公司	总经理：李	地址：闽侯县大湖乡珍山村1号
福州新竹科技园发展有限公司	总经理：何	地址：福建省福州市闽侯县科技东路8号福州高新区海西高新技术产业园创业大厦B区2层205室
闽侯县尚干鸿哲商务信息咨询服务部	老板：吴	地址：福建省福州市闽侯县尚干镇新榕路1号新榕小区02幢19号店铺
闽侯县若水生花生物科技有限公司	总经理：张	地址：闽侯县上街镇岐安村（福州地区大学新校区体育场地东南附属楼）
福州卓尔物流有限公司	总经理：杨	地址：福州市闽侯县祥谦镇辅澜路3号福州皇杰实业有限公司研发楼五层501室
闽侯县彦铭贸易有限公司	总经理：徐	地址：闽侯县甘蔗街道洽浦村洽浦193号
福州盛科计算机网络信息技术有限公司	总经理：叶	地址：闽侯县上街镇岐安村（福州地区大学城新校区体育场地东南附属楼）
福州鑫辉达设备租赁有限公司	总经理：林	地址：福州市闽侯县上街镇浦口村
福建荣捷万仕德汽车销售服务有限公司	总经理：姜	地址：福建省福州市闽侯县青口镇新城西路62号博雅星城16#楼16店面
福州上仟贸易有限公司	总经理：陈	地址：福州市闽侯县上街镇建平路99号福建高速物流园12#130-131
闽侯县永诚包装制品有限公司	总经理：宋	地址：福建省福州市闽侯县甘蔗街道大元巷102号
福州亚博天汽车贸易有限公司	总经理：念	地址：福建省闽侯县青口镇新城路62号博雅星城2#楼1层03店面
闽侯县野狼贸易有限公司	总经理：林	地址：闽侯县上街镇美岐小区二期5座107室
福州城森园林景观工程有限公司	总经理：唐	地址：福建省福州市闽侯县南屿镇南前村土溪厝3号
福州市情定依身贸易有限公司	总经理：王	地址：闽侯县上街镇岐头村5-6号
闽侯县洋里诗尧工艺品加工场	联系人：江	地址：福建省福州市闽侯县洋里乡洋里村洋里街西路107号
上海奉贤建设发展（集团）有限公司福州分公司	总经理：钱	地址：福建省福州市闽侯县南屿镇旗山集中工业区8号楼二层
闽侯县千家山农业专业合作社	联系人：林	地址：闽侯县甘蔗镇军民路12号五层楼房
闽侯县众彩广告传媒有限公司	总经理：林	地址：闽侯县祥谦镇枕峰村上塘125号
福州三友装修有限公司	总经理：畅	地址：福建省福州市闽侯县甘蔗街道入城路南侧
青峰（福州）传媒有限公司	总经理：林	地址：闽侯县青口镇升旗村青口街53号
福州市闽侯县圆柏贸易有限公司	总经理：毛	地址：福建省福州市闽侯县上街镇国宾大道338号英泰第一城B区商住楼5#619单元
闽侯县祥顺农林开发有限公司	总经理：邓	地址：福建省福州市闽侯县竹岐乡竹岐村
福州秋实园贸易有限公司	总经理：陈	地址：福州市闽侯县上街镇庄南路1号“博仕后缘墅“E2#103
闽侯县仙和祥原生态农业有限公司	总经理：王	地址：福建省福州市闽侯县洋里乡仙门村坝头自然村3号
福州三友和贸易有限公司	总经理：陈	地址：闽侯县甘蔗街道昙石山西大道98号新城丽景B区10#楼2层214店面
福建神州美景健康管理有限公司	总经理：陈	地址：福州市闽侯县科技东路8号福州高新区海西高新技术产业园创业大厦B区1层157室
福建根艺达工艺品有限公司	总经理：陈	地址：福建省闽侯县上街镇国宾大道1号闽都大庄园沿街商住9#楼1层147店面
福州市闽侯县科阳金属制品有限公司	总经理：陈	地址：福州市闽侯县上街镇沙堤村（闽侯县鑫龙寿五金机械有限公司）2#厂房4层405
福州九易传媒有限公司	总经理：林	地址：闽侯县甘蔗街道入城路横屿233号一楼店面
福建省煜景装饰设计有限公司	总经理：聂	地址：闽侯县上街镇国宾大道276号综合商场7层
福州菜鸟工艺品有限公司	总经理：蔡	地址：闽侯县上街镇闽都大庄园165号店面
闽侯县鸿尾莲棋大排档	联系人：刘	地址：福建省福州市闽侯县鸿尾乡114县道排洪沟（刘兴棋厝）
闽侯县荆溪流朱溢墨脱胎漆艺坊	联系人：上	地址：福建省福州市闽侯县荆溪镇古山洲村（五楼）
闽侯县南屿意程家具商场	联系人：王	地址：闽侯县南屿镇南旗村
闽侯县古将贸易有限公司	总经理：冯	地址：福州市闽侯县上街镇乌龙江北大道1号福州地区大学新校区教师生活区B区B4#楼1504单元
闽侯县上街鸿艺工艺品加工厂	厂长：宋	地址：闽侯县上街镇新峰村杏山39号一层
闽侯县绿网餐饮管理有限公司	总经理：瞿	地址：闽侯县甘蔗街道员工公寓18#D-12号
闽侯县上街书香领寓金海岸房产中介所	所长：蒋	地址：福建省福州市闽侯县上街镇邱阳东路2号弘绘菁华园弘绘楼01店面
闽侯县洋里景丰农业专业合作社	联系人：张	地址：闽侯县洋里乡新见村堡头36号
福州恒业建材有限公司	总经理：潘	地址：闽侯县鸿尾乡奎石村长安里
上海源天绿化工程有限公司闽侯分公司	总经理：张	地址：福州市闽侯县竹岐乡榕西村316国道直升机机场
福建广咏通消防设备制造有限公司	总经理：周	地址：闽侯县鸿尾乡石佛头街107号
福建闽富华家居制造有限公司	总经理：涂	地址：福州市闽侯县竹岐乡竹西村溪口118号1#厂房一层
闽侯县青星物流有限公司	总经理：林	地址：闽侯县青口镇新城路62号博雅星城12-603
闽侯县十八溪农业开发有限公司	总经理：潘	地址：闽侯县南通镇古城村布里
福州富森纸业有限公司	总经理：强	地址：闽侯县南屿镇高岐村安厦52号
闽侯县大湖沐雨种植场	联系人：马	地址：福建省福州市闽侯县大湖乡大坪村
闽侯县永盛家纺有限公司	总经理：陈	地址：闽侯县上街镇浦口村浦南
闽侯县南屿辉旺苗木场	联系人：林	地址：闽侯县南屿镇南井村红旗村民小组
福州新能能源科技有限公司	总经理：陈	地址：福州市闽侯县甘蔗街道长江村墩园洲
福州市朝华园艺有限责任公司	总经理：张	地址：福建省福州市闽侯县南通镇桥街村
闽侯县罗峰家庭农场	联系人：邓	地址：福建省福州市闽侯县竹岐乡罗洋村际峰片
闽侯县金叶园艺有限公司	总经理：练	地址：福建省福州市闽侯县荆溪镇光明村岭尾54号
福州港尾建材有限公司	总经理：卢	地址：闽侯县竹岐乡白龙村
闽侯县鑫弘鑫铁艺配件厂	厂长：陈	地址：福建省福州市闽侯县甘蔗街道大元村
闽侯县凯锐物资再生利用有限公司	总经理：赵	地址：闽侯县上街镇沙堤村后街
盛辉物流集团有限公司闽侯高速物流园分公司	总经理：毕	地址：闽侯县上街镇建平路99号高速物流园2号楼102-107号
闽侯县善品天鸿餐饮管理有限公司	总经理：王	地址：闽侯县青口镇祥宏路268号3#厂房整座（福州全庆雨具塑料制品有限公司内）
福建青大汽车维修有限公司	总经理：郑	地址：闽侯县青口镇前街村金山加油站旁16号
闽侯县启城企业管理有限公司	总经理：黄	地址：闽侯县南屿镇南旗桥下72号
闽侯县荆溪翔源电子厂	厂长：钟	地址：闽侯县荆溪镇荆溪村徐家村165号1#厂房2层
闽侯县木禾贸易有限公司	总经理：黄	地址：闽侯县甘蔗镇化龙村818西路74号
闽侯县万德芙工艺品有限公司	总经理：周	地址：闽侯县甘蔗街道十字村旗下新村
闽侯县汇滨木制品有限责任公司	总经理：马	地址：闽侯县大湖乡大坪村
福建省康辉国际旅行社股份有限公司上街大学城营业部	老板：吴	地址：福州市闽侯县上街镇新商业街（工商银行斜对面）
福州市闽侯县至诚教育咨询有限公司	总经理：徐	地址：福州市闽侯县上街镇岐安村商业中心B号楼一层03店面
闽侯县竹岐乡半岭村兴建苏强果树场	联系人：苏	地址：福建省福州市闽侯县竹岐乡半岭村兴建自然村
闽侯县洋里供销社小箬村综合服务部	老板：刘	地址：福建省福州市闽侯县小箬乡小箬村
福州泳旭贸易有限公司	总经理：黄	地址：福建省福州市闽侯县上街镇源通东路118号福晟学府11#楼1层01店面
闽侯县上街建基医药商店第一分店	老板：林	地址：福建省福州市闽侯县上街镇厚美村104店面（上街镇政府对面）
福州齐悦塑料制品有限公司	总经理：艾	地址：福建省福州市闽侯县南通镇陈厝村
福州誉叶成汽配有限公司	总经理：叶	地址：闽侯县祥谦镇卜洲村
福州市保恩农业开发有限公司	总经理：唐	地址：闽侯县南屿镇双龙村保恩
福州市闽侯县梦飞食品有限公司	总经理：蔡	地址：闽侯县荆溪镇厚屿村食品工业园福州康旺食品有限公司5#厂房二层
闽侯县竹岐天骏日用品咨询服务部	老板：陈	地址：福建省福州市闽侯县竹岐乡榕西村石岐26号
福州市汇京时代汽车销售服务有限公司	总经理：林	地址：福建省福州市闽侯县尚干镇祥通路13号
福州德奈福洗涤有限公司	总经理：王	地址：福建省福州市闽侯县上街镇庄南路1号“博士后缘墅”E5#04店面
福州市天鹏谷成饲料有限公司	总经理：胡	地址：福建省福州市闽侯县南屿镇后山村
闽侯县南通陈培煌家具加工场	联系人：陈	地址：福建省福州市闽侯县南通镇罗洲村新桥浦1号
福州华洋保温工程有限公司	总经理：阮	地址：福建省福州市闽侯县荆溪镇闽侯经济技术开发区铁岭东路9号（4#车间）
闽侯县中庚房地产开发有限公司	总经理：梁	地址：福建省福州市闽侯县荆溪镇荆溪村197号
闽侯县鸿萃生态农业开发有限公司	总经理：罗	地址：福建省福州市闽侯县鸿尾乡大模村山边124号
闽侯县甘蔗酷胜装饰材料店	老板：高	地址：福建省福州市闽侯县甘蔗街道县城新区“世纪芳洲”
闽侯县讯锋通信工程有限公司	总经理：施	地址：福建省福州市闽侯县甘蔗街道山前亭下街66号
闽侯县大湖思惠钢筋加工场	联系人：马	地址：福建省福州市闽侯县大湖乡大坪村（圣康加油站对面）
闽侯县鱼尔乐机械有限责任公司	总经理：王	地址：闽侯县祥谦镇虎山村王厝26号
闽侯县新枝农业专业合作社	联系人：余	地址：闽侯县廷坪乡广坪村新枝1号
闽侯县溪头农业综合开发有限公司	总经理：王	地址：闽侯县白沙镇溪头村溪头79号
闽侯县乐建农业开发有限公司	总经理：杨	地址：闽侯县鸿尾乡鸿尾村上门限11号
闽侯县靓家贸易有限公司	总经理：林	地址：闽侯县青口镇宏三村
闽侯县加特林贸易有限公司	总经理：杨	地址：闽侯县青口镇青口投资区义溪路98号1#厂房
闽侯县后洋农业专业合作社	联系人：宋	地址：闽侯县大湖乡后洋村43号
闽侯县鸿桥都市农业专业合作社	联系人：章	地址：闽侯县鸿尾乡桥头村坂头
闽侯县福香源餐饮管理有限公司	总经理：郑	地址：闽侯县青口镇宏二村
闽侯县柏利莱家具贸易有限公司	总经理：余	地址：闽侯县南屿镇高岐村安里6号3#厂房第二层
华腾实业（福建）有限公司闽侯分公司	总经理：俞	地址：闽侯县荆溪镇古山洲村洲头268号5#厂房整座
福州中鑫之宝汽车销售服务有限公司	总经理：林	地址：闽侯县青口镇义溪路88号8#展厅第一层
福州市卫农农资有限公司	总经理：徐	地址：闽侯县竹岐乡竹岐村竹岐街357号一层
福州市闽侯县永福超人汽车租赁有限公司	总经理：林	地址：福州市闽侯县上街镇建平路50号博仕后家园6#楼401单元
福州精工泡塑制品有限公司	总经理：林	地址：闽侯县祥谦镇泮洋村福州泮洋野营用品有限公司内2号厂房3层
福州恒荣机械工程有限公司	总经理：袁	地址：闽侯县青口镇壶山村千家花园26号店面
福建晟哲自动化科技有限公司	总经理：张	地址：闽侯县荆溪镇光明村上沙58号1#楼
福建启航置业有限公司	总经理：林	地址：闽侯县甘蔗街道闽侯大桥西侧
福建大旭光电有限公司	总经理：刘	地址：闽侯县竹岐溪口工业小区（竹西村溪口116号）
法兴华宝汽车租赁（上海）有限公司福州分公司	总经理：李	地址：闽侯县青口镇杨厝村、泸屿村（福州宝井钢材有限公司综合楼102）
闽侯县竹岐乡陈绍同养蜂场	联系人：陈	地址：闽侯县竹岐乡榕西村石岐
闽侯县竹岐乡陈金炎养蜂场	联系人：陈	地址：闽侯县竹岐乡白龙村33号
闽侯县众鑫橡胶制品有限公司	总经理：李	地址：福建省福州市闽侯县青口镇东台村洋中5号
闽侯县鑫诚工艺品有限公司	总经理：程	地址：福州市闽侯县甘蔗街道墩园洲工业区
闽侯县伟兴纺织有限公司	总经理：宋	地址：闽侯县南屿镇江口村旺厝
闽侯县南屿学仁塑料破碎加工厂	厂长：郑	地址：闽侯县南屿镇江口村浦口60号
闽侯县南屿双联铁桶加工厂	厂长：陈	地址：闽侯县南屿镇高岐村
闽侯县马厝高山农业综合开发有限公司	总经理：马	地址：闽侯县廷坪乡马厝村31号
闽侯县乐家商务宾馆	联系人：王	地址：闽侯县上街镇建平村根雕一条街1#楼二层
闽侯县大湖上苑山腰生态肉牛养殖场	联系人：朱	地址：闽侯县大湖乡上苑村山腰
闽侯县春秋纺织有限公司	总经理：宋	地址：福建省福州市闽侯县南屿镇江口村旺厝
福州金盛达家具有限公司	总经理：王	地址：福州市闽侯县祥谦镇辅翼村（福建豪峰金属制品有限公司内）
福州佳华汽车销售服务有限公司	总经理：吴	地址：闽侯县祥谦镇兰圃村（闽侯县盛辉物流有限公司内）
福州乡村牛餐饮管理有限公司	总经理：王	地址：闽侯县甘蔗街道昙石山东大道6号综合楼（厂房）整座2层202
福州市闽侯县新方向教育咨询有限公司	总经理：林	地址：福州市闽侯县上街镇建平村金上大道博仕后家园4#03店面
福州市华成工艺品有限公司	总经理：董	地址：闽侯县甘蔗街道长江村（福州市兆发水表水暖有限公司厂房1#第一层）
福建光能能源科技有限公司	总经理：薛	地址：福建省福州市闽侯县经济技术开发区二期
林梦镜	联系人：林梦镜	地址：福建闽侯县福州仓山区建新镇冠州工业区（福州南高速口）
闽侯圣博家饰有限公司	总经理：陈灵燕	地址：福建闽侯县甘蔗镇
闽侯县上街阮上好茗茶店	老板：王荣添	地址：福建闽侯县上街 源通东路
福州欧尼斯工艺品有限公司	总经理：罗若洲	地址：福建闽侯县福建闽侯荆溪镇溪头工业园区
刘文焕	联系人：刘文焕	地址：福建闽侯县甘蔗镇旗下新村闽侯县委旁
李凤阳	联系人：李凤阳	地址：福建闽侯县上街建平村1号
陈光衔	联系人：陈光衔	地址：福建闽侯县荆溪镇桐口村58号
闽侯县南屿晓东工艺品加工店	老板：林晓东	地址：福建闽侯县闽侯县南屿
福建省闽侯县白沙工艺美术二厂	厂长：王斌谋	地址：福建闽侯县福建省闽候县墩园洲工业区8号厂区
福州三成新型墙体材料有限公司	总经理：廖景国	地址：闽侯县江洋农场武竹村西洋
鑫华龙（福建）电装有限公司	总经理：王娟琴	地址：闽侯县祥谦镇辅翼村
福州御赐福贸易有限公司	总经理：赵天赐	地址：闽侯县上街镇源通东路59号尚书耕天下花园1#店面1层02店面
福州富腾生态农业发展有限公司	总经理：陈能文	地址：闽侯县鸿尾乡南坑村南坑78号
闽侯县白沙白云谷生态农业专业合作社	联系人：邱铸?	地址：闽侯县白沙镇白沙村火车路121号
福州市闽侯县旭宏商贸有限公司	总经理：孙艳先生	地址：闽侯县上街镇华佗路红峰村上街根雕展示交易中心1号楼1层12号
福州市骄阳驰辉贸易有限公司	总经理：林翠云	地址：闽侯县上街镇建平村金上大道博仕后家园1#09店
福州市黄氏艺品木业有限公司	总经理：黄贞庚	地址：闽侯县上街镇建平村后山002号
中国国旅（福建）国际旅行社有限公司闽侯尚干营业部	老板：林先生	地址：闽侯县尚干镇红新村
爱欧亚科技（福建）有限公司	总经理：程文艺	地址：福州市生物医药和机电产业园区（闽侯县南屿镇）
福建新开普信息科技有限公司	总经理：尚卫国	地址：福州市闽侯县上街镇科技东路以南“海西高新技术产业园”创新楼8号楼2层
成都中铁二局瑞城物业管理有限公司福州分公司	总经理：周蓉先生	地址：福州市闽侯县荆溪镇徐家村236号
福建天泽控股有限公司	总经理：陈先生	地址：闽侯县南通镇南通街108号
闽侯德润投资合伙企业（有限合伙）	联系人：杨岩岩	地址：闽侯县南屿镇生物医药和机电产业园区
闽侯县溪坪园农业专业合作社	联系人：郑振城	地址：闽侯县廷坪乡溪坪村芳田?
闽侯县星光辉食用菌专业合作社	联系人：陈佑辉	地址：闽侯县南通镇洲头村河尾
福州翔通电力物资有限公司	总经理：陈先生	地址：闽侯县甘蔗街道横屿村
福州华榕汽车改装有限公司	总经理：戴先生	地址：福州市闽侯县青口投资区祥谦镇洋下村
福建东乾生态农业开发有限公司	总经理：薛先生	地址：闽侯县大湖乡东?后元里15号
闽侯县鸿尾包依春木制工艺品加工场	联系人：包先生	地址：闽侯县鸿尾乡大模村
闽侯县福展包装制品有限公司	总经理：陈先生	地址：闽侯县青口镇壶山村东南千家花园1幢402
福州鼎辉工艺品有限公司	总经理：曾财银	地址：闽侯县上街镇岐头村岐头23号
福建省金福机动车安全检测有限公司	总经理：林鸿祥	地址：闽侯县祥谦镇枕峰村
福州闽源工艺品有限公司	总经理：陈仰豪	地址：闽侯县南通镇罗洲村
福建登洁农业发展有限公司	总经理：周洁先生	地址：福州市闽侯县南屿镇三南林场8号
福州牧兴饲料有限公司	总经理：陈如开	地址：闽侯县竹岐乡榕西村
福建省中保瑞志贸易有限公司	总经理：陈武先生	地址：闽侯县尚干镇福州市海峡汽车文化广场一期汽车超市一层E区E-105单元
闽侯县视界工坊贸易有限公司	总经理：陆进先生	地址：闽侯县上街镇新峰村商贸中心3#204号
福建天瑞医药有限公司闽侯县第一门市部	老板：陈德英	地址：闽侯县青口镇壶山村河头街8-2号
福州市祺联食品有限公司	总经理：王全城	地址：福州市闽侯县南通镇海峡蔬菜批发市场南区9号楼101号
闽侯县富光家居用品有限公司	总经理：陈光汨	地址：闽侯县竹岐乡榕西村中埕68号2#厂房一层01车间
福州余氏艺佳工艺品有限公司	总经理：余春宝	地址：闽侯县上街镇中美村
福州聚福鑫木业有限公司	总经理：陈端先生	地址：闽侯县上街镇新洲村
福州荣乐实业有限公司	总经理：黄积伟	地址：闽侯县青口镇青圃工业区
闽侯县御虎山生态农业专业合作社	联系人：郭銮兵	地址：福州市闽侯县祥谦镇?前村新村
福州承铭工艺品有限公司	总经理：吴先生	地址：闽侯县上街镇建平村董屿022号
福州福农农业发展有限公司	总经理：欧先生	地址：福建省闽侯县白沙镇白沙村刘厝里41号
福州祥瑞纺织品有限公司	总经理：宋先生	地址：闽侯县南屿镇江口村
闽侯县上街冰宇隆家居店	老板：赵先生	地址：闽侯县上街镇红峰村
闽侯县南屿木生便利店	老板：黄先生	地址：闽侯县南屿镇高岐村
闽侯县上街镇宪窗街道平安香烛点	联系人：陈先生	地址：闽侯县上街镇红丰村宪窗街道
闽侯县上街振辉世纪星文体用品店	老板：章先生	地址：闽侯县上街镇福州大学旗山校区学生生活区三期连廊
闽侯县上街良捷工艺品店	老板：吴先生	地址：闽侯县上街镇建平村董屿157号
闽侯县大湖月圆电信服务部	老板：程先生	地址：闽侯县大湖乡大湖后街95号
闽侯县南屿桂芳森林人家小吃店	老板：黄先生	地址：闽侯县南屿镇双峰村
闽侯县南屿艳华食杂店	老板：林先生	地址：闽侯县南屿镇柳浪村中洲56号
闽侯县大湖微微电信服务部	老板：唐先生	地址：闽侯县大湖乡东姚村东姚78号
闽侯县甘蔗红江满烟酒商行	联系人：洪先生	地址：闽侯县甘蔗街道818大道盐业办公楼底层右边三间商铺
福州海峡副食品批发市场捷佳日用百货商行	联系人：陈先生	地址：闽侯县南通镇海峡副食品批发市场1225号店
闽侯县南通剑清日杂店	老板：林先生	地址：闽侯县南通镇泽苗村
闽侯县善然堂贸易有限公司	总经理：叶先生	地址：闽侯县甘蔗街道山前村38号
福州众森工艺品有限公司	总经理：张先生	地址：闽侯县上街镇联心村
福建力普勘测有限公司	总经理：严先生	地址：闽侯县上街镇科技东路海西高新技术产业园创业大厦B区5层
福建省乾达永丰地产顾问有限公司	总经理：林先生	地址：闽侯县荆溪镇厚屿村216号福州市粮食批发市场办公大楼四楼1、2、3号店面
闽侯县九里家禽养殖专业合作社	联系人：林先生	地址：闽侯县廷坪乡汶合村九里自然村5号
闽侯县谊联合创网络科技有限公司	总经理：皮先生	地址：闽侯县甘蔗街道818大道东方花园5#306
福建福丰食品有限公司	总经理：江先生	地址：闽侯县洋里乡洋头村
闽侯福怡塑料制品有限公司	总经理：马先生	地址：闽侯县荆溪镇桐口村（福州同泰电子有限公司）厂房一层
闽侯县小天使贸易有限公司	总经理：高先生	地址：闽侯县南屿镇江口村
闽侯县上街小鱼美术设计工作室	联系人：韦先生	地址：闽侯县上街镇国宾大道338号英泰第一城B区5栋523
闽侯县青口华荣五金商店	老板：杨先生	地址：闽侯县青口镇东台村后厝135号
闽侯县上街富兴木雕工艺品店	老板：张先生	地址：闽侯县上街镇蔗洲村木雕城
闽侯县上街林东特艺根雕工艺品店	老板：王先生	地址：闽侯县上街镇建平村后山99号
闽侯县荆溪陈育才中医诊所	所长：陈先生	地址：闽侯县荆溪镇厚屿新街
闽侯县上街陈弟云眼镜店	老板：陈先生	地址：闽侯县上街镇大学城蔗洲村2号地商业网点第贰幢第壹层第20号店面
闽侯县上街碧祥建材贸易经营部	老板：赵先生	地址：闽侯县上街镇红峰村沙墩文明村南起第二直
闽侯县甘蔗一剪缘理发店	老板：张先生	地址：闽侯县甘蔗街道昙石山中大道118号新城丽景A区8#楼103店面
闽侯县甘蔗俏华粮油店	老板：陈先生	地址：闽侯县甘蔗街道化龙村亭下街
闽侯县甘蔗邹爱玉服装店	老板：邹先生	地址：闽侯县甘蔗镇入城路北侧101号
闽侯县天仪殡葬服务有限公司	总经理：林先生	地址：闽侯县尚干镇红新村红门
福建省闽侯县同心养蜂专业合作社	联系人：黄先生	地址：福建省闽侯县南屿镇新联村?上42号
闽侯县宏利物业有限公司	总经理：吴先生	地址：闽侯县青口镇东南汽车城后福工业区（闽侯县宏利金属制品有限公司）
中石化森美（福建）石油有限公司福州闽侯乌门加油站	站长：郑先生	地址：福州市闽侯县尚干镇乌门村省道203线30公里800米
福州福勇达工艺品有限公司	总经理：林先生	地址：闽侯县上街镇新峰村
闽侯县睿哲贸易有限公司	总经理：王先生	地址：闽侯县上街镇岐安村岐安花园31-5整座
福建安康工伤保险事务有限公司	总经理：王先生	地址：闽侯县上街镇新街8号楼三楼（镇对面）
闽侯县南屿宋友祥纺织配件加工场	联系人：宋先生	地址：闽侯县南屿镇江口九石
福建宝嘉霖投资有限公司	总经理：李先生	地址：闽侯县甘蔗街道昙石山西大道69号员工公寓29#502
福州市旺中旺工艺品有限公司	总经理：林旺先生	地址：闽侯县上街镇上街镇美岐村美前
福州汝惠工艺品有限公司	总经理：赵汝惠	地址：闽侯县上街镇沙堤村后街35号
福州市弥勒汇工艺品有限公司	总经理：陈春燕	地址：闽侯县上街镇建平村
福州飞麟工艺品有限公司	总经理：陈如林	地址：闽侯县上街镇中美村仁宅
福州新安德鲁森食品有限公司闽侯福大分店	老板：雷东隆	地址：福州市闽侯县上街镇福州大学旗山校区西教学楼（闽侯县上街师生便利店西教分店）
闽侯县温泉胡子鲶苗种专业合作社	联系人：黄道枫	地址：闽侯县甘蔗街道坛石村
闽侯县舞明昕文化发展有限公司	总经理：林先生	地址：闽侯县祥谦镇泮洋村大?63号
福州鑫宏锋金属制品有限公司	总经理：李剑锋	地址：福州市闽侯县青口镇前洋村（福州青龙农业水产综合有限公司）内
福州市杰盛隆贸易有限公司	总经理：林伙士	地址：闽侯县祥谦镇兰圃村
福建永达物流有限公司	总经理：林财先生	地址：闽侯县尚干镇过浦村马路线22公里处二层
闽侯县千盈制衣有限公司	总经理：叶雪英	地址：闽侯县上街镇新峰村梧洋2#5幢
福州市忠盛塑胶制品有限公司	总经理：陈新忠	地址：闽侯县青口镇祥青路39号4#厂房
福州金帆鞋业有限公司	总经理：陈艳先生	地址：闽侯县青口镇祥青路39号
福州宝明达金属材料有限公司	总经理：陈明先生	地址：闽侯县青口镇宏二村
闽侯县金奎山果蔬种植专业合作社	联系人：陈锦铿	地址：闽侯县青口镇坊口八斗新村
福州隆博进出口贸易有限公司	总经理：方孝强	地址：闽侯县南通镇方庄南路45号
福州好佳餐饮有限公司	总经理：刘海燕	地址：闽侯县荆溪镇桐口村
福州艺群工艺品有限公司	总经理：林光锋	地址：闽侯县荆溪镇荆溪村6#（福州艺泉工艺品有限公司内）
闽侯县柴火房美食会所	所长：杨俊先生	地址：闽侯县荆溪镇厚屿小桥村路段南侧新甘洪路旁（厚屿小桥老人会1-3层）
福州利天下粮油贸易有限公司	总经理：陈明照	地址：闽侯县荆溪镇福州市粮食批发交易市场12座9号
闽侯县盛美家居饰品有限公司	总经理：周伯魁	地址：闽侯县甘蔗街道县城新区世纪芳洲住宅小区7#楼405单元
福建省宇浩建设工程有限公司	总经理：罗性魁	地址：闽侯县甘蔗街道县城新区“世纪芳洲”住宅小区1#乙103号房
闽侯县甘蔗峰香五金店	老板：黄先生	地址：闽侯县甘蔗街道员工公寓5#D-10店铺
闽侯县尚干淘江大酒楼	联系人：陈先生	地址：闽侯县尚干镇红新村尚南路70号一层至二层
闽侯县青口兴宏汽车配件仓储处	联系人：林先生	地址：闽侯县青口镇文华村积善路29号
福州海峡副食品批发市场滨海商行	联系人：陈先生	地址：闽侯县南通镇海峡副食品批发市场2173号店
闽侯县南通三科林茶叶店	老板：陈先生	地址：闽侯县南通街陈厝村卫星69号4#厂房整座
闽侯县鸿尾鑫涵通讯器材商行	联系人：黄先生	地址：闽侯县鸿尾乡超乾村石佛头街
闽侯县鸿尾漂亮宝贝理发店	老板：林先生	地址：闽侯县鸿尾乡石佛头街红星桥61-63号
闽侯县南通蓝金服装店	老板：陈先生	地址：闽侯县南通镇陈厝村
闽侯县南通腾兴便利店	老板：陈先生	地址：闽侯县南通镇马腾村
闽侯县甘蔗可爱小天使童装店	老板：吴先生	地址：闽侯县甘蔗街道街心路41号沿街底层16号店面
福州海峡副食品批发市场大康食品商行	联系人：姚先生	地址：闽侯县南通镇海峡副食品批发市场2149店
闽侯县甘蔗净美洗涤服务部	老板：洪先生	地址：闽侯县甘蔗街道山前村135号整座
闽侯县尚干增明兽药店	老板：林先生	地址：闽侯县尚干镇桥头（洋中村）
福州闽侯雪旗生态农业发展有限公司	总经理：何开杰	地址：闽侯县南屿镇旗山万佛寺
福建省榕佳建设工程有限公司	总经理：杨敏先生	地址：闽侯县甘蔗街道昙石山西大道69号员工公寓32幢501-503单元
闽侯县泰宝山农林专业合作社	联系人：刘用斌	地址：闽侯县洋里乡安仁村安仁134号
福州市维新达生物科技有限公司	总经理：蒋维先生	地址：福州市闽侯县上街镇科技东路"海西高新技术产业园"创新园10号楼1层
福州古洋苗木有限公司	总经理：罗道伟	地址：闽侯县鸿尾乡大模村洋中74号
福建省科皇工贸有限公司	总经理：黄一岷	地址：闽侯县荆溪镇荆溪村徐家村93-1号车间整座
闽侯县竹岐旺达养殖场	联系人：林昌旺	地址：闽侯县竹岐乡湖后地区
闽侯县吉祥溪生态农业综合开发有限公司	总经理：苏庄华	地址：闽侯县竹岐乡半岭村
闽侯县润丰农业开发有限公司	总经理：季权先生	地址：闽侯县洋里乡刘洋村
福建春宇机械有限公司	总经理：黄星先生	地址：闽侯县祥谦镇洋辅路6号3#厂房
闽侯县牛栏道果蔬专业合作社	联系人：陈彬贤	地址：闽侯县青口镇坊口村八斗新村
福建宏亨建设工程集团有限公司闽侯分公司	总经理：施好弟	地址：闽侯县荆溪镇人民政府干部楼
闽侯县友道农业专业合作社	联系人：徐道峰	地址：闽侯县荆溪镇荆溪村徐家村
闽侯县燕飞林农业专业合作社	联系人：吴木林	地址：闽侯县鸿尾乡桥头村23-3号整座
福州有伦生态农业有限公司	总经理：毛有仓	地址：闽侯县鸿尾乡南坑村
福州学量贸易有限公司	总经理：陈学量	地址：闽侯县鸿尾乡鸿尾村（郑武镇）整座
闽侯县鸿安纸制品厂	厂长：余木淼	地址：闽侯县鸿尾乡安樟村石坑洋8号
闽侯丫霸文化传播有限公司	总经理：周丕禄	地址：闽侯县甘蔗街道昙石新村19座2单元1层
闽侯县邑府装饰设计工程有限公司	总经理：张良敏	地址：闽侯县甘蔗街道八一八西路86号
闽侯县钻石人生娱乐有限公司	总经理：黄兰珍	地址：闽侯县白沙镇安平路88号白沙新城商贸中心三层
江阴万奇内饰系统有限公司闽侯分公司	总经理：CHERRY CHU	地址：福州市闽侯县青口镇东南大道1号
中化（福建）石油销售有限公司闽侯尚干加油站	站长：谢先生	地址：闽侯县尚干镇大桥头国道324线21公里700米
福州友隆设备检测有限公司	总经理：林先生	地址：闽侯县南屿镇五都村3层整座
闽侯县鸿尾乡徐云平林果场	联系人：徐先生	地址：闽侯县鸿尾乡埕头村桥头山
闽侯县洋里新风花圃场	联系人：林先生	地址：闽侯县洋里乡际兜村山坪顶
闽侯县上街天同气体店	老板：赵先生	地址：闽侯县上街镇金屿村余盛口
福州和靖工艺品有限公司	总经理：王先生	地址：闽侯县荆溪镇荆溪村（福州宏凯新型墙材有限公司内）
闽侯县青口心意婚姻服务部	老板：林先生	地址：闽侯县青口镇农光村新城路博雅星城泊园1#207
闽侯县精舍饰界家居有限公司	总经理：林先生	地址：闽侯县甘蔗街道县城新区世纪芳洲住宅小区7#楼405单元
福州蓝帆印务有限公司闽侯县分公司	总经理：林先生	地址：闽侯县南屿镇天水岭1号
福建省嘉成生物科技有限公司	总经理：王先生	地址：闽侯县青口镇东台村
长乐华成钢结构建筑有限公司闽侯县分公司	总经理：陈先生	地址：闽侯县祥谦镇门口村
福州市隆?劳务服务有限公司	总经理：杨先生	地址：闽侯县青口镇壶山村陶精路3号“千家花园”1#楼店面30号
福州市影讯文化传播有限公司	总经理：叶先生	地址：闽侯县上街镇沙堤村国宾大道
福州春福种业有限公司	总经理：李先生	地址：福州市闽侯县上街镇源通东路59号尚书耕天下花园3#楼1008单元
闽侯县沃家家居用品有限公司	总经理：林先生	地址：闽侯县甘蔗街道长江村墩园洲
闽侯县兴隆盛农业专业合作社	联系人：陈先生	地址：闽侯县鸿尾乡南元村后洋34号
闽侯县南屿福泰家具厂	厂长：林先生	地址：闽侯县南屿镇窗夏村窗前
福州市启明木艺经营部	成立日期：2000/9/2	地址：中国.福建省.福州市.闽侯县
古木年华股份有限公司	总经理：林幼华	地址：福州闽侯县上街镇建平村岐安新村花园11-7
福建壹印象传媒有限公司	总经理：缪经理	地址：福建省福州市闽侯县大学城博士后家园2# 101
福州永芳玻璃工艺品有限公司	总经理：潘永松	地址：闽侯县鸿尾
福州福盛汽车配件有限公司	成立日期：2007/7/17	地址：中国.福建省.福州市.闽侯县青口镇村里村
福建朗正通信科技有限公司	成立日期：2008/8/8	地址：福建省福州市闽侯县荆溪镇甘洪路168号
福建老根根雕厂	成立日期：2001/1/1	地址：福州市闽侯县上街镇博士后家园07-01展厅
花木兰木雕厂	厂长：郭桂兰	地址：福建省福州市闽侯县上街镇建平村
福州新达混凝土外加剂有限公司	总经理：李建奇	地址：福建省福州市闽侯县青口镇青秀村旦元下
福州?狮润滑油有限公司	总经理：林高文	地址：闽侯县上街镇竹歧乡苏洋村国宾大道616号勃莱特工业园
福州市老树根雕有限公司	总经理：叶浩	地址：福建省福州市闽侯县上街镇
福州华夏龙德工艺品有限公司	总经理：陈繁荣	地址：福建省 福州市 闽侯县 南屿镇大屿香颂2-18#
花木兰木雕工艺厂	成立日期：2009/9/21	地址：福建省福州市闽侯县上街镇建平村
福州闽侯建忠特种鱼苗有限公司	总经理：欧阳建忠	地址：福建省福州市闽侯县竹歧乡
以达鞋业有限公司	总经理：钟礼镇	地址：福州市闽侯县南屿镇元峰路口
福州益丰源赠品制造有限公司	总经理：吴祥光	地址：中国.福建省.福州市.闽侯县福建福州西门外厚屿187号
福建闽侯盛艺工艺品有限公司	成立日期：2001/1/1	地址：中国.福建省.福州市.闽侯县闽侯详谦镇洋下村三股29号
闽侯县维美达装饰品有限公司	总经理：陈峰	地址：中国.福建省.福州市.闽侯县甘蔗镇陈店湖工业区
福建省神安建材有限公司	总经理：雷光森	地址：中国.福建省.福州市.闽侯县
闽侯县中泰玻璃纺纱有限公司	总经理：黄开纯	地址：中国 福建 闽侯县 福建省闽侯县大湖乡珍山工业区
福州老树根雕有限公司	总经理：叶浩	地址：福建省福州闽侯县上街镇
福州丰雅进工艺品有限公司	总经理：罗晴	地址：福建省闽侯县竹歧乡苏洋村（厂址）福州东街三山大厦南楼2205（市区办事处）
福建省闽侯荆溪小桥漆器厂	成立日期：1988/11/22	地址：中国.福建省.福州市.闽侯县
闽侯县宇浩红木家居有限公司	总经理：叶明顺	地址：中国福建福州闽侯县甘蔗街道青岐村188号
福州佳云工艺品有限公司	总经理：钟宙清	地址：中国.福建省.福州市.闽侯县福建省福州市闽侯县甘蔗镇三福小区2路11号
福州安泰木业有限公司	总经理：包天生	地址：福州市闽侯县115县道绿洲家园旁
台合工贸(厦门公司)	成立日期：2000/2/2	地址：福州市闽侯县青口镇东南汽车对面
闽侯金亮利工艺品厂	成立日期：2013/4/17	地址：闽侯县福州南屿新区葛岐村130号
福建梅玲玩具科技有限公司	成立日期：2011/5/24	地址：闽侯县大湖乡韩坂88号
福州益丰源织带有限公司	总经理：吴祥光	地址：中国.福建省.福州市.闽侯县荆溪镇厚屿187号
福州上豪五金贸易有限公司	总经理：陈玄基	地址：闽侯县青口投资区文华村白水路(六和对面，华萱厂内)
福州市闽赣园钉制造有限公司	总经理：李金龙	地址：中国.福建省.福州市.闽侯县永丰村汽车教练旁
福建省闽侯县三友纺织厂	厂长：宋经纬	地址：福建闽侯县南屿镇江口
福建闽侯红木家具有限公司	成立日期：1998/8/11	地址：福建省福州市闽侯县荆溪镇关口工业区272号
泛亚窗帘轨道厂	厂长：叶似英	地址：中国.福建省.福州市.闽侯县白沙镇长坪园3号
闽侯双益纺织厂	成立日期：2000/8/3	地址：福州市闽侯县南屿镇
福州树人贸易有限公司	总经理：郭桂兰	地址：福州市闽侯县上街镇建平村岐安花园
闽侯鑫源贸易有限公司	成立日期：2012/1/31	地址：福州市闽侯县青口镇吉山新村
尚美(福建)装饰材料有限公司	成立日期：2009/9/1	地址：福州市闽侯县铁岭二期
福州艾?食品有限公司	成立日期：2010/10/1	地址：中国.福建.闽侯县.南屿镇元峰村光华百特工业区1号楼
福州古木工艺品有限公司	总经理：郭树人	地址：福建省福州市闽侯县上街镇建平村
格格堡木制餐具股份有限公司	总经理：张清光	地址：福建省福州市闽侯县厚屿48号 格格堡木制餐具股份有限公司
闽侯东才贸易有限公司	总经理：李文官	地址：福州市闽侯县鸿尾乡官路村
福州泰盛集成家具有限公司	成立日期：2007/5/18	地址：福州闽侯县荆溪镇
闽侯县江口榕江纺织厂	厂长：曾碧朱	地址：中国 福建 闽侯县 闽侯县南屿镇江口村九石17
闽侯县巧工工艺品有限公司	成立日期：2013/5/1	地址：福建省福州市闽侯县建平巧工工艺馆 福建省福州市闽侯市上街建平根雕街
红杉根雕家具厂	厂长：卓传勇	地址：福建省闽侯县上街镇建平村
闽侯县金涛塑胶有限公司	总经理：郑卫	地址：福建省福州市闽侯县南屿镇高岐工业区
福建福特科光电股份有限公司	总经理：黄恒标	地址：福建福州市闽侯县铁岭工业集中区二期7号路8号
闽侯县阿斯顿家居用品有限公司	总经理：雷光彩	地址：闽侯县昙石新村2区15座
闽侯闽水缘运动休闲有限公司	总经理：郭香健	地址：闽侯县荆溪镇绿洲家园C区7041
闽侯联力机械有限公司	总经理：程飞	地址：闽侯县鸿尾乡政府三楼
福州中宝汽车租赁服务有限公司	总经理：郑绍强	地址：闽侯县上街镇厚美村（张秉生）住宅楼一层北向单元
福州鼎盛新型节能建材有限公司	总经理：叶国诚	地址：闽侯县竹岐乡榕东村
福建原动力汽车销售服务有限公司	总经理：王爱艺	地址：闽侯县南屿镇晓岐、元峰村
福建闽侯恒森林业发展有限公司	总经理：李塑龄	地址：闽侯县大湖乡雪峰村天洋13号
闽侯县畲山秀水农业综合开发有限公司	总经理：雷秀花	地址：闽侯县大湖乡六锦畲族村
闽侯县青口佳宝工贸有限公司	总经理：方钦达	地址：闽侯县青口投资区（正道汽车配件（福州）有限公司F栋）
闽侯县闽禾日用品咨询服务部	老板：魏信仙	地址：闽侯县甘蔗世纪芳洲1号乙座607
闽侯县甘蔗岩勘钻探劳务队	队长：林世江	地址：闽侯县甘蔗街道化龙村福龙巷4号
闽侯县大湖长文食用菌种植场	联系人：方长文	地址：闽侯县大湖乡东姚村帮山自然村
闽侯县大湖长久食用菌种植场	联系人：姚良久	地址：闽侯县大湖乡东姚村
闽侯县大湖融南养鳗场	联系人：张功琛	地址：闽侯县大湖乡双溪村下洋
福州中网电子商务有限公司	总经理：吴锦文	地址：福州市闽侯县铁岭工业区一期九号西路6号（福建胜基食品饮料有限公司内）
福州缘源缘商贸有限公司	总经理：林锦武	地址：闽侯县青口镇商贸中心街7#楼9号店
福州赢导电子商务有限公司	总经理：林媚	地址：闽侯县南通镇瓜山村瓜后坝头
福州五龙珊贸易有限公司	总经理：林建明	地址：闽侯县祥谦镇泮洋工业区
福州泰康汽车车厢制造有限公司	总经理：李志刚	地址：闽侯县尚干镇福厦路21公里处
福州盛源电机有限公司	总经理：林贵铃	地址：闽侯县南屿镇元峰村、流洲村（福州光华百特饲料有限公司）6#厂房二层
福州品众农业发展有限公司	总经理：叶雄	地址：闽侯县白沙镇上寨村村委会办公楼
福州君安汽车维修有限公司	总经理：金星建	地址：闽侯县荆溪镇徐家村301号
福州鸿宾贸易有限公司	总经理：洪斌	地址：闽侯县甘蔗街道山前后街3号三福花园1#104店面
福州成茂贸易有限公司	总经理：许坤茂	地址：闽侯县青口镇青口村
福建兆元光电有限公司	总经理：傅佩文	地址：福州市闽侯县南屿镇生物医药和机电产业园区（现住所：闽侯县南屿镇新联村6号）
福州市仓山五金工具厂闽侯县唐举分厂	厂长：严世光	地址：闽侯县白沙镇唐举村
闽侯县白沙生活方式花店	老板：王秀华	地址：闽侯县白沙镇新街47号
福州市古盛工艺制品有限公司	总经理：苏孔飞	地址：闽侯县鸿尾乡古洋村
福州裕龙工艺品有限公司	总经理：黄键	地址：闽侯县鸿尾乡石佛头街179号
闽侯县仙籁缘制衣厂	厂长：陈玉娜	地址：闽侯县南屿镇后山村旗山工业集中区【福州长征珠宝有限公司内1号楼2层】
闽侯县南屿镇徐军鞋店	老板：徐军	地址：闽侯县南屿镇南井村
闽侯县南屿魅力今生美容美体店	老板：张赛琴	地址：闽侯县南屿镇先施农贸市场面街7号
闽侯欣意包装制品有限公司	总经理：吴文杰	地址：闽侯县青口镇前洋工业区
闽侯永盛机械有限公司	总经理：吴世光	地址：闽侯县青口镇前洋工业区
闽侯县上街兴福化妆品店	老板：杨龚妹	地址：闽侯县上街镇国宾大道338号英泰第一城B区商住1#楼521单元
闽侯县闽川机械设备有限公司	总经理：何添喜	地址：闽侯县上街镇上街村
闽侯县上街华盛达鞋面加工厂	厂长：林鼎伟	地址：闽侯县上街镇新峰村杏山45号
闽侯县上街英泰麦田房产中介所	所长：张力军	地址：闽侯县上街镇英泰第一城商住楼K2幢126号
闽侯县上街晟兴药店	老板：陈宗密	地址：闽侯县上街镇源通东路59号尚书耕天下花园2#店面一层13-14
闽侯县上街雅竹化妆品经营部	老板：江少兰	地址：闽侯县上街镇源通东路59号尚书耕天下花园2#楼1003单元
福州市高森交通设施有限公司	总经理：郑家荣	地址：闽侯县祥谦镇枕峰村（福州常兴制冷设备有限公司内)
福建明冉服饰有限公司	总经理：黄香政	地址：闽侯县上街镇沙堤村
福州德源化工有限公司	总经理：芦江平	地址：闽侯县竹岐乡春风村
福州好利多农业开发有限公司	总经理：张胜忠	地址：闽侯县荆溪镇荆溪村
福州魅力频道服饰有限公司	总经理：庄华锋	地址：闽侯县南屿镇五都村
福州佩考林工业有限公司	总经理：高建新	地址：福州市闽侯县青口投资区祥谦镇辅翼村
福州青口水务有限公司	总经理：林一敏	地址：闽侯县祥谦镇凤港村
福州市闽侯福林纸业有限公司	总经理：桂绍林	地址：闽侯县荆溪镇溪下村溪下158号
福州市闽侯利达机械有限公司	总经理：邹秋娥	地址：闽侯县青口镇壶山村陶精路3号“千家花园”
福州市闽侯县敦睦贸易有限公司	总经理：张光煜	地址：福州市闽侯县青口镇宏一村
福州瓦尔节能电器有限公司	总经理：郑尔平	地址：闽侯县鸿尾乡桥头村
福州雄鑫机械技术工程有限公司	总经理：张竹雄	地址：闽侯县祥谦镇洋下村（福州宏业机械有限公司）1#楼
闽侯华润燃气有限公司	总经理：陆泓	地址：闽侯县甘蔗街道昙石山中大道118号新城丽景A区2号楼二层206#、207#店铺
闽侯县恒祥新型墙体材料厂	厂长：黄初平	地址：闽侯县青口镇青林村
闽侯县宏展电装有限公司	总经理：陈子山	地址：闽侯县祥谦镇虎山村龙井8号
闽侯县南屿雷鸣铝合金厂	厂长：张雷鸣	地址：闽侯县南屿镇后山村
闽侯县旺客来宾馆	联系人：肖书忠	地址：闽侯县甘蔗街道军民路12号
闽侯县协宏五金机电有限公司	总经理：陈晓琛	地址：闽侯县青口镇农光村新城路博雅星城
闽侯县源创医药科技有限公司	总经理：邓天力	地址：闽侯县尚干镇浦里村八斗新村46号
闽侯县天绿农家禽畜有限公司	总经理：方国辉	地址：闽侯县竹岐乡蒲洋村
闽侯县苏洋茉莉花专业合作社	联系人：金昌伙	地址：闽侯县竹岐乡苏洋村村委会
闽侯县双燕工艺品厂	厂长：陈燕华	地址：闽侯县甘蔗工业区
闽侯县清谋蔬果专业合作社	联系人：江清谋	地址：闽侯县南屿镇南井村
闽侯县闽建通讯工程有限公司	总经理：余广棋	地址：闽侯县甘蔗镇工业小区一区
闽侯县白沙唐举山农业综合开发有限公司	总经理：陈维汉	地址：闽侯县白沙镇唐举村兜整座
福州市泓晟农牧发展有限公司	总经理：余朝阳	地址：闽侯县洋里乡际兜村上元自然村1-12#厂房
福州福钢贸易有限公司	总经理：曾浚	地址：闽侯县荆溪杜坞火车站综合楼411室
福州方广达贸易有限公司	总经理：方左	地址：闽侯县荆溪杜坞火车站综合楼412室
福建信通卓越房地产有限公司	总经理：林旭	地址：福州市闽侯县南屿镇南井村新桥头（闽侯县南屿搬运站内）
福建省胜威物流有限公司	总经理：陈金刚	地址：闽侯县南通镇陈厝街东35号
福建省康祥贸易有限公司	总经理：陈孙寿	地址：闽侯县荆溪杜坞火车站综合楼410室
福建兆盈投资有限公司	成立日期：2011/8/24	地址：福州市闽侯县南通镇马腾村
福州市中景纺织有限公司	成立日期：2011/8/24	地址：福州市闽侯县南屿镇尧沙村浯江
福州赵记石材有限公司	成立日期：2011/8/23	地址：闽侯县白沙镇汤院村委
福州市闽侯建立复合材料有限公司	成立日期：2011/8/23	地址：闽侯县大湖乡珍山村
闽侯县翰霖彩印有限公司	成立日期：2011/8/23	地址：闽侯县甘蔗街道大元村陈店湖工业集中区9#2层
福州百利源贸易有限公司	成立日期：2011/8/23	地址：闽侯县甘蔗街道街心路32号首邑商业步行街A区1-5#楼03商业用房
福州邑都餐饮管理有限公司	成立日期：2011/8/23	地址：闽侯县甘蔗街道入城路319号东利楼三层
福建福旺木业有限公司	成立日期：2011/8/23	地址：闽侯县甘蔗街道昙石村龙岭
闽侯县天翊家电贸易有限公司	成立日期：2011/8/23	地址：闽侯县甘蔗街道蔗洲路212号
闽侯县横洋农场	成立日期：2011/8/23	地址：闽侯县甘蔗镇横屿村301号
福州市隆力达贸易有限公司	成立日期：2011/8/23	地址：闽侯县甘蔗镇五福村
福建惠好四海医药连锁有限责任公司荆溪卫院分店	成立日期：2011/8/23	地址：闽侯县荆溪关口366号
福州奥斯邦建材有限公司	成立日期：2011/8/23	地址：闽侯县荆溪镇港头村横岐
福州市闽侯达通汽配有限公司	成立日期：2011/8/23	地址：闽侯县荆溪镇关西村
福州顺森汽车配件有限公司	成立日期：2011/8/23	地址：闽侯县青口镇付竹村
福州天福居工艺品有限公司	成立日期：2011/8/23	地址：闽侯县青口镇红旗村新桥外（林步先）自用房整座
福州超宇钢材贸易有限公司	成立日期：2011/8/23	地址：闽侯县青口镇宏二村（闽侯宏丰纸业有限公司）房整座
闽侯县三晟贸易有限公司	成立日期：2011/8/23	地址：闽侯县青口镇青长路建设大厦底层
闽侯县顺发农业合作社	成立日期：2011/8/23	地址：闽侯县青口镇新城商贸街商住6#A303
福建省尚街根艺创意园有限公司	成立日期：2011/8/23	地址：闽侯县上街镇红峰村
福州市闽侯恒博工艺品有限公司	成立日期：2011/8/23	地址：闽侯县洋里乡林洋村林洋23号
福州再友贸易有限公司	成立日期：2011/8/17	地址：福州市闽侯县南通镇陈厝村海峡农副产品物流中心A区4201
福州茂基物业管理有限公司	成立日期：2011/8/17	地址：福州市闽侯县南屿镇旗山集中工业区8号办公楼
福建诚辉农业综合开发有限公司	成立日期：2011/8/16	地址：闽侯县大湖乡墙坪村桥下自然村
闽侯县美尔贸易有限公司	成立日期：2011/8/16	地址：闽侯县甘蔗镇三福小区一路12号
福州盛佳佳茶业有限公司	成立日期：2011/8/16	地址：闽侯县鸿尾乡奎石村牛头山58号
福建千飞建设有限公司	成立日期：2011/8/16	地址：闽侯县鸿尾乡桥头村
闽侯正安生鲜配送有限公司	成立日期：2011/8/16	地址：闽侯县南屿镇南旗村尾顶长盛楼201
福建工大科学技术开发总公司闽侯图书报刊经营部	成立日期：2011/8/16	地址：闽侯县上街镇福建工程学院学生公寓H2楼架空层第6间
福建华欣服装有限公司	总经理：林义利	地址：福建省闽侯县祥谦镇中
闽侯县南屿方敏服装店	老板：方敏	地址：福建省福州市闽侯县闽侯县南屿元峰村
福建省闽侯东南旅游开发有限公司	总经理：张依珠	地址：福建省闽侯县大湖乡梧桐里１号
福州市闽侯县云堡寨旅游开发有限公司	总经理：陈昭强	地址：福建省福州市闽侯县白沙镇林炳村
福建裕达投资有限公司	总经理：邱燕芳	地址：福建省闽侯县青口投资区青口镇船尾村
福建证大予捷矿业投资有限公司	总经理：胡毅	地址：福建省福州市闽侯县大湖乡大湖街５号
福建耀华房地产开发有限公司	总经理：吴增基	地址：闽侯县青口镇青长路建设大厦第四层
福建联丰房地产开发有限公司	总经理：何建华	地址：福建省闽侯县上街英泰第一城商住楼Ｋ－１２９＃１３０＃
福建省闽侯县嘉德房地产开发有限公司	总经理：吴庸	地址：福建省福州市闽侯县荆溪镇港头村
闽侯县昙石山博物馆配套项目和省艺术高等职业学院建设指挥部	老板：张大斌	地址：福建省福州市闽侯县甘蔗镇政府内
院埕公路建设指挥部	老板：余福杨	地址：福建省福州市闽侯县白沙镇院埕村
中国建设银行股份有限公司福州东南汽车城支行	联系人：林榕琦	地址：福建省福州市闽侯县青口镇工贸商住楼
福建省友诚建筑工程有限公司	总经理：林游承	地址：闽侯县荆溪镇荆溪村
福州瀚思远见建筑设计有限公司	总经理：杨洪	地址：闽侯县上街镇新峰村上街商贸中心八号楼04房
福州金嘉利建筑金属配件有限公司	总经理：林国良	地址：福建省福州市闽侯县尚干镇天达电子公司内
福建源素建材有限公司	总经理：王琼	地址：闽侯县南屿镇窗厦村
闽侯县鑫山新型保温建材有限公司	总经理：陈国辉	地址：福建省闽侯县荆溪镇光明村
闽侯县闽港建材有限公司	总经理：林宝国	地址：福建省闽侯县荆溪镇关西村村委会
福州利浩建材有限公司	总经理：黄霞	地址：福建省闽侯县祥谦镇辅翼村
闽侯县华翔建材贸易有限公司	总经理：潘福比	地址：福建省福州市闽侯县甘蔗镇县城新区（甘蔗世纪芳洲１号楼１０５室）
福州祥顺新型建材有限公司	总经理：江祥华	地址：福建省福州市闽侯县白沙镇上寨村
闽侯县金祥建材经营部	老板：洪秀萍	地址：福建省福州市闽侯县甘蔗镇坛石村
闽侯县艾森广告策划部	老板：叶风华	地址：福建省福州市闽侯县甘蔗镇入城路新华书店综合楼３０１号
福建省闽侯华亿纺织工贸有限公司	总经理：宋建伟	地址：福建省福州市闽侯县南屿镇旗山工业集中区
闽侯县明鑫工贸有限公司	总经理：马新明	地址：福建省福州市闽侯县白沙镇汶溪村
闽侯县金全丰工贸有限公司	总经理：林金水	地址：福建省福州市闽侯县青口镇吉山新村Ｃ幢１１号
福建省闽侯县艺丰工艺品有限公司	总经理：林伟义	地址：闽侯县竹岐乡春风村
福建省闽侯兆丰工艺品有限公司	总经理：林光禹	地址：闽侯县荆溪镇永丰工业小区
闽侯国盛工艺品公司	总经理：胡晶晶	地址：福建省闽侯县横屿376
闽侯县福诚工艺品厂	厂长：程道利	地址：福建省闽侯县甘蔗陈店湖工业区
闽侯县闽涛工艺品加工厂	厂长：江阳涛	地址：福建省闽侯县白沙镇下浦路５３号
闽侯县中津工艺品加工厂	厂长：肖瑜	地址：福建省闽侯县白沙镇溪头村张厝里
闽侯县余盛工艺品厂	厂长：余谋钢	地址：福建省闽侯县白沙镇溪头村可河38号后面
福州亿宝工艺品有限公司	总经理：李东宝	地址：闽侯县鸿尾乡官路村
福州福田艺城工艺品有限公司	总经理：杨大院	地址：福建省闽侯县小箬乡福田村２２号
福州明富工艺品有限公司	总经理：李德明	地址：福建省闽侯县鸿尾乡石佛头街
福州闽鹰工艺品有限公司	总经理：张章鹰	地址：福建省闽侯县鸿尾乡石
福州华谊工艺品有限公司	总经理：徐诗榕	地址：福建省闽侯县甘蔗街道工业区
福州赛得家居工艺品有限公司	总经理：程升	地址：福建省闽侯县甘蔗街道陈店湖工业区
福州荣煌工艺品有限公司	总经理：郑仕光	地址：福建省福州市闽侯县青口镇前街村委会楼上
闽侯县艺辉工艺品厂	厂长：张兴锋	地址：福建省福州市闽侯县荆溪镇厚屿村桐溪
闽侯县鸿尾工艺品经营部	老板：曾祯宝	地址：福建省福州市闽侯县鸿尾乡超?村１２１号
闽侯县方舟工艺品有限公司	总经理：叶小舟	地址：福建省福州市闽侯县甘蔗墩园洲５３号
闽侯县古林工艺品厂	厂长：吴宝如	地址：福建省福州市闽侯县白沙镇上寨村
福建省闽侯县益丰源工艺品有限公司(国内业务部)	联系人：唐加军	地址：福建省闽侯县福州市荆溪镇西门外厚屿187号
闽侯县达克工艺品有限公司	总经理：林再?	地址：福建省福州市闽侯县荆溪镇关口村
闽侯县福丰工艺品加工厂	厂长：林廷晃	地址：福建省福州市闽侯县荆溪厚屿村２７号
福州蓝枫工艺品有限公司	总经理：林成武	地址：福建省福州市闽侯县尚干镇福厦路西侧２１．６公里处
福州闽信木业工艺品有限公司	总经理：江仕清	地址：福建省福州市闽侯县南屿镇高岐工业区
闽侯县森联工艺品厂	厂长：黄香旺	地址：福建省福州市闽侯县竹岐乡榕西村（３１６国道边）
福州鸿桥工艺品有限公司	总经理：黄善焕	地址：福建省福州市闽侯县鸿尾乡大模村洋中１３９号
福州联星工艺品有限公司	总经理：黄恒松	地址：福建省福州市闽侯县甘蔗镇长江村
闽侯县怡佳工艺品有限公司	总经理：黄恒光	地址：福建省福州市闽侯县荆溪镇桐口村３２号
闽侯县溪元家传工艺品厂	厂长：池家传	地址：福建省福州市闽侯县鸿尾乡溪源村３６号
福州福津工艺品有限公司	总经理：程道柱	地址：福建省福州市闽侯县甘蔗镇陈店湖工业区
福州禄艺雕刻工艺品有限公司	总经理：陈遵禄	地址：福建省福州市闽侯县上街镇新峰村
福建省闽侯县零点工艺品有限公司	总经理：陈辅群	地址：福建省福州市闽侯县甘蔗镇陈店湖工业区９号楼
闽侯县兴诚工艺品有限公司	总经理：陈辅端	地址：福建省福州市闽侯县甘蔗工业区
闽侯县腾祥塑料包装品有限公司	总经理：陈锦瑞	地址：福建省闽侯县青口投资区汽配城８号楼
福州翔腾塑料科技开发有限公司	总经理：何建明	地址：福建省福州市闽侯县荆溪镇永丰村
闽侯县上街海狮咨询服务部	老板：赵志强	地址：福建省福州市闽侯县上街镇沙堤村中洲８号
福建省闽侯县点石建筑工程咨询工作室	联系人：曾晓琴	地址：福建省福州市闽侯县荆溪镇绿洲家园Ｂ区Ｃ２３
福建永惠医药连锁有限公司第十五分店	老板：赵燕燕	地址：福建省福州市闽侯县尚干镇洋中村祥谦路１５３号
福建省宜又佳医药连锁有限公司第二十分店	老板：林威	地址：福建省福州市闽侯县尚干镇洋中村祥谦路１５６号
柏源（福建）化工有限公司	总经理：翁加兴	地址：福建省福州市闽侯县上街镇工贸路
闽侯县建达日用化工厂	厂长：陈学忠	地址：福建省福州市闽侯县荆溪镇关东村
福州力业化工有限公司	总经理：陈继顺	地址：福建省福州市闽侯县白沙镇汶溪２号
闽侯县山水制衣厂	厂长：程秀玉	地址：福建省福州市闽侯县甘蔗镇交通路５４号
闽侯县亿兴五金机械贸易有限公司	总经理：叶学桂	地址：福建省闽侯县青口镇船尾村后门兜小区
闽侯县华兴机械厂	厂长：张先生	地址：福州福建省福州市闽侯县祥谦镇枕峰工业区华兴机械厂
福州福龙膜科技开发有限公司	总经理：张群华	地址：福州福州市闽侯县南屿镇后山工业集中区
福建省闽侯鑫榕新纸业有限公司	总经理：林经理	地址：福建省福州闽侯县竹岐乡南洋工业区
闽侯县福通土工材料厂	厂长：洪海峰	地址：福州闽侯闽侯县甘蔗镇铁岭5号
福州钧泽景观工程有限公司	总经理：许先生	地址：福州福州市闽侯县上街镇文贤路1号
福建榕泰达信息技术服务有限公司	总经理：陈小姐	地址：福州市闽侯县尚干镇榕泰汽车销售有限公司良安路20号
福州祥谦龙泰家具厂	厂长：陈烨	地址：福建省福州市闽侯县祥谦陵园旁龙泰工业区
福州方圆电机有限公司	总经理：陈剑平	地址：中国 福建 闽侯县 闽侯县铁岭集中工业区二期
福州市鼓楼区柏雅工艺品有限公司	总经理：程章瑛	地址：中国 福建 闽侯县 甘蔗镇甘洲园工业区
福州富坤工艺品有限公司	总经理：林明月	地址：中国 福建 闽侯县 甘蔗陈店湖工业区
福州龙楼阁木业有限公司	总经理：郑顺源	地址：福建福州闽侯县荆溪工业园18号
福州锐新金属有限公司	总经理：陈光枝	地址：中国 福建 闽侯县 青口投资区消防二中队旁（东南汽车城内）
闽侯县堂辰机电有限公司	总经理：陈铮	地址：中国 福建 闽侯县 福建福州闽侯县甘蔗街道悬石村218号
福州鹏达金属材料有限公司	总经理：陈爱珠	地址：中国 福建 闽侯县 福州市闽侯县甘蔗陈店湖工业小区
福州市闽侯县富恒粉末冶金有限公司	总经理：陈勇枫	地址：中国 福建 闽侯县 福州市闽侯县甘蔗墩园洲工业区
福州峰祥野营用品有限公司	总经理：林沣	地址：中国 福建 闽侯县 福建省福州市闽候县祥谦镇凤港村
闽侯县鸿超家居制造有限公司	总经理：洪海鸿	地址：中国 福建 闽侯县 福州市闽侯县白沙镇长坪园福商路鸿超家居
闽侯县屋语家具有限公司	总经理：钟宙明	地址：中国 福建 福州市 福建省福州市闽侯县甘蔗镇143号
澳韵门业有限公司	总经理：郑顺源	地址：福建省福州市闽侯县荆溪镇古山洲工业园18号
福州银色魅力商铺	null	地址：中国 福建 福州市 福建省闽侯县
闽侯县永胜建材厂	厂长：黄香访	地址：中国 福建 福州市 闽侯县荆溪镇永丰村
美家居装修设计工程公司	null	地址：中国 福建 福州市 闽侯县甘蔗镇街心路
闽侯县得利药店	null	地址：中国 福建 福州市 闽侯县廷坪乡政府
福州黄氏药业有限公司物流部	null	地址：中国 福建 福州市 闽侯县荆溪镇光明村上沙68号
陈自和(个体经营）	null	地址：中国 福建 福州市 福建省福州市闽侯县上街镇马保石沙新村8幢610
绿源竹工艺厂	null	地址：中国 福建 福州市 福州市闽侯县上街镇溪源村
福建省闽侯展发橡塑制品有限公司	总经理：张正求	地址：中国 福建 福州市 福建省闽侯县白沙镇下浦路55号
四元贸易公司	null	地址：中国 福建 福州市 闽侯县上街镇侯官村101号
许贤浪（个人）	null	地址：中国 福建 福州市 福州闽侯县上街镇工贸路
福州白丸子公司	null	地址：中国 福建 福州市 福建省福州闽侯县埔前村90号
闽侯县城关供销社食品蜜饯厂	null	地址：中国 福建 福州市 福建省闽侯县甘蔗镇三英村环城路26号
闽侯县职工物价监督总站	站长：林华霖	地址：福建省福州市闽侯县甘蔗镇街心路
闽侯县增辉管线安装有限公司	总经理：张增辉	地址：福建省福州市闽侯县尚干镇红新村
闽侯县运输集团公司南通分公司	总经理：张寿平	地址：福建省福州市闽侯县南通镇南通街
闽侯县邮电多种经营部	null	地址：福建省福州市闽侯县甘蔗镇街心路１４２号
闽侯县永丰工艺精品有限公司	总经理：金恩煌	地址：中国 福建 福州市 闽侯县荆溪镇永丰工业区
闽侯县益农农技推广经营部	老板：陈训彬	地址：福建省福州市闽侯县甘蔗镇八一八东路统战部楼下
闽侯县益民除四害服务部	老板：陈金蕊	地址：福建省福州市闽侯县甘蔗镇街心路２２号
闽侯县艺术木器加工场G	null	地址：福建省福州市闽侯县南通银安村
闽侯县医学会	null	地址：福建省福州市闽侯县甘蔗镇街心路22号
闽侯县耀华建筑有限公司	null	地址：福建省福州市闽侯县青口镇工业路
闽侯县洋里忠历食杂店	null	地址：福建省福州市闽侯县洋里乡洋里村
闽侯县洋里玉华食杂店	null	地址：福建省福州市闽侯县洋里乡洋里街
闽侯县洋里迎德养殖场	null	地址：福建省福州市闽侯县洋里乡洋头村
闽侯县洋里秀钦日杂店	null	地址：福建省福州市闽侯县洋里乡市场
闽侯县洋里兴业装修建材制品厂	null	地址：福建省福州市闽侯县洋里乡安仁村
闽侯县洋里欣连食什店	null	地址：福建省福州市闽侯县洋里乡洋里村
闽侯县洋里小箬必贵毛笔加工场	null	地址：福建省福州市闽侯县洋里乡小箬村
闽侯县洋里乡洋里村谢玉梅食杂店	null	地址：福建省福州市闽侯县洋里乡洋里村
闽侯县洋里乡刘地村经济合作管理委员会	联系人：魏智铿	地址：福建省福州市闽侯县洋里乡刘地村
闽侯县洋里乡岭兜村经济合作管理委员会	联系人：江作明	地址：福建省福州市闽侯县洋里乡岭兜村
闽侯县洋里乡林洋村经济合作管理委员会	联系人：张孟森	地址：福建省福州市闽侯县洋里乡林洋村
闽侯县洋里乡花兰食杂店	null	地址：福建省福州市闽侯县洋里乡洋里村
闽侯县洋里乡法律服务所	null	地址：福建省福州市闽侯县洋里乡
闽侯县洋里乡春萌食杂店	null	地址：福建省福州市闽侯县洋里乡洋里街
闽侯县洋里乡长基村经济合作管理委员会	null	地址：福建省福州市闽侯县洋里乡长基村
闽侯县洋里梧英食什店	null	地址：福建省福州市闽侯县洋里乡花桥村80号
闽侯县洋里维如食杂店	null	地址：福建省福州市闽侯县洋里花桥街
闽侯县洋里王氏文化电子经营部G	null	地址：福建省福州市闽侯县洋里乡花桥街86号
闽侯县洋里淑珍食杂店	null	地址：福建省福州市闽侯县洋里乡绅带桥前街
闽侯县洋里榕妹食杂店	null	地址：福建省福州市闽侯县洋里乡
闽侯县洋里榕华钻探劳务队	队长：林世钦	地址：福建省福州市闽侯县洋里乡后坑村
闽侯县洋里粮食管理站	null	地址：福建省福州市闽侯县洋里乡绅带村
闽侯县洋里金河建材综合场	null	地址：福建省福州市闽侯县洋里乡小若村
闽侯县洋里花桥英华食杂店	null	地址：福建省福州市闽侯县洋里乡花桥村
闽侯县洋里桂花食杂店	null	地址：福建省福州市闽侯县洋里乡绅带村
闽侯县洋里安仁金蹀钻探劳务队G	null	地址：福建省福州市闽侯县洋里乡安仁村
闽侯县烟草公司南通经营部	null	地址：福建省福州市闽侯县南通镇
闽侯县星光五金冷作加工厂	厂长：吴星光	地址：福建省福州市闽侯县青口镇吉山村
闽侯县兴隆食杂店	null	地址：福建省福州市闽侯县荆溪镇徐家村长
闽侯县信达信息中介服务有限公司	null	地址：福建省福州市闽侯县甘蔗镇入城路
闽侯县新鑫苦味果蔬有限公司	总经理：张大鹏	地址：福建省福州市闽侯县洋里乡新见村
闽侯县新天地娱乐城	null	地址：福建省福州市闽侯县上街镇红峰村
闽侯县新岐运输站	null	地址：福建省福州市闽侯县南通镇新岐村东２号
闽侯县新锦达电子贸易有限公司	null	地址：福建省福州市闽侯县洋里乡安仁村61号
闽侯县小箬乡小箬村经济合作管理委员会	null	地址：福建省福州市闽侯县小箬乡小箬村
闽侯县小箬乡西村村经济合作社	联系人：林允锋	地址：福建省福州市闽侯县小箬乡西村
闽侯县小箬乡社会事务办公室	null	地址：福建省福州市闽侯县小箬乡人民政府内
闽侯县小箬乡企业管理站	null	地址：福建省福州市闽侯县小箬乡政府内
闽侯县小箬乡橄榄场	联系人：林修淡	地址：福建省福州市闽侯县小箬乡小箬村
闽侯县小箬农村合作基金会	null	地址：福建省福州市闽侯县洋里乡小箬村
闽侯县小箬临江建材场	联系人：陈世武	地址：福建省福州市闽侯县小箬乡小箬村
闽侯县小箬粮食管理站	null	地址：福建省福州市闽侯县小箬乡
闽侯县小箬建乡工作筹备小组	null	地址：福建省福州市闽侯县小箬乡
闽侯县祥谦镇中院村经济合作社	null	地址：福建省福州市闽侯县祥谦镇中院村
闽侯县祥谦镇枕峰村经济合作管理委员会	联系人：林木亮	地址：福建省福州市闽侯县祥谦镇枕峰村
闽侯县祥谦镇友谊微机配件厂	null	地址：福建省福州市闽侯县祥谦镇泮洋村
闽侯县祥谦镇肖家道村经济合作社管理委员会	null	地址：福建省福州市闽侯县祥谦镇肖家道村
闽侯县祥谦镇双龙村龙山村民小组	联系人：林兆光	地址：福建省福州市闽侯县祥谦镇双龙村
闽侯县祥谦镇社会治安综合治理委员会办公室	null	地址：福建省福州市闽侯县祥谦镇
闽侯县祥谦镇岐尾村经济合作社	null	地址：福建省福州市闽侯县祥谦镇岐尾村
闽侯县祥谦镇农业机械管理站	站长：林祥东	地址：福建省福州市闽侯县祥谦镇政府
闽侯县祥谦镇兰圃村经济合作社	null	地址：福建省福州市闽侯县祥谦镇兰圃村
闽侯县祥谦镇江中村合作基金会	null	地址：福建省福州市闽侯县祥谦镇江中村
闽侯县祥谦镇红南竹木转站	null	地址：福建省福州市闽侯县祥谦镇枕峰村红南联队公路边
闽侯县祥谦镇法律服务所（闽侯县祥谦镇司法办）	null	地址：福建省福州市闽侯县祥谦镇泮洋村
闽侯县祥谦镇船舶管理站	站长：林品忠	地址：福建省福州市闽侯县祥谦镇
闽侯县祥谦镇爱国石料场	null	地址：福建省福州市闽侯县祥谦镇枕峰村
闽侯县祥谦枕峰装璜材料厂	null	地址：福建省福州市闽侯县祥谦镇枕峰村
闽侯县祥谦运输公司	总经理：林悯	地址：福建省福州市闽侯县祥谦镇大桥边
闽侯县祥谦洋下村经济合作社	null	地址：福建省福州市闽侯县祥谦镇洋下村
闽侯县祥谦新晨塑料袋加工厂	厂长：林增福	地址：福建省福州市闽侯县祥谦镇兰布村坊兜５２号
闽侯县祥谦榕中养殖场	联系人：陈春乐	地址：福建省福州市闽侯县祥谦镇中院岐头村
闽侯县祥谦榕祥钻井队G	null	地址：福建省福州市闽侯县祥谦镇洋下村企头顶42号
闽侯县祥谦榕贸燃料站Ｇ	null	地址：福建省福州市闽侯县祥谦镇中院村
闽侯县祥谦仁辉纸巾厂	厂长：黄宝仁	地址：福建省福州市闽侯县祥谦镇官前村
闽侯县祥谦培浩石料场	联系人：陈培浩	地址：福建省福州市闽侯县祥谦镇中院村
闽侯县祥谦明鑫茶果经营部	null	地址：福建省福州市闽侯县祥谦镇洋下村
闽侯县祥谦闽丰予制品加工场	null	地址：福建省福州市闽侯县祥谦镇凤港村
闽侯县祥谦龙祥钻井队G	null	地址：福建省福州市闽侯县祥谦枕峰红兰林钦饭店
闽侯县祥谦龙轻工有限公司	null	地址：福建省福州市闽侯县竹岐乡白龙月半山
闽侯县祥谦兰布木榕食杂店	null	地址：福建省福州市闽侯县祥谦镇兰布村
闽侯县祥谦合作总店青口第三门市部	null	地址：福建省福州市闽侯县祥谦镇青口镇
闽侯县祥谦福贵沙场	null	地址：福建省福州市闽侯县祥谦镇公路段
闽侯县祥谦凤港钢锉厂	null	地址：福建省福州市闽侯县祥谦镇凤港村
闽侯县祥谦宝富沙场	null	地址：福建省福州市闽侯县祥谦镇
闽侯县乡镇企业管理局	null	地址：福建省福州市闽侯县甘蔗镇甘洲路１９８号
闽侯县乡镇企业产品质量检验所	null	地址：福建省福州市闽侯县甘蔗镇交通路２号
闽侯县峡南贤养油流量计维修站G	null	地址：福建省福州市闽侯县闽江乡峡南村道头76号
闽侯县峡南承舟日杂店	null	地址：福建省福州市闽侯县闽江乡峡南村马山尾11号
闽侯县溪坪水库建设指挥部	老板：张开国	地址：福建省福州市闽侯县甘蔗镇八一八西路５８号
闽侯县物资局	null	地址：福建省福州市闽侯县甘蔗镇街心路
闽侯县物资公司尚干供应站	null	地址：福建省福州市闽侯县尚干镇桥头迎宾楼一层
闽侯县物价检查所	所长：刘义勇	地址：福建省福州市闽侯县甘蔗镇交通路２号
闽侯县五溪淡水养殖场	null	地址：福建省福州市闽侯县南屿镇五都村
闽侯县卫生保健服务中心	null	地址：福建省福州市闽侯县甘蔗镇街心路２２号
闽侯县旺达再生胶厂	null	地址：福建省福州市闽侯县上街镇侯官村
闽侯县外商投资企业联谊会	null	地址：福建省福州市闽侯县甘蔗镇交通路２号
闽侯县土地开发征用事务部	null	地址：福建省福州市闽侯县甘蔗镇交通路１号
闽侯县土地管理局洋里土地管理所	所长：詹万灿	地址：福建省福州市闽侯县洋里乡
闽侯县土地管理局小箬土地管理所	null	地址：福建省福州市闽侯县小箬乡
闽侯县闽江友联喷油泵维修店	老板：林容华	地址：福建省福州市闽侯县闽江乡峡南村
闽侯县闽江兴星渔农机械厂	null	地址：福建省福州市闽侯县闽江乡峡南兴星村９９号
闽侯县闽江乡渔轮第十五队	null	地址：福建省福州市闽侯县闽江乡公婆村４０号
闽侯县闽江乡渔轮第八队	null	地址：福建省福州市闽侯县闽江乡公婆村４０号
闽侯县闽江粮食管理站	null	地址：福建省福州市闽侯县闽江乡峡南村道头８６号
闽侯县闽江联运站	null	地址：福建省福州市闽侯县闽江乡峡南村
闽侯县闽江可仁食杂综合店	null	地址：福建省福州市闽侯县闽江乡峡南村道头1号
闽侯县闽江酱奇厂	null	地址：福建省福州市闽侯县闽江乡峡南村
闽侯县闽江富兴渔网加工店	null	地址：福建省福州市闽侯县闽江乡红旗村
闽侯县闽江第十二生产队	null	地址：福建省福州市闽侯县闽江乡胜利村
闽侯县闽达木材加工有限公司	总经理：张秋海	地址：福建省福州市闽侯县闽江乡峡南村
闽侯县茂税打铁店G	null	地址：福建省福州市闽侯县甘蔗镇校园路22号
闽侯县马保农业综合开发示范场	null	地址：福建省福州市闽侯县上街镇马保村
闽侯县绿洋农牧业开发综合场	联系人：季高雪	地址：福建省福州市闽侯县洋里乡刘洋村
闽侯县旅游开发公司经营部	null	地址：福建省福州市闽侯县甘蔗镇街心路204号
闽侯县隆盛贸易经营部	老板：杨丽珍	地址：福建省福州市闽侯县甘蔗镇城关８１８西路１３０号
闽侯县联谊家用电器店G	null	地址：福建省福州市闽侯县上街镇街道
闽侯县立书汽车蓬垫加工店	老板：林立书	地址：福建省福州市闽侯县甘蔗镇甘洲路
闽侯县兰全食杂店	null	地址：福建省福州市闽侯县南通镇文山村
闽侯县抗旱服务队	null	地址：福建省福州市闽侯县甘蔗镇交通路2号
闽侯县康福保健品特艺厂	null	地址：福建省福州市闽侯县南通镇马腾村
闽侯县军械库－龙山桥交通战备公路建设指挥部	老板：程道龙	地址：福建省福州市闽侯县甘蔗镇交通路２号
闽侯县荆溪芝元机械加工厂	厂长：高芝元	地址：福建省福州市闽侯县荆溪镇永丰文山里
闽侯县荆溪镇植物医院	院长：张宝金	地址：福建省福州市闽侯县荆溪镇徐家村
闽侯县荆溪镇永丰村合作经济管理委员会	联系人：罗发锦	地址：福建省福州市闽侯县荆溪镇永丰村
闽侯县荆溪镇永丰村合作基金会	null	地址：福建省福州市闽侯县荆溪镇永丰村亭下17号
闽侯县荆溪镇荆溪村合作基金会	null	地址：福建省福州市闽侯县荆溪镇荆溪村
闽侯县荆溪镇厚屿村合作经济管理委员会	联系人：林廷谷	地址：福建省福州市闽侯县荆溪镇厚屿村
闽侯县荆溪镇关口村合作经济管理委员会	联系人：王寿林	地址：福建省福州市闽侯县荆溪镇关口村
闽侯县荆溪镇港头景端养殖场	null	地址：福建省福州市闽侯县荆溪镇港头村
闽侯县荆溪镇丁钦修理店	null	地址：福建省福州市闽侯县荆溪镇徐家村
闽侯县荆溪勇飞地板木加工场	null	地址：福建省福州市闽侯县荆溪镇徐家村
闽侯县荆溪永荣五金加工店	老板：郭泳荣	地址：福建省福州市闽侯县荆溪镇永丰村文山里３号
闽侯县荆溪英玉卫生纸加工户	联系人：徐英玉	地址：福建省福州市闽侯县荆溪镇徐家村
闽侯县荆溪小晴修理店	null	地址：福建省福州市闽侯县荆溪镇光明村
闽侯县荆溪溪下第二养殖场	null	地址：福建省福州市闽侯县荆溪溪下村
闽侯县荆溪顺利汽车教练所	所长：陈辉	地址：福建省福州市闽侯县荆溪镇光明村新东１１号
闽侯县荆溪世桐沙石只场	联系人：陈世桐	地址：福建省福州市闽侯县荆溪镇永丰村浦口７号
闽侯县荆溪生官汽车修理场	联系人：吴生官	地址：福建省福州市闽侯县荆溪镇徐家村
闽侯县荆溪榕林木材加工厂	厂长：江发兴	地址：福建省福州市闽侯县荆溪镇古山洲村
闽侯县荆溪勤弟食杂店G	null	地址：福建省福州市闽侯县荆溪镇徐家村68号
闽侯县荆溪启旭壳灰加工场	null	地址：福建省福州市闽侯县荆溪镇洽浦村
闽侯县荆溪明前修理店	null	地址：福建省福州市闽侯县荆溪镇徐家村23号
闽侯县荆溪美燕水暖配件店	null	地址：福建省福州市闽侯县荆溪镇厚屿村
闽侯县荆溪梅煊加油店	老板：林梅煊	地址：福建省福州市闽侯县荆溪镇永丰村文山里４２号
闽侯县荆溪粮食管理站	null	地址：福建省福州市闽侯县荆溪镇坛石村319号
闽侯县荆溪连官农机配件店	null	地址：福建省福州市闽侯县荆溪镇徐家村
闽侯县荆溪凯旋木箱厂	null	地址：福建省福州市闽侯县荆溪镇光旺村
闽侯县荆溪锦春扁铁加工场	null	地址：福建省福州市闽侯县荆溪镇永丰村浦口1号
闽侯县荆溪洪坚修理店	null	地址：福建省福州市闽侯县荆溪镇坛石村
闽侯县荆溪何忠食杂店	null	地址：福建省福州市闽侯县荆溪镇古山洲
闽侯县荆溪合作总店荆溪第四门市部	null	地址：福建省福州市闽侯县荆溪镇徐家村
闽侯县荆溪合作总店关口门市部	null	地址：福建省福州市闽侯县荆溪镇关口村
闽侯县荆溪合作总店港头旱头门市部	null	地址：福建省福州市闽侯县荆溪镇光明村
闽侯县荆溪合作总店第二门市部	null	地址：福建省福州市闽侯县荆溪镇徐家村124号
闽侯县荆溪国荣汽车挡风玻璃安装店	null	地址：福建省福州市闽侯县荆溪镇坛石村325号
闽侯县荆溪观雄水泥店	null	地址：福建省福州市闽侯县荆溪镇厚屿村
闽侯县荆溪关中竹草制品厂	null	地址：福建省福州市闽侯县荆溪镇关中村白石洋
闽侯县荆溪古山洲汽车修理店	null	地址：福建省福州市闽侯县荆溪镇光明村下沙23号
闽侯县荆溪古山洲漆器实验厂	null	地址：福建省福州市闽侯县荆溪镇古山洲村
闽侯县荆溪丰盛蔬菜加工场	null	地址：福建省福州市闽侯县荆溪镇坛石村31号
闽侯县荆溪本凯日杂店	null	地址：福建省福州市闽侯县荆溪镇徐家村
闽侯县经济局	null	地址：福建省福州市闽侯县甘蔗镇交通路2号
闽侯县京闽建材有限公司	null	地址：福建省福州市闽侯县荆溪镇永丰村文山里
闽侯县金球翻砂场G	null	地址：福建省福州市闽侯县上街美岐村
闽侯县教育学会	联系人：梁王圭胜	地址：福建省福州市闽侯县甘蔗镇交通路６０号
闽侯县交通战备领导小组	联系人：陈文波	地址：福建省福州市闽侯县交通局内
闽侯县交通运输管理所	null	地址：福建省福州市闽侯县甘蔗镇交通路２号
闽侯县酱?厂荆溪批发部	null	地址：福建省福州市闽侯县荆溪镇白头村
闽侯县江口腾飞鞋材有限公司	null	地址：福建省福州市闽侯县南屿镇江口村过透93号
闽侯县江口染织一厂	null	地址：福建省福州市闽侯县南屿镇江口村
闽侯县江口明华棉毛厂	null	地址：福建省福州市闽侯县南屿镇江口村
闽侯县江口棉纺织五厂	厂长：宋立桦	地址：中国 福建 福州市 闽侯县南屿镇江口村
闽侯县江口凯旋织布	null	地址：福建省福州市闽侯县南屿镇江口村
闽侯县江口过偷纺织一厂	null	地址：福建省福州市闽侯县南屿镇江口村过透
闽侯县江口福星纺织有限公司	null	地址：福建省福州市闽侯县南屿镇江口村九石
闽侯县建筑材料公司购销站	null	地址：福建省福州市闽侯县青口镇青口路
闽侯县建行职工技术协作委员会服务部	老板：林兆惠	地址：福建省福州市闽侯县八一八西路１２８号
闽侯县价格事务所	null	地址：福建省福州市闽侯县甘蔗镇入城路
闽侯县家家乐酒酿饮品厂	厂长：顾鹤年	地址：福建省福州市闽侯县甘蔗镇横屿村３１２号
闽侯县计划局	null	地址：福建省福州市闽侯县甘蔗镇交通路２号
闽侯县环境秩序综合整治指挥部	老板：潘革生	地址：福建省福州市闽侯县甘蔗镇闽侯宾馆
闽侯县华英教育装备中心	联系人：叶青	地址：福建省福州市闽侯县甘蔗镇校园路３７号
闽侯县华泰建材有限公司	null	地址：福建省福州市闽侯县上街镇商业街5号
闽侯县华盛特艺厂	null	地址：福建省福州市闽侯县荆溪镇永丰村
闽侯县厚屿自力脱胎漆器厂	null	地址：福建省福州市闽侯县荆溪镇厚屿村184-1号
闽侯县侯官运输站石只场	null	地址：福建省福州市闽侯县上街镇侯官村7号
闽侯县鸿尾运输站	null	地址：福建省福州市闽侯县鸿尾乡原口村
闽侯县鸿尾玉芳灶具店	null	地址：福建省福州市闽侯县鸿尾乡石佛头街
闽侯县鸿尾星峰竹编厂	null	地址：福建省福州市闽侯县鸿尾乡石佛头街66号
闽侯县鸿尾兴华竹编厂	null	地址：福建省福州市闽侯县鸿尾乡石佛头街112号
闽侯县鸿尾乡溪元村柑桔场	null	地址：福建省福州市闽侯县鸿尾乡溪元村
闽侯县鸿尾乡蔬菜办	null	地址：福建省福州市闽侯县鸿尾乡石佛头街
闽侯县鸿尾乡石溪线道路建设指挥部	老板：金清峰	地址：福建省福州市闽侯县鸿尾乡人民政府院内
闽侯县鸿尾乡桥头村实验果场	联系人：郑尔平	地址：福建省福州市闽侯县鸿尾乡桥头村
闽侯县鸿尾乡农业机械管理站	站长：石王湘	地址：福建省福州市闽侯县鸿尾乡鸿尾街
闽侯县鸿尾乡农村合作基金会	联系人：李述通	地址：福建省福州市闽侯县鸿尾乡石佛头街
闽侯县鸿尾乡离退休干部活动中心	null	地址：福建省福州市闽侯县鸿尾乡石佛头街
闽侯县鸿尾乡法律服务所	所长：李道根	地址：福建省福州市闽侯县鸿尾乡
闽侯县鸿尾乡榜上柑桔场	null	地址：福建省福州市闽侯县鸿尾乡榜上村
闽侯县上街供销社蔗州购销处	联系人：林仕华	地址：福建省福州市闽侯县上街镇蔗州村
闽侯县上街供销社新洲购销处	联系人：林仕华	地址：福建省福州市闽侯县上街镇新洲村
闽侯县南屿供销社五交化门市部	老板：陈士平	地址：福建省福州市闽侯县南屿镇南屿街
闽侯县上街供销社建平购销处	联系人：林仕华	地址：福建省福州市闽侯县上街镇建平村
闽侯县大湖供销社坂头购销处	联系人：姚心旗	地址：福建省福州市闽侯县大湖乡坂头村
闽侯县鸿尾供销社竹编草织厂	null	地址：福建省福州市闽侯县鸿尾乡石佛头街
福建省闽侯县南屿供销社针纺联营厂	null	地址：福建省福州市闽侯县南屿镇江口村
闽侯县大湖供销社江洋生产资料	联系人：姚心旗	地址：福建省福州市闽侯县大湖乡江洋村
闽侯县上街供销社新峰商场	null	地址：福建省福州市闽侯县上街镇新峰村
闽侯县洋里供销社安仁购销处	联系人：江本淦	地址：福建省福州市闽侯县洋里乡安仁村
闽侯县南屿供销社双龙购销处	联系人：陈超凡	地址：福建省福州市闽侯县南屿镇双龙村
闽侯县南屿供销社江口购销处	联系人：徐碧金	地址：福建省福州市闽侯县南屿镇江口村
闽侯县上街供销社侯官购销处	联系人：林仕华	地址：福建省福州市闽侯县上街镇侯官村
闽侯县洋里供销社岭兜购销处	联系人：江本淦	地址：福建省福州市闽侯县洋里乡岭兜村
闽侯县上街供销社酱　厂	null	地址：福建省福州市闽侯县上街镇侯官村
中国邮电工会闽侯县电信局委员会	联系人：杨德权	地址：福建省福州市闽侯县甘蔗镇街心路１４２号
闽侯县电信局职工技协服务部	老板：杨德权	地址：福建省福州市闽侯县甘蔗镇街心路１４２号
福建移动通信有限责任公司闽侯分公司	总经理：吴屹飚	地址：福建省福州市闽侯县甘蔗镇入城路中段　　负责人：吴屹飚
闽侯县医药公司新药特药门市部	老板：洪茂滔	地址：福建省福州市闽侯县甘蔗镇入城路６９号
福建省闽侯县烟草公司青口批发部	老板：何宗炳	地址：福建省福州市闽侯县青口镇青口村
闽侯县医药公司第二门市部	老板：叶龙泉	地址：福建省福州市闽侯县甘蔗镇甘洲路３１号
闽侯县医药公司工会委员会	联系人：唐国光	地址：福建省福州市闽侯县甘蔗镇街心路６３号
闽侯县竹岐乡林飞厨房用具店G	null	地址：福建省福州市闽侯县竹岐乡竹岐街116号
闽侯县祥谦永进鸡场	null	地址：福建省福州市闽侯县祥谦镇卜洲村富沙
闽侯县辉发水产养殖有限公司	null	地址：福建省福州市闽侯县荆溪镇溪下村
闽侯县青口明东养猪场	null	地址：福建省福州市闽侯县青口镇村里村浦尾
闽侯县梅溪第七养猪场	null	地址：福建省福州市闽侯县青口镇梅溪村
闽侯县南旗顺德畜牧水产养殖场	null	地址：福建省福州市闽侯县南屿镇南旗村水西
闽侯县荆溪祥秀养猪场	联系人：梁祥秀	地址：福建省福州市闽侯县荆溪镇永丰村
闽侯县生猪定点屠宰联合执法队	队长：肖祖锦	地址：福建省福州市闽侯县甘蔗镇街心路１００号
闽侯县洋里乡茶场农业组	联系人：吴华彬	地址：福建省福州市闽侯县洋里乡坪古洋
福建省闽侯县闽江渔业有限公司	null	地址：福建省福州市闽侯县闽江乡峡南
闽侯县南屿茗香茶厂	厂长：谢金旺	地址：福建省福州市闽侯县南屿镇后山村
福建省闽侯县上街第三茶厂	null	地址：福建省福州市闽侯县上街镇联心村
福建省闽侯县苗圃	null	地址：福建省福州市闽侯县白沙镇溪头村南山１０号
闽侯县大湖乡双溪茶场	null	地址：福建省福州市闽侯县大湖乡双溪村
福建省闽侯县太福制茶厂	null	地址：福建省福州市闽侯县青口梅岭梅新路62号
闽侯县祥谦闽中种猪场	联系人：林建乐	地址：福建省福州市闽侯县祥谦镇岐尾村
福建省闽侯县尚干华富茶厂	null	地址：福建省福州市闽侯县尚干镇后浦村５４号
闽侯县尚干立华养猪场	null	地址：福建省福州市闽侯县尚干镇浦里村
闽侯县青口镇后福第十一养猪场	null	地址：福建省福州市闽侯县青口镇后福村
闽侯县青口宏二第五养猪场	null	地址：福建省福州市闽侯县青口镇宏二村
闽侯县鸿尾志基养猪场G	null	地址：福建省福州市闽侯县鸿尾乡安樟村
闽侯县青口青梅制茶厂	成立日期：1993/3/16	地址：中国 福建 福州市 闽侯县青口镇梅岭村
闽侯县青口镇后福第十养猪场	null	地址：福建省福州市闽侯县青口镇后福村
闽侯县青口金钓钗养猪场	null	地址：福建省福州市闽侯县青口镇付竹村过溪
闽侯县南通顺风养猪场	null	地址：福建省福州市闽侯县南通镇瓜山村
闽侯县青口宏二第四养猪场	null	地址：福建省福州市闽侯县青口镇宏二村
闽侯县上街镇金屿畜牧场	null	地址：福建省福州市闽侯县上街镇金屿村
闽侯县荆溪水产养殖场	null	地址：福建省福州市闽侯县荆溪镇溪下村
闽侯县南屿镇三南林场	null	地址：福建省福州市闽侯县南屿镇南前村
福建省闽侯县青口制茶厂	null	地址：福建省福州市闽侯县青口镇工业路６号
闽侯县廷坪联兴良种猪繁育场	联系人：李强余	地址：福建省福州市闽侯县廷坪乡下洋村
闽侯县科南良种场	联系人：唐忠炳	地址：福建省福州市闽侯县南屿镇高岐村
闽侯县竹岐榕中养鸡场	null	地址：福建省福州市闽侯县竹岐榕中养鸡场
福建省闽侯意丰水产养殖场	null	地址：福建省福州市闽侯县祥谦镇江中村
闽侯县青口梅溪第九养猪场	联系人：林万江	地址：福建省福州市闽侯县青口镇梅溪村
闽侯县上街沙当养猪场G	null	地址：福建省福州市闽侯县上街镇红峰村沙当16号
闽侯县青口吉山第五养猪场	null	地址：福建省福州市闽侯县青口镇梅溪村
闽侯县青口镇宏一第三养猪场	联系人：吴增禄	地址：福建省福州市闽侯县青口镇宏一村
闽侯县荆溪镇桐口养猪场	null	地址：福建省福州市闽侯县荆溪镇桐口村
福州市明丰水产养殖有限公司	总经理：邓保红	地址：福建省福州市闽侯县荆溪镇光明村
闽侯县青口后福第十四养猪场	null	地址：福建省福州市闽侯县青口镇后福村
闽侯县青口后福十三养猪场	null	地址：福建省福州市闽侯县青口镇后福村
福建省地方国营闽侯白沙农场	null	地址：福建省福州市闽侯县白沙镇孔元68号
福州将军山综合农场有限公司	总经理：吴龙振	地址：福建省福州市闽侯县荆溪镇关西村　　　　法定代表人：
福州嘉梅农场有限公司	总经理：黄秀芷	地址：福建省福州市闽侯县洋里乡　　　　　　　法定代表人：黄秀芷
闽侯县鸿尾综合农场	null	地址：福建省福州市闽侯县鸿尾乡千里洋
福州市江洋农场彭湖村民委员会	null	地址：福建省福州市闽侯县江洋农场彭湖
福建省闽侯金田果菜农场	联系人：张学腾	地址：福建省福州市闽侯县白沙镇大濑村
闽侯县青口镇宏屿大红里农场	null	地址：福建省福州市闽侯县青口镇宏屿村大红里
福建省闽侯县鸿尾南华综合贸易农场	null	地址：福建省福州市闽侯县鸿尾乡南坑村
闽侯县南屿镇畜牧兽医站	null	地址：福建省福州市闽侯县南屿镇畜牧兽医站南屿镇新桥
闽侯县白沙镇畜牧兽医站	null	地址：福建省福州市闽侯县白沙镇安平路９０号
闽侯县青口镇畜牧兽医站	null	地址：福建省福州市闽侯县青口镇青口村
福建省闽侯县上街古井茶厂	厂长：陈依海	地址：福建省福州市闽侯县上街镇马保村古井７号
闽侯县畜牧兽医学会	null	地址：福建省福州市闽侯县甘蔗镇交通路2号
福建省闽候县上街第一茶厂	null	地址：福建省福州市闽侯县上街镇浦口村
闽侯县鸿尾乡畜牧兽医站	null	地址：福建省福州市闽侯县鸿尾石佛头街
福建省闽侯县园艺场	联系人：叶延青	地址：福建省福州市闽侯县荆溪镇关东村
闽侯县小箬乡畜牧兽医站	站长：余永建	地址：福建省福州市闽侯县小箬乡政府内
闽侯县大湖乡股份果林场	null	地址：福建省福州市闽侯县大湖乡大湖村
闽侯县上洲绿海园艺场	联系人：林硕坤	地址：福建省福州市闽侯县南通镇上洲村
福建省闽侯山前制茶厂	厂长：胡桂富	地址：福建省福州市闽侯县甘蔗镇山前后街２号
福建省闽侯县甘蔗富民种苗场	null	地址：福建省福州市闽侯县甘蔗镇长江墩园洲
福州闽祥茶厂	厂长：林祥勇	地址：福建省福州市闽侯县祥谦镇枕峰工业区
福建省闽侯县龙山茶厂	厂长：江敏	地址：福建省福州市闽侯县洋里乡洋里村１４３号
福建省闽侯县上街石沙茶厂	null	地址：福建省福州市闽侯县上街镇马保村
福建省闽侯县闽江第二茶厂	null	地址：福建省福州市闽侯县闽江乡峡南村
闽侯县青口向阳苗圃场	null	地址：福建省福州市闽侯县青口镇溪东村
闽侯县上街余三茶厂	厂长：王志	地址：福建省福州市闽侯县上街镇金屿村金桥
闽侯县上街浦联茶厂	null	地址：福建省福州市闽侯县上街镇联心村
福建省闽侯县白沙振兴茶厂	null	地址：福建省福州市闽侯县白沙镇长坪园
闽侯县上街第八茶厂	null	地址：福建省福州市闽侯县上街镇联心村
闽侯县尚干镇畜牧兽医站	null	地址：福建省福州市闽侯县尚干镇祥谦路２６号
闽侯县闽星茶厂	null	地址：福建省福州市闽侯县闽江兴星村
福州市江洋农场角洋村民委员会	null	地址：福建省福州市闽侯县江洋农场角洋村
福州市江洋农场武竹村民委员会	null	地址：福建省福州市闽侯县江洋农场武竹村
闽侯县大湖乡马乾农业综合开发农场	联系人：蓊启坚	地址：福建省福州市闽侯县大湖乡马乾村
福州市江洋农场江洋村民委员会	null	地址：福建省福州市闽侯县江洋农场江洋村
闽饫县青口镇第二采石场	null	地址：福建省福州市闽侯县青口镇龙双莲电视台山腰岭
闽侯县鸿尾乡电管站	null	地址：福建省福州市闽侯县鸿尾乡石佛头街
福州大成房地产开发有限公司	总经理：郭起耕	地址：福建省福州市闽侯县竹岐乡竹西村　　　　法定代表人：
闽侯县青口镇工业区供电所	null	地址：福建省福州市闽侯县青口镇工业区
福建省银华房地产开发股份有限公司闽侯办事处	联系人：林杰	地址：福建省福州市闽侯县甘蔗镇入城路１３６号联谊大厦２楼
闽侯县南通镇房地产开发公司	null	地址：福建省福州市闽侯县南通镇南通街６９号
福建嘉祥房地产开发有限公司	总经理：景源	地址：福建省福州市闽侯县荆溪镇光明村　　　　法定代表人：景源
福建友顺房地产开发有限公司	总经理：景源	地址：福建省福州市闽侯县荆溪镇港头村　　　　法定代表人：景源
闽侯县南屿镇房地产开发公司	总经理：许忠添	地址：福建省福州市闽侯县南屿镇新桥头柳厝街１号
福州鸿盛置业有限公司	总经理：翁振旺	地址：福建省福州市闽侯县上街镇
福州英泰物业管理有限公司	总经理：郑丽香	地址：福建省福州市闽侯县上街３１６国道旁
闽侯县房地产价格评估事务所	null	地址：福建省福州市闽侯县甘蔗镇八一八西路73号
福州永华房地产开发有限公司	null	地址：福建省福州市闽侯县尚干镇寅武江
福州文武房地产开发有限公司	null	地址：福建省福州市闽侯县上街镇沙堤村委会
闽侯县白沙团成自行车修理店G	null	地址：福建省福州市闽侯县白沙镇火车路8号
闽侯县竹岐建榕自行车修理店	null	地址：福建省福州市闽侯县竹岐乡竹岐村
闽侯县荆溪修武自行车修理店	null	地址：福建省福州市闽侯县荆溪镇坛石村
闽侯县竹岐建民自行车修理店G	null	地址：福建省福州市闽侯县竹岐乡竹岐街
闽侯县白沙立新自行车修理店G	null	地址：福建省福州市闽侯县白沙镇火车路
闽侯县荆溪郭荣自行车修理店	null	地址：福建省福州市闽侯县荆溪镇永丰村文山里
闽侯县白沙文光钟表修理店G	null	地址：福建省福州市闽侯县白沙镇白沙街
闽侯县南通仲武自行车修理店	null	地址：福建省福州市闽侯县南通镇南通街
闽侯县城关昌盛钟表修理店G	null	地址：福建省福州市闽侯县甘蔗镇街心路139号
闽侯县甘蔗东升机动车电器修理店G	null	地址：福建省福州市闽侯县甘蔗镇入城路中段
闽侯县殡仪服务站	站长：金小娥	地址：福建省福州市闽侯县甘蔗镇校园路１４５号
闽侯县江口元开五金修配厂G	null	地址：福建省福州市闽侯县南屿镇江口村
闽侯县青口电厂	null	地址：福建省福州市闽侯县青口工业路
闽侯县闽益自来水厂	厂长：陈斌	地址：福建省福州市闽侯县闽江乡峡南村
闽侯县闽江供电站	null	地址：福建省福州市闽侯县闽江乡峡南村道头街８５号
福建省闽侯县白沙镇供电站	null	地址：福建省福州市闽侯县白沙镇礼堂边
闽侯县鸿尾埕头水电站	null	地址：福建省福州市闽侯县鸿尾乡埕头村
闽侯县上街供电站	null	地址：福建省福州市闽侯县上街镇红峰村
闽侯县南屿镇供电站	null	地址：福建省福州市闽侯县南屿镇南屿街１号
闽侯县甘蔗善华自行车修理配店G	null	地址：福建省福州市闽侯县甘蔗镇交通路8号
闽侯县南屿镇电管站	null	地址：福建省福州市闽侯县南屿镇
闽侯县住房资金管理中心	null	地址：福建省福州市闽侯县建设局内
闽侯县南屿公社双龙供电站	null	地址：福建省福州市闽侯县南屿镇龙泉村民委员会
闽侯县南屿镇尧沙供电站	站长：唐德水	地址：福建省福州市闽侯县南屿镇尧沙村
闽侯县青口镇自来水工程指挥部	老板：陈维华	地址：福建省福州市闽侯县青口镇政府内
福建省闽侯县青口明锦电器修理店	null	地址：福建省福州市闽侯县青口镇农贸市场
闽侯县甘蔗向前家电修理店	null	地址：福建省福州市闽侯县甘蔗镇街心路18号
闽侯县青口培清液化气灶具店G	null	地址：福建省福州市闽侯县青口镇青口街
闽侯县自来水公司劳动服务公司	null	地址：福建省福州市闽侯县甘蔗镇交通路１号
闽侯县南通恒安液化气灶具店	null	地址：福建省福州市闽侯县南通街
闽侯县南屿镇龙泉村自来水厂	厂长：陈则美	地址：福建省福州市闽侯县南屿镇龙泉村
闽侯县大湖贵峰自来水有限公司	总经理：刘遵松	地址：福建省福州市闽侯县大湖乡大湖街
闽侯县竹岐龙泉自来水厂	null	地址：福建省福州市闽侯县竹岐乡榕东村
闽侯县水利电力局南通自来水厂	null	地址：福建省福州市闽侯县南通镇帮道村
闽侯县鸿尾自来水厂	null	地址：福建省福州市闽侯县鸿尾乡石佛头街７９号
闽侯县荆溪则兴修车店	null	地址：福建省福州市闽侯县荆溪镇关口村
闽侯县竹岐家兴电器修理店	老板：庄启生	地址：福建省福州市闽侯县竹岐乡白龙村３１６号
福州快洁洗涤有限公司	null	地址：福建省福州市闽侯县上街镇厚美村
闽侯县荆溪铁岭修车店	null	地址：福建省福州市闽侯县荆溪镇洽浦村284号
闽侯县青口镇建贵修车店G	null	地址：福建省福州市闽侯县青口镇青圃村
闽侯县青口宏屿福栋修车店G	null	地址：福建省福州市闽侯县青口镇宏屿村33号
闽侯县白沙少玲补胎店G	null	地址：福建省福州市闽侯县白沙镇长坪园10号
闽侯县甘蔗鼎桓摩托修理店	老板：洪鼎桓	地址：福建省福州市闽侯县甘蔗镇化龙村福龙巷４８号
文豪燃气具特约维修店	null	地址：福建省福州市闽侯县甘蔗镇街心路32号
闽侯县甘蔗茂煌摩托车修理Ｇ	null	地址：福建省福州市闽侯县甘蔗镇入城路
闽侯县白沙兴隆摩托车修理店G	null	地址：福建省福州市闽侯县白沙镇下浦路
闽侯县祥谦镇枕峰洗车场	null	地址：福建省福州市闽侯县祥谦镇枕峰村
闽侯县闽江秋弟补胎店	null	地址：福建省福州市闽侯县闽江乡峡南村湾里40号
闽侯县白沙明照摩托车修理店G	null	地址：福建省福州市闽侯县白沙镇新街
闽侯县白沙良振补胎店G	null	地址：福建省福州市闽侯县白沙镇火车路37号
闽侯县白沙埕元仁明摩托修理店G	null	地址：福建省福州市闽侯县白沙镇埕元村
闽侯县白沙镇文化技术学校	校长：吴世敏	地址：福建省福州市闽侯县白沙镇安平路１３６号
闽侯县竹岐白龙小学	null	地址：福建省福州市闽侯县竹岐乡白龙村
闽侯县鸿尾乡文化技术学校	null	地址：福建省福州市闽侯县鸿尾乡影剧院
闽侯青圃职业中学工会委员会	null	地址：福建省福州市闽侯县青口镇青圃光园１号
闽侯建平职业中学教育工会委员会	null	地址：福建省福州市闽侯县上街镇建平村
闽侯县白沙新坡小学	校长：潘帮灿	地址：福建省福州市闽侯县白沙镇新坡村
闽侯县祥谦镇文化技术学校	校长：施文飞	地址：福建省福州市闽侯县祥谦镇
闽候县白沙汶溪小学	null	地址：福建省福州市闽侯县白沙镇汶溪村
闽候县廷坪中心小学	null	地址：福建省福州市闽侯县廷坪乡廷坪村
闽侯县竹岐中心幼儿园	联系人：谢敏华	地址：福建省福州市闽侯县竹岐乡竹岐街１３６号
闽侯县竹岐中心小学	null	地址：福建省福州市闽侯县竹岐乡竹岐村
闽侯县南通瓜山小学	null	地址：福建省福州市闽侯县南通镇瓜山村
闽侯县竹岐叶洋小学	null	地址：福建省福州市闽侯县竹岐叶洋村
闽候县廷坪罗桥小学	null	地址：福建省福州市闽侯县廷坪乡罗桥村
闽侯县沪屿中心小学	null	地址：福建省福州市闽侯县青口镇沪屿村沪屿街８３号
闽候县廷坪下洋小学	null	地址：福建省福州市闽侯县廷坪乡下洋村
闽侯县闽江乡中心幼儿园	null	地址：福建省福州市闽侯县闽江乡峡南村
闽侯县青口镇中心幼儿园	null	地址：福建省福州市闽侯县青口镇青圃村
闽候县洋里中心幼儿园	null	地址：福建省福州市闽侯县洋里乡洋里村
福建省机动车驾驶员培训实验学校	null	地址：福建省福州市闽侯县荆溪镇桐口村
闽侯县劳动局职业技术培训中心	联系人：郑承荣	地址：福建省福州市闽侯县甘蔗镇街心路１９３号
闽候县廷坪文山岗小学	null	地址：福建省福州市闽侯县廷坪文山岗
闽侯县白沙中心幼儿园	null	地址：福建省福州市闽侯县白沙镇埕元新村
福建省高级技工学校	校长：高孔星	地址：福建省福州市闽侯县荆溪镇光明村下沙３１号
闽侯县大湖乡文化技术学校	null	地址：福建省福州市闽侯县大湖乡政府
闽侯县青圃职业中学养殖种植场	null	地址：福建省福州市闽侯县青口镇青圃村光园里１号
福建省闽侯县建平职业中学	null	地址：福建省福州市闽侯县上街镇廷平村
闽侯县农业机械化技术学校	校长：杨发铠	地址：福建省福州市闽侯县荆溪镇荆溪村
福建省闽侯县师范学校修缮车间	null	地址：福建省福州市闽侯县荆溪镇港头村连头１号
闽侯县南通中心幼儿园	null	地址：福建省福州市闽侯县南通苏坂东路４０号
福建省闽侯师范学校教育工会委员会	null	地址：福建省福州市闽侯县荆溪镇港头村
闽侯县私立百益幼儿园	联系人：刘景平	地址：福建省福州市闽侯县荆溪镇永丰村浦口
福建省闽侯师范学校服务部	null	地址：福建省福州市闽侯县荆溪镇港头村店头１号
闽侯县竹岐乡苏洋小学	null	地址：福建省福州市闽侯县竹岐乡苏洋村
闽侯县青口联丰小学	null	地址：福建省福州市闽侯县青口镇联丰村
闽侯县枕峰中心小学	校长：林光敏	地址：福建省福州市闽侯县祥谦镇枕峰村
闽侯县青口梅溪小学	null	地址：福建省福州市闽侯县青口镇梅溪村
闽侯县大湖大池小学	校长：王道遣	地址：福建省福州市闽侯县大湖乡大池村
闽侯县青口西塘小学	null	地址：福建省福州市闽侯县青口镇东台村西厝
闽侯县大湖茶坪小学	null	地址：福建省福州市闽侯县大湖乡茶坪村
闽候县廷坪蕉溪小学	null	地址：福建省福州市闽侯县廷坪乡蕉溪村
闽侯县南通文山小学	null	地址：福建省福州市闽侯县南通镇文山村
闽候县延坪盘岭小学	null	地址：福建省福州市闽侯县廷坪乡盘岭村
闽候县竹岐榕榕岸中心小学	null	地址：福建省福州市闽侯县竹岐乡榕岸村
闽侯县闽江闽亭小学	null	地址：福建省福州市闽侯县亭江镇闽亭村
闽候县廷坪溪坪小学	null	地址：福建省福州市闽侯县廷坪乡溪坪村
闽侯县南屿南前小学	null	地址：福建省福州市闽侯县南屿镇南前村
闽侯县闽江小学学区	null	地址：福建省福州市闽侯县闽江乡峡南村
闽侯县竹岐小学学区	null	地址：福建省福州市闽侯县竹岐乡竹岐村
闽侯县大湖双溪小学	校长：江东浩	地址：福建省福州市闽侯县大湖乡双溪村
闽侯县青口小学	null	地址：福建省福州市闽侯县青口镇青圃村新桥外６０号
闽侯县洋头中心小学	null	地址：福建省福州市闽侯县洋里乡洋头村
闽候县祥谦红南小学	null	地址：福建省福州市闽侯县祥谦镇红南村
闽候县尾桥中心小学	null	地址：福建省福州市闽侯县廷坪乡尾桥村
闽候县洋里新见小学	null	地址：福建省福州市闽侯县洋里乡新见村
闽侯县大湖乡桥下小学	null	地址：福建省福州市闽侯县大湖乡桥下村
闽侯县南屿双峰小学	null	地址：福建省福州市闽侯县南屿镇双峰村
闽侯县上街余盛小学	null	地址：福建省福州市闽侯县上街镇余盛村
闽候县洋里长基小学	null	地址：福建省福州市闽侯县洋里乡长基村
闽侯县青口东台小学	null	地址：福建省福州市闽侯县青口镇东台后厝
闽候县廷坪马厝小学	null	地址：福建省福州市闽侯县廷坪乡马厝村
闽侯县甘蔗青岐小学	null	地址：福建省福州市闽侯县甘蔗镇青岐村５７号
闽侯县青口陈元小学	null	地址：福建省福州市闽侯县青口镇东台村
闽侯县青口集东小学	null	地址：福建省福州市闽侯县青口镇后福村
闽侯县大湖洋山小学	null	地址：福建省福州市闽侯县大湖洋山
闽候县洋里茶苑小学	null	地址：福建省福州市闽侯县洋里乡茶苑村
闽侯县鸿尾大模小学	null	地址：福建省福州市闽侯县鸿尾乡大模村
福建省闽候县第七中学	null	地址：福建省福州市闽侯县南屿镇江口村
闽侯县城关中学	null	地址：福建省福州市闽侯县甘蔗镇里山前１号
闽侯县奎石中心小学	null	地址：福建省福州市闽侯县鸿尾乡奎石村
闽候县洋里安仁小学	null	地址：福建省福州市闽侯县洋里乡安仁村
福建省闽侯县鸿尾中学康乐工艺厂	null	地址：福建省福州市闽侯县鸿尾乡石佛头
福建省闽侯虎峰初级中学	null	地址：福建省福州市闽侯县祥谦镇双龙村
闽侯县青口小学学区	null	地址：福建省福州市闽侯县青口镇
福建省闽侯县鸿尾中学教育工会委员会	null	地址：福建省福州市闽侯县鸿尾乡石佛头街２１２号
福建省闽侯第三中学	null	地址：福建省福州市闽侯县南屿镇南旗村桥下路２３号
福建省闽侯县桐口中学教育工会委员会	null	地址：福建省福州市闽侯县荆溪镇桐口村
福建省闽侯第六中学工会委员会	null	地址：福建省福州市闽侯县上街镇上街村赤塘２７号
福建省闽侯荆溪中学教育工会委员会	联系人：杨康林	地址：福建省福州市闽侯县荆溪镇徐家村
闽侯私立民益中学	null	地址：福建省福州市闽侯县甘蔗镇校园路1号
闽侯县南通初级中学	校长：潘可人	地址：福建省福州市闽侯县南通镇苏坂东路３４号
闽侯私立闽山中学	null	地址：福建省福州市闽侯县南屿镇南前村
福建省闽侯上寨初级中学	null	地址：福建省福州市闽侯县白沙镇上寨村上寨６４号
闽候县洋里尚锦小学	null	地址：福建省福州市闽侯县洋里乡尚锦村
福建省闽侯江洋林业中学	null	地址：福建省福州市闽侯县江洋农场江洋村
福建省闽侯县南屿初级中学	null	地址：福建省福州市闽侯县南屿镇中溪村坎水１号
闽侯县青圃中心小学	null	地址：福建省福州市闽侯县青口镇青圃村宫下１号
福建省闽侯尚干初级中学	null	地址：福建省福州市闽侯县尚干镇五虎路
闽侯县小箬乡尚格小学	校长：周迎锋	地址：福建省福州市闽侯县小箬乡尚格村
闽侯县上?中心小学	null	地址：福建省福州市闽侯县竹岐乡半岭村
闽侯县竹岐春风小学	null	地址：福建省福州市闽侯县竹岐乡春风村
闽侯县南通莲湖小学	null	地址：福建省福州市闽侯县南通镇泽洋村
闽候县竹岐溪南小学	null	地址：福建省福州市闽侯县竹岐乡溪南村
闽候县上街马保小学	null	地址：福建省福州市闽侯县上街镇马保村
闽侯县南通古城小学	null	地址：福建省福州市闽侯县南通镇古城村
闽侯县南通第二中心小学	null	地址：福建省福州市闽侯县南通镇泽洋村
闽侯县实验小学工会委员会	null	地址：福建省福州市闽侯县甘蔗镇校园路２号
闽侯县罗洋中心小学	null	地址：福建省福州市闽侯县竹岐乡罗洋村
闽侯县洋里乡绅带小学	null	地址：福建省福州市闽侯县洋里乡绅带村
闽侯县上街美岐小学	null	地址：福建省福州市闽侯县上街镇美岐村
闽候县闽江胜利小学	null	地址：福建省福州市闽侯县闽江乡
闽侯县青口前洋小学	null	地址：福建省福州市闽侯县青口镇前洋村
闽侯县大义中心小学	null	地址：福建省福州市闽侯县青口镇大义后街村马路街３１号
闽侯县小箬中心小学	校长：陈晓光	地址：福建省福州市闽侯县小箬乡小箬村
闽侯县大湖六锦小学	校长：刘国胜	地址：福建省福州市闽侯县大湖乡六锦村
闽侯县南屿桐南小学	null	地址：福建省福州市闽侯县南屿镇桐南村
闽侯县南通银安小学	null	地址：福建省福州市闽侯县南通镇银安村
闽候县洋里梧溪小学	null	地址：福建省福州市闽侯县洋里乡梧溪村
福建省闽侯第三中学工会委员会	null	地址：福建省福州市闽侯县南屿镇南旗村桥下路２３号
闽候县白沙上岐小学	null	地址：福建省福州市闽侯县白沙镇上岐村82号
闽侯县孔元中心小学	null	地址：福建省福州市闽侯县白沙镇孔元村
闽侯县鸿尾青马小学	校长：陈祖芬	地址：福建省福州市闽侯县鸿尾乡青马村
闽侯县白沙洋石小学	null	地址：福建省福州市闽侯县白沙镇洋石小学
闽候县廷坪洪山小学	null	地址：福建省福州市闽侯县廷坪乡洪山村
闽侯县青口镜上小学	null	地址：福建省福州市闽侯县青口镇镜上村
闽侯县南通洲头小学	null	地址：福建省福州市闽侯县南通镇洲头村
闽侯县荆溪洽浦小学	null	地址：福建省福州市闽侯县荆溪镇洽浦村
闽侯县上街岐安小学	null	地址：福建省福州市闽侯县上街镇岐安村
闽侯县上街马排小学	null	地址：福建省福州市闽侯县上街镇马排村
闽候县白沙大濑小学	null	地址：福建省福州市闽侯县白沙镇大濑村
闽候县洋里张际小学	null	地址：福建省福州市闽侯县
闽候县洋里岭兜小学	null	地址：福建省福州市闽侯县洋里乡岭兜村
闽侯县白沙汤浣小学	null	地址：福建省福州市闽侯县白沙镇汤院村
闽候县廷坪黄埔小学	null	地址：福建省福州市闽侯县廷坪乡黄埔村
闽侯县青口宏屿小学	null	地址：福建省福州市闽侯县青口镇宏二村
闽侯县南通泽苗小学	null	地址：福建省福州市闽侯县南通镇泽苗村
闽侯县桐口中心小学	null	地址：福建省福州市闽侯县荆溪镇桐口村
闽侯县南通上洲小学	null	地址：福建省福州市闽侯县南通镇上洲村
闽侯县南通马腾小学	null	地址：福建省福州市闽侯县南通镇马腾村
闽侯县小箬小学学区	联系人：林宜瑜	地址：福建省福州市闽侯县小箬乡小箬村
闽候县廷坪汶合中心小学	null	地址：福建省福州市闽侯县廷坪汶合村
闽候县荆溪六?小学	null	地址：福建省福州市闽侯县荆溪镇六　村
闽侯县青口傅筑小学	null	地址：福建省福州市闽侯县青口镇傅筑村
闽侯县鸿尾乡官路小学	null	地址：福建省福州市闽侯县鸿尾乡官路村
闽侯县大湖后洋小学	校长：严希津	地址：福建省福州市闽侯县大湖乡后坪村
福州清水食品有限公司	总经理：郑钟杜	地址：福建省福州市闽侯县祥谦镇兰圃工业区
闽侯县南屿晨光紧固件厂	null	地址：福建省福州市闽侯县南屿镇南井村上井８９号
闽侯县荆溪维萃豆奶厂	null	地址：福建省福州市闽侯县荆溪镇关口村277号
闽侯县鸿尾乡青坑蜜饯厂	null	地址：福建省福州市闽侯县云尾乡青马村２号
福建省熔新机床厂劳动服务公司	null	地址：福建省福州市闽侯县白沙镇孔源村１６８号
福建省闽侯二轻工贸总公司竹木制品厂	厂长：黄宝童	地址：福建省福州市闽侯县甘蔗镇校园路
福建省闽侯县秋龙工艺美术厂	null	地址：福建省福州市闽侯县祥谦镇中院村
福建省闽侯县志达工艺厂	null	地址：福建省福州市闽侯县荆溪镇绿家村５号
福建省闽侯县荆溪桐口福达工艺厂	null	地址：福建省福州市闽侯县荆溪镇桐口村后池
福建省闽侯县华隆工艺厂	null	地址：福建省福州市闽侯县华隆工艺厂
闽侯县荆溪飞宏工艺厂	null	地址：福建省福州市闽侯县荆溪光明村下沙路30号
闽侯县鸿尾永兴工艺厂G	null	地址：福建省福州市闽侯县鸿尾乡超乾村
闽侯县江口盛荣织布厂	null	地址：福建省福州市闽侯县南屿镇江口村
福州恒发织造有限公司	null	地址：福建省福州市闽侯县甘蔗镇前后街５号
闽侯县砂轮厂工会委员会	null	地址：福建省福州市闽侯县白沙镇新街１４８号
闽侯县南屿秀荣美术工艺厂	null	地址：福建省福州市闽侯县南屿镇上井村
闽侯县甘蔗闽全鞋帽厂	null	地址：福建省福州市闽侯县甘蔗镇火车站
闽侯县南屿江口榕丰织布厂	null	地址：福建省福州市闽侯县南屿镇江口村青州
闽侯县荆溪华清工艺品厂	null	地址：福建省福州市闽侯县荆溪镇桐口村
闽侯县厚屿观大工艺厂	厂长：林观振	地址：福建省福州市闽侯县荆溪镇厚屿新街
闽侯县芝田建筑材料厂	null	地址：福建省福州市闽侯县南屿镇芝田村
闽侯县南屿江口东兴纺织厂	null	地址：福建省福州市闽侯县南屿镇江口村过透
闽侯县南屿色织厂	null	地址：福建省福州市闽侯县南屿镇水西１号
闽侯县甘蔗镇石料厂	null	地址：福建省福州市闽侯县甘蔗镇五福村
福州诚中砂石有限公司竹岐砂石加工厂	null	地址：福建省福州市闽侯县竹岐乡竹西村
闽侯县上街祥庆水泥制品厂	厂长：陈祥庆	地址：福建省福州市闽侯县上街镇上街村
福建省闽侯县宏辉鞋业有限公司	null	地址：福建省福州市闽侯县甘蔗镇甘洲路１５号
福建省闽侯白沙汶溪保温材料厂	null	地址：福建省福州市闽侯县白沙镇汶溪村
闽侯县江口江旺纺织厂	null	地址：福建省福州市闽侯县江口村
闽侯县南屿东方织带厂G	null	地址：福建省福州市闽侯县南屿镇江口村后双180号
闽侯县南屿江口英姿线带厂G	null	地址：福建省福州市闽侯县南屿江口村
闽侯县青口沪屿村里劳保服装厂	null	地址：福建省福州市闽侯县青口镇沪屿村
闽侯县第四建筑工程公司水泥制品厂	厂长：江爱涛	地址：福建省福州市闽侯县甘蔗镇校园路２４号
福建省闽侯制鞋厂	null	地址：福建省福州市闽侯县青口镇青圃青长路108号
闽侯县龙飞工艺鞋帽厂	厂长：陈天龙	地址：福建省福州市闽侯县南通镇陈厝村
福建嘉豪制衣有限公司	总经理：李嘉豪	地址：福建省福州市闽侯县上街镇浦口村
闽侯县南屿江口双桥织布厂G	null	地址：福建省福州市闽侯县南屿镇江口后双村
闽侯县闽兴石粉厂	null	地址：福建省福州市闽侯县青口镇青圃新桥外54号
闽侯县青口红旗塑革鞋厂	null	地址：福建省福州市闽侯县青口镇青坛水电站
闽侯县江口汉城纺织厂	null	地址：福建省福州市闽侯县南屿镇江口村
闽侯青口融丰石粉厂	厂长：杨明銮	地址：福建省福州市闽侯县青口镇联丰村
闽侯县南屿江口茂金线带厂	厂长：潘茂金	地址：福建省福州市闽侯县南屿镇江口村九石
闽侯鸿顺制衣有限公司	null	地址：福建省福州市闽侯县甘蔗镇三英村
闽侯县宏辉线业有限公司	null	地址：福建省福州市闽侯县南通镇泮洋村
闽侯县华丽工艺美术厂	null	地址：福建省福州市闽侯县甘蔗镇化龙村
闽侯县富丽华工艺厂G	null	地址：福建省福州市闽侯县南通镇古城村镜口27号
闽侯县南屿江口兆永工艺厂	null	地址：福建省福州市闽侯县南屿镇江口村九石
闽侯县康兴工艺厂	厂长：冯昭为	地址：福建省福州市闽侯县廷坪乡溪坪村
闽侯县南屿江口建国纺织厂G	null	地址：福建省福州市闽侯县南屿镇江口过透
闽侯县宇峰纺织厂	厂长：宇江榕	地址：福建省福州市闽侯县南屿镇江口村九石１０４号
闽侯县南屿江口发利织布厂G	null	地址：福建省福州市闽侯县南屿镇江口九石
福建省闽侯县增宾工艺厂	厂长：林秀清	地址：福建省福州市闽侯县甘蔗镇街心路３０号
闽侯县江口华达纺织厂	null	地址：福建省福州市闽侯县南屿镇江口村
闽侯县江口青顺纺织厂	null	地址：福建省福州市闽侯县南屿镇江口青州
福建省闽侯瀛明服装有限公司	null	地址：福建省福州市闽侯县甘蔗镇
福建省闽侯县南粤厨房设备有限公司	总经理：梁力坚	地址：闽侯县南屿镇南井村
闽侯县南屿江口福兴纺织厂	null	地址：福建省福州市闽侯县南屿镇江口村过透１４号
闽侯县南屿江口标平纺织厂	null	地址：福建省福州市闽侯县南屿镇江口过透
闽侯县鸿尾溪旺工艺厂	null	地址：福建省福州市闽侯县鸿尾乡桥头村桥头街46号
福建省闽侯县江口振兴塑革鞋厂	null	地址：福建省福州市闽侯县南屿镇江口村青洲37号
福建省闽侯县胪峰鞋业有限公司	总经理：陈开兴	地址：福建省福州市闽侯县青口镇傅筑建材市场Ｇ座
闽侯县南屿镇兴华纺织厂G	null	地址：福建省福州市闽侯县南屿镇江口村九石
闽侯县南屿开拓纺织厂	null	地址：福建省福州市闽侯县南屿镇江口村过透６６号
福建省闽侯县荆溪宏达工艺厂	null	地址：福建省福州市闽侯县荆溪镇原屿村７２号
闽侯县江口胜光织布厂	null	地址：福建省福州市闽侯县南屿镇江口村青州
闽侯县江口国利纺织厂G	null	地址：福建省福州市闽侯县南屿镇江口村
闽侯县江口明发纺织厂G	null	地址：福建省福州市闽侯县南屿镇江口村后双113号
福建省闽侯县鸿尾明辉工艺厂	null	地址：福建省福州市闽侯县鸿尾乡超乾村335号
闽侯县江口祥辉棉纺织厂	null	地址：福建省福州市闽侯县南屿镇江口村青洲96号
闽侯县江口永发纺织厂	null	地址：福建省福州市闽侯县南屿镇江口村过透１０４号
福建省闽侯县厚屿旅游工艺厂G	null	地址：福建省福州市闽侯县荆溪镇厚屿村62号
福建省闽侯县闽旺工艺厂	厂长：苏金仙	地址：福建省福州市闽侯县甘蔗镇五福村
福建省闽侯县万安服装厂	厂长：洪建华	地址：福建省福州市闽侯县甘蔗镇山前军民路１６号
闽侯县洋里乡小箬武唐工艺厂G	null	地址：福建省福州市闽侯县洋里乡小箬村
闽侯县百创鞋业有限公司	null	地址：福建省福州市闽侯县荆溪镇光明村
福建省闽侯服装厂	null	地址：福建省福州市闽侯县甘蔗镇墩园洲５５号
福州友联工艺美术品有限公司闽侯分公司	null	地址：福建省福州市闽侯县上街镇岐安村
闽侯县洋里兴盛竹草工艺厂G	null	地址：福建省福州市闽侯县洋里乡洋里村
闽侯县晓峰工艺品厂	null	地址：福建省福州市闽侯县南屿镇晓岐村
闽侯县上街恒辉丝印网版加工场	联系人：张乾明	地址：福建省福州市闽侯县上街镇金屿余盛村
闽侯县江口亨达纺织厂	null	地址：福建省福州市闽侯县南屿镇江口后双１２６号
闽侯县江口新榕纺织厂	null	地址：福建省福州市闽侯县南屿镇江口村九石
闽侯县甘蔗金星工艺厂	null	地址：福建省福州市闽侯县甘蔗镇大元村大元巷
闽侯县小箬金若工艺厂	厂长：李益淦	地址：福建省福州市闽侯县小箬乡青安村
闽侯县尚干双福美术工艺厂	厂长：林建辉	地址：福建省福州市闽侯县尚干镇福厦路西侧
闽侯县竹岐贝莱工艺厂	null	地址：福建省福州市闽侯县竹岐乡竹岐街299号
福建省闽侯县尚干浦里塑料工艺厂	null	地址：福建省福州市闽侯县尚干镇浦里村
福建省闽侯县明榕工艺品有限公司	null	地址：福建省福州市闽侯县青口镇杨厝村阁兜２号
福建省闽侯县上街星良工艺品厂	厂长：王星良	地址：福建省福州市闽侯县上街镇岐安村下长安３５－３号
福建省闽侯日兴工艺厂	厂长：罗华美	地址：福建省福州市闽侯县白沙长坪园
福建省闽侯县青口顺达针织厂	null	地址：福建省福州市闽侯县青口镇工业区
闽侯县甘蔗三源工艺品厂	厂长：陈佑辉	地址：福建省福州市闽侯县甘蔗镇大元巷３８－１号
福建省闽侯县锦锋工艺品厂	厂长：林连正	地址：福建省福州市闽侯县尚干镇五虎路２７号
福建省闽侯县南屿艺馨工艺厂	null	地址：福建省福州市闽侯县南屿镇后山村
福建省闽侯榕兴工艺品有限公司	总经理：方孝秋	地址：福建省福州市闽侯县南通镇方庄
闽侯县兴达彩色包装印刷厂	null	地址：福建省福州市闽侯县青圃村新桥头
闽侯县双华工艺美术厂	厂长：陈忠华	地址：福建省福州市闽侯县甘蔗镇三福小区１座１２６号
福州温雅工艺品有限公司	总经理：张鲁榕	地址：福建省福州市闽侯县鸿尾乡官路村　　　　法定代表人：张鲁榕
闽侯县正茂工艺厂	厂长：胡振光	地址：福建省福州市闽侯县荆溪镇建发建材综合楼１０５号
福建省闽侯县闽隆工艺厂	厂长：李碧仙	地址：福建省福州市闽侯县甘蔗镇长江巷３９号
