福建诚付天下金融技术服务有限公司福州连江分公司	总经理：林	地址：连江县凤城镇玉山小区104国道西侧1#楼101单元
福建省京舜建设工程有限公司连江分公司	总经理：陈	地址：连江县凤城镇816中路安盛大厦2#楼605
连江县菊红农业综合场	联系人：陈	地址：福建省福州市连江县长龙镇下洋村新建路115号
福州市闽诚家政服务有限公司连江分公司	总经理：范	地址：连江县凤城镇龙华花园二期19号楼4号店面
连江县丹阳镇法增铝合金铁门加工厂	厂长：陈	地址：福州市连江县丹阳镇山兜村长园坪
连江县蓼沿乡宝磊石料场	联系人：黄	地址：福州市连江县蓼沿乡溪东村单兜岗
连江县诚信天商务咨询服务有限公司	总经理：罗	地址：福建省福州市连江县凤城镇丹凤西路2号宏宇花园14#-16#14号店
连江县丹阳镇荣盛石材厂	厂长：黄	地址：福建省福州市连江县丹阳镇花园村
连江县旺居房产代理有限公司	总经理：黄	地址：福建省福州市连江县凤城镇北门街凤园路凤尾花园3#楼11店
福建佳创置业有限公司	总经理：林	地址：福建省福州市连江县凤城镇江滨西路3号江夏苑1#－4#楼二层33店面
福州财缘城投资有限公司	总经理：邵	地址：福建省福州市连江县凤城镇文山北路5号太一新天地1#楼7店面
福建华兰里农业综合开发有限公司	总经理：邱	地址：福建省福州市连江县马鼻镇贵峰村渔池墩路1号
福建瑞玻玻璃有限公司	总经理：陈	地址：福建省福州市连江县可门经济开发区坑园村溪尾路58号
福建省万坤建设工程有限公司	总经理：黄	地址：连江县凤城镇丹凤东路14号绿茵花园5#楼4层401单元
福州励志房地产开发有限公司	总经理：邱	地址：福建省福州市连江县安凯乡高塘村高塘路102号
连江县创宏建材有限公司	总经理：王	地址：福建省福州市连江县凤城镇国优路8号鲤鱼港湾5#楼11层1102单元
连江众安投资有限公司	总经理：王	地址：福建省福州市连江县马鼻镇横厝村红石12-2号
连江县泓帆渔业有限公司	总经理：刘	地址：连江县苔?镇茭南村宏图路43号
连江县兴丰服饰有限公司	总经理：庄	地址：连江县凤城镇丹凤东路15号丹凤花园44#楼13店面
连江县浦口镇山海经农业专业合作社	联系人：林	地址：连江县浦口镇中麻村里澳269号
福建省上善星电缆有限公司	总经理：林	地址：连江县经济开发区敖江工业园区1#楼福建世纪电缆有限公司内
福州市金汇通投资咨询有限公司	总经理：林	地址：连江县凤城镇丹凤东路7号迪鑫花园6#1号店
福州市日志环保科技有限公司	总经理：林	地址：福建省福州市连江县凤城镇莲荷东路25#楼B座3车库
福州市恩佑再生资源有限公司	总经理：王	地址：福建省福州市连江县坑园镇下元村前进路29号
连江县黄岐镇郑秀敏渔需制品厂	厂长：郑	地址：福建省福州市连江县黄岐镇大建村建强路码头边
连江县金莎水产养殖有限公司	总经理：汪	地址：福建省福州市连江县黄岐镇后仑村西路23号
福建泰龙源农业开发有限公司	总经理：黄	地址：福州市连江县透堡镇馆读村门前埕D9号2户
福建省鸿翔广告工程有限公司	总经理：林	地址：连江县凤城镇莲荷东路18#A2号店
连江县庆源燃料油贸易有限公司	总经理：占	地址：福建省福州市连江县浦口镇中麻村
福州源鑫盛源实业有限公司	总经理：林	地址：福建省福州市连江县可门开发区管委会坑园镇坑园村溪尾路58号
福建省连江县西山顶综合农场（普通合伙）	联系人：林	地址：福建省福州市连江县蓼沿乡利畲村西山自然村
中国移动通信集团福建有限公司连江商专营业厅	联系人：陈	地址：连江县潘渡村福建商业高等专科学校新校区商业街
福州盛龙塑胶有限公司牡丹洋分公司	总经理：潘	地址：连江县蓼沿乡定田村牡丹洋垅头厝山地
连江县丹阳镇顶尚丽盾工艺石加工厂	厂长：雷	地址：福州市连江县丹阳镇新洋村
连江县玉平养兔场	联系人：刘	地址：福建省福州市连江县江南乡澄岩村
连江县苔?旺角酒厂	厂长：林	地址：福建省福州市连江县苔?镇苔?村后港1#、2#、3#D6#
福建省假日国际旅行社有限公司连江?头营业部	老板：倪	地址：福建省福州市连江县?头镇街道团结路11号
福建省鑫恒投资有限公司	总经理：韩	地址：连江县凤城镇金安西路2号龙芝国际商业广场1层5店面
福建省生久担保有限公司	总经理：陈	地址：福建省福州市连江县凤城镇丹凤西路2号宏宇花园14-16#14号店
连江县鑫瑞咨询服务有限公司	总经理：谢	地址：连江县凤城镇丹凤东路15号丹凤花园43#楼14店面
福州良特贸易有限公司	总经理：吴	地址：福建省福州市连江县?头镇开放路东侧宏源新苑4#楼503室
福州市超浪养殖有限公司	总经理：林	地址：福建省福州市连江县坑园镇屿头村富新路4号
连江县凤城镇依宝药店	老板：谢	地址：福建省福州市连江县凤城镇丹凤东路15号丹凤花园2#楼6-9号店
福建省新马会旅游开发有限公司	总经理：李	地址：福建省福州市连江县潘渡乡贵安村科技大楼305室
连江县坑园镇颜岐富珍水产品经营部	老板：颜	地址：福建省福州市连江县坑园镇颜岐村新民南路94号
福建连江宏大建筑工程有限公司	总经理：姚	地址：连江县下宫乡厦一村一条山脚
连江县九源燃料油有限公司	总经理：林	地址：福建省福州市连江县?头镇下岐村113号
福建宜联管业有限公司	总经理：林	地址：连江县敖江镇青塘村工业园区1#厂房
福州市宏日建筑劳务有限公司	总经理：杨	地址：福建省福州市连江县凤城镇江滨路景江花园二期D型E12一层
连江县坑园镇光辉海产品厂	厂长：颜	地址：福建省福州市连江县坑园镇颜岐村新民南路礼堂边
福州盛运物流有限公司	总经理：赵	地址：连江县沈海高速公路与文笔东路交叉口东北角
连江县长龙镇龙发农民专业合作社	联系人：陈	地址：福建省福州市连江县长龙镇建庄村后门洋
连江县凤城镇我家聚餐园玉荷分店	老板：林	地址：福建省福州市连江县凤城镇玉荷西路（原西餐厅）2#楼9号店、10号店
神州坤元（福建）建设工程有限公司	总经理：郑	地址：福建省福州市连江县凤城镇816东路109号六层
连江县坑园镇颜岐村广隆超市	联系人：颜	地址：福建省福州市连江县坑园镇颜岐村大兴东路310号
福州市金石馆工艺品有限公司	总经理：王	地址：福建省福州市连江县凤城镇丹凤东路3-460号9#楼1层112号店
兴锋盈（福建）集团有限公司连江分公司	总经理：官	地址：连江县潘渡乡贵安村后垄仔责任田
福建康佰家大药房连锁有限公司一二二店	老板：严	地址：连江县?头镇上坪路18号鑫立大厦第一层店面
连江县渔港旅游开发有限公司	总经理：谢	地址：福建省福州市连江县苔?镇秀邦村北沃五路二扇一直
连江县好帮手家庭服务有限公司	总经理：范	地址：连江县凤城镇金凤名都10#楼1层7号店面
连江县华商翼企业管理有限公司	总经理：林	地址：福建省福州市连江县凤城镇816南路巨林商厦1#楼1-19号店面
福建省得力宝五金工具有限公司	总经理：王	地址：连江县?头镇东边村连港路北侧3#1层
连江县马鼻镇金石石材加工厂	厂长：陈	地址：福建省福州市连江县马鼻镇车站西侧
福建金沙岛投资有限公司	总经理：林	地址：连江县凤城镇华光西路2号凤凰城10#楼1店面
福建中汇典当有限公司	总经理：高	地址：福建省福州市连江县贵安新天地贵锦苑商业1号楼21店
连江县晓澳镇金山禽畜养殖场	联系人：林	地址：连江县晓澳镇道澳村二坪山南面
福州千穗农业开发有限公司	总经理：陈	地址：福建省福州市连江县透堡镇西门村西门街14号3户
福建晟鑫建设工程有限公司连江分公司	总经理：陈	地址：福建省福州市连江县凤城镇东北街816东路109号二层
连江县鱼奇海产品有限公司	总经理：王	地址：福建省福州市连江县凤城镇丹凤东路2号丹凤广场1#楼B座801
福州兴鑫旺贸易有限公司	总经理：陈	地址：连江县马鼻镇半田下村溪边区50号
福州百味食品有限公司连江分公司	总经理：陈	地址：连江县经济开发区东湖园区3#厂房一楼
承洁环保有限公司	总经理：陈	地址：连江县江南乡江南社区居委会307房
福州群龙兴贸易有限公司	总经理：欧	地址：连江县?头镇天麟明珠城7座404号
连江县顺鑫汽车租赁有限公司	总经理：李	地址：连江县凤城镇江滨东路18号景江花园二期D型23号店面
迪凯塑料制品有限公司	总经理：陈	地址：连江县丹阳镇虎山村连江县丹阳造纸厂一层
连江县华源建材贸易有限公司	总经理：陈	地址：福州市连江县凤城镇文山北路5号太一新天地12#楼8层811单元
福州市旺林升汽车租赁有限公司	总经理：林	地址：福州市连江县丹阳镇104国道右侧12号住宅楼4号店面
福州市车迷城汽车服务有限责任公司	总经理：陈	地址：福州市连江县敖江投资区上高速路北侧、敖江路东侧8#标准厂房
福州海中水产有限公司	总经理：陈	地址：连江县马鼻镇玉井村二房里112号
福州创域装饰工程有限公司	总经理：林	地址：福建省福州市连江县凤城镇文山北路5号太一新天地1#楼14店面
福州丰畅购物中心有限公司	总经理：张	地址：连江县潘渡乡贵安村科技大楼
高明实业（福建）有限公司	总经理：赖	地址：连江县凤城镇文明东路1号
连江县卓创企业管理咨询有限公司	总经理：林	地址：福建省福州市连江县凤城镇文笔路6号凤翔国际二区17#楼1层20店面
连江县盛平企业管理咨询有限公司	总经理：张	地址：连江县凤城镇玉荷东路（台资大楼边）1#104
连江县雅顺广告工程有限公司凤城分公司	总经理：陈	地址：福建省福州市连江县凤城镇文山北路6号龙华花园3#楼1层3店面
福建省连江县世长水产养殖场	联系人：赵	地址：福建省福州市连江县筱埕镇定海村鲍鱼海区第一区
福建省连江县乾元水产品贸易有限公司	总经理：刘	地址：福建省福州市连江县苔?镇后湾村海滨路5号
福建连江恒欣村镇银行股份有限公司?头支行	联系人：陈	地址：福建省福州市连江县?头镇拱屿村开放路东川花园B#B单元
福建中永建设工程有限公司连江分公司	总经理：陈	地址：福建省福州市连江县凤城镇文山北路6号龙华花园16#楼2层202单元
福建兴坤达钢结构工程有限公司	总经理：陈	地址：福建省福州市连江县敖江镇浦下村原荷山造纸厂
福建永恒兴投资有限公司	总经理：陈	地址：福建省福州市连江县凤城镇文山北路6号龙华花园商业用房1层4店面
福建省连江县黄岐枝达海洋渔具制造厂	厂长：林	地址：福建省福州市连江县黄岐镇海建街畚箕山
福建省大众农业综合开发有限公司	总经理：黄	地址：福建省福州市连江县蓼沿乡定田村下岩路92号
福建省同友房地产开发有限公司	总经理：唐	地址：福建省福州市连江县凤城镇丹凤西路2号宏宇花园14-16#楼14号店
中国人寿保险股份有限公司连江县支公司第十营销服务部	老板：李	地址：福建省福州市连江县?头镇劳动路100号二层
福建聚磊建材有限公司	总经理：袁	地址：福建省福州市连江县江南乡境路村垅里工业区3号
福建宫福水产进出口有限公司	总经理：卓	地址：连江县晓沃镇道沃村1#楼
连江县东岱镇靓装建材店	老板：林	地址：连江县东岱镇东岱街邮电局对面
连江县北茭富源渔业有限公司	总经理：林	地址：福建省福州市连江县苔?镇北茭村吴城面14号
连江县大宇贸易有限公司	总经理：周	地址：福建省福州市连江县?头镇兰田村1#1层101室
中国石油化工股份有限公司福建福州连江玉泉加油站	站长：贾先生	地址：连江县凤城镇玉山村国道104线2287公里500米
连江县马鼻镇传承化妆品经营部	老板：郑先生	地址：连江县马鼻镇墙兜村林厝前
连江县?头镇万隆达石材厂	厂长：陈先生	地址：连江县?头镇秦川村塘边?头中学西路边
连江县同心协力养殖专业合作社	联系人：林先生	地址：连江县安凯乡同心村同心路18号
连江县下宫清丰鲍鱼养殖场	联系人：肖能烁	地址：连江县下宫乡松皋村屿仔后面第二行第三区
连江县下宫一水鲍鱼养殖场	联系人：肖能登	地址：连江县下宫乡江湾村江湾海区（鲍鱼海区第38区）
福州市福泽水产有限公司	总经理：吴克松	地址：连江县下宫乡初芦村初芦62号
福州富盛食品水产有限公司	总经理：林文飞	地址：连江县苔?镇苔?村后港码头
福建省连江罗源湾酒业有限公司	总经理：林阳先生	地址：连江县马鼻镇贵峰村村口
福州市泰和盛竹业有限公司	总经理：马法斌	地址：连江县蓼沿乡蒲边村柴桥头
福州泛泰贸易有限公司	总经理：陈为民	地址：连江县凤城镇816北路103号连江县交通局3#五楼
福建省润物天成发展有限公司	总经理：严先生	地址：连江县潘渡乡贵安科技大楼
福建伟佳机械有限公司	总经理：吴先生	地址：连江县东岱镇蝉步村3号三层连体房屋一层101室
连江县黄岐正旺食品厂	厂长：林政先生	地址：连江县黄岐镇海新街新华路103号
连江县好运来投资咨询有限公司	总经理：刘彬先生	地址：连江县凤城镇金安东路2号龙芝御景3#楼2003单元
福建岱江生态农业开发有限公司	总经理：缪仁振	地址：连江县东岱镇东岱街大涂七里里林果场
连江县下宫乡江湾村帝王鲍鱼养殖场	联系人：王先生	地址：福建省福州市连江县下宫乡江湾村江湾海区（鲍鱼海区第7区）
福州三辉物业有限公司连江县分公司	总经理：李先生	地址：福建省福州市连江县江南乡花坞村
连江县鸿运担保有限公司	总经理：陈先生	地址：福建省福州市连江县筱埕镇假日听海16号楼1604
福建省连江县盛世生猪养殖场	联系人：黄先生	地址：连江县蓼沿乡仁坂村桃园山
连江县远翔贸易有限公司	总经理：孙先生	地址：连江县东湖镇东湖村白厝尾38号
福建省春秋国际旅行社有限公司?头大众路营业部	老板：柳先生	地址：福建省福州市连江县?头镇大众中路17号
连江县苔?镇后湾村张滨善水产养殖场	联系人：张先生	地址：连江县苔?镇后湾村海滨路78号（养殖场所：后湾海区）
福州顺丰速运有限公司?头营业部	老板：邱保东	地址：连江县?头镇青芝大道2号青芝凤凰城1#楼1层15店面
连江县鑫林农业专业合作社	联系人：林先生	地址：连江县黄岐镇赤才村赤才141号三楼
连江县定海甘棠渔港建设发展有限公司	总经理：刘用忠	地址：连江县筱埕镇定海村护城西路1号
浙江稠州商业银行股份有限公司福州连江支行	联系人：程巧先生	地址：连江县县城区敖江路与丹凤路交叉口东南角玉沙综合商场
连江县隆昌水产品有限公司	总经理：郭云焘	地址：连江县苔?镇??村山仔
连江县苔?镇雄丰鲍鱼养殖基地	联系人：高向立	地址：连江县苔?镇后湾村海滨路58号
永辉超市股份有限公司福建连江贵安新天地超市	联系人：林小斌	地址：连江县潘渡乡沿江大道1号
福建省获丰网络科技有限公司连江分公司	总经理：陈树立	地址：连江县凤城镇金安西路2号龙芝国际商业广场地下1层1店面02号商铺
福州百弘珠宝有限公司	总经理：郑凤清	地址：连江县凤城镇东北街玉荷东路侨隆花园A区A#2层西单元
福建省中鼎?建设工程有限公司	总经理：李家铮	地址：连江县凤城镇816北路4#301
连江县君恒贸易有限公司	总经理：陈峰先生	地址：连江县敖江幕浦村口连黄路168号（连江县明顺贸易有限公司4号楼）
连江县君顺贸易有限公司	总经理：陈阿明	地址：连江县敖江幕浦村口连黄路168号（连江县明顺贸易有限公司2#楼）
福建省连江县海力威生物技术有限公司	总经理：姚英先生	地址：连江县安凯乡奇达村外澳路菜园下
福州屈臣氏个人用品商店有限公司连江816南路分店	老板：林先生	地址：福建省福州市连江县凤城镇816南路39号千彩银座首层1号店铺
嵩川（福州）贸易有限公司	总经理：罗先生	地址：连江县凤城镇丹凤东路15号丹凤花园23#楼504单元
连江县和一装潢工程有限公司	总经理：姚先生	地址：连江县凤城镇华光西路2号凤凰城10#楼1店面
连江县兴旺金属制品有限公司	总经理：范先生	地址：福建省连江县丹阳镇虎山村坪?4-13号
连江县天行商务信息咨询服务部	老板：陈先生	地址：连江县凤城镇玉山村玉荷西路592号
福建鸿正尚唐建筑装饰工程有限公司	总经理：胡先生	地址：连江县凤城镇金安东路2号龙芝御景5#楼1层6店面
福建工标建设发展有限公司	总经理：林先生	地址：连江县凤城镇莲荷西路1#楼一层14店面
连江县新天地贸易有限公司	总经理：游先生	地址：连江县贵安新天地贵邦苑沿街商铺6#、7#店面
连江县和谐物业服务有限公司	总经理：丁先生	地址：连江县凤城镇文山北路温麻公园大门南侧1#5号店
连江县豪运水产有限公司	总经理：杨先生	地址：连江县安凯乡沙澳村沙澳路7号
连江县透堡镇国球电脑维修店	老板：赖先生	地址：连江县透堡镇南街村下新村6号
连江县兴顺轮胎服务中心	联系人：薛先生	地址：连江县凤城镇西风路6号5号店面
连江县敖江镇小王食杂店	老板：王先生	地址：连江县敖江镇山亭村财桥路97号
连江县泓亿保洁服务有限公司	总经理：蔡先生	地址：连江县凤城镇丹凤西路2号宏宇花园8#一层13杂物间
连江县丹阳镇科农农业综合开发合作社	联系人：许先生	地址：连江县丹阳镇文朱村大丘头
连江县利万家液化石油气有限公司丹阳供应站	站长：陈振先生	地址：连江县丹阳镇丹阳村坪?果场
连江县苔?镇后湾村平岚鲍鱼育苗场	联系人：林木清	地址：连江县苔?镇后湾村平岚岛
福建浦鑫投资有限公司	总经理：郑礼广	地址：福建省连江县浦口镇浦丰街广西门楼113号
福建伙利置业有限公司	总经理：王敏芳	地址：连江县凤城镇西南街文明东路4号3#楼整座
福建省旅游有限公司黄岐营业部	老板：林素芝	地址：福州市连江县黄岐镇新城中路A-4
连江县鑫盛白蚁防治有限公司	总经理：林忠琅	地址：连江县凤城镇北门小区文明西路3#201
连江县井衣谷体育服务有限公司	总经理：黄宝桂	地址：连江县凯旋公馆B区3#201单元
连江县吉安建筑工程有限公司	总经理：林先生	地址：福建省福州市连江县敖江镇鲤鱼山村
连江县学佳水产养殖场	联系人：陈先生	地址：福建省福州市连江县马鼻镇南门村埭尾
连江县心雨鑫美容美发有限公司	总经理：乐景灿	地址：连江县凤城镇816中路与北门路交叉口（发利酒店）二层三层
连江县山水乐农农业开发有限公司	总经理：林水龙	地址：连江县潘渡乡潘渡村吓头里2号
福建海外旅游实业总公司连江营业部	老板：吴强先生	地址：连江县凤城镇丹凤东路15号丹凤花园7号楼5号店
中国工商银行股份有限公司连江金安支行	联系人：薛文希	地址：连江县凤城镇金安东路2号格林威治二区5#楼一层11号、12号店面和二层商业E区店面
福州润隆汽车贸易有限公司	总经理：林玉锬	地址：连江县凤城镇后洋巷税务新村201室
连江县下宫乡金品鲍鱼养殖场	联系人：洪先生	地址：连江县下宫乡江湾海区（鲍鱼海区第6区）
福建国艺园林建设工程有限公司连江分公司	总经理：陈先生	地址：连江县浦口镇浦东街浦南路5号2-3层
连江县丹阳镇兴顺车辆信息咨询部	老板：任先生	地址：连江县丹阳镇虎山村炕横厝2-15号
连江县坑园镇红下村曾玉赛香烛店	老板：曾先生	地址：连江县坑园镇红下村坂前路21号
连江县浦口镇洪燕日杂店	老板：孙先生	地址：连江县浦口镇浦江街旗新路42号
连江县凤城镇全城热恋婚纱摄影店	老板：林先生	地址：连江县凤城镇丹凤东路绿茵花园1#楼5号店面
连江县凤城镇响当当日杂店	老板：兰先生	地址：连江县凤城镇816东路华兴楼1#12店
连江县苔?镇林琴电信代办点	联系人：林先生	地址：连江县苔?镇苔?村后港西南路
连江县下宫乡百隆鲍鱼养殖场	联系人：廖先生	地址：连江县下宫乡江湾海区（鲍鱼海区第16区）
华润混凝土（连江）有限公司	总经理：潘先生	地址：福建省福州市连江县浦口镇塔头村
连江县凤城镇雅好房产中介服务中心	联系人：卞先生	地址：连江县凤城镇北门街莲荷西路4#楼第38店
连江县凤城镇丹比奴皮具店	老板：林先生	地址：连江县凤城镇金安西路2号龙芝商业广场2层3店面（2-3-10号专柜）
连江县凤城镇犀牛鞋店	老板：余先生	地址：连江县凤城镇金安西路2号龙芝国际商业广场1层9店面（1-9-5/1-9-6号商铺）
连江县?头镇刘依钗日用品零售店	老板：刘先生	地址：连江县?头镇宏源公寓B座102室
连江县丹阳镇福旺家具店	老板：黄先生	地址：连江县丹阳镇长光路1号楼
连江县?头镇稻草人皮具店	老板：陈先生	地址：连江县?头镇大众中路（青芝路口）金牛山广场永辉超市外租区A0225008柜位
连江县凤城镇飘艺理发会所	所长：邢先生	地址：连江县凤城镇丹凤东路15号丹凤花园29#楼14店面
连江县凤城镇卡丝造型理发店	老板：周先生	地址：连江县凤城镇丹凤东路绿茵花园1#7号店
连江县潘渡乡池恒平寿山石店	老板：池先生	地址：连江县潘渡乡贵安村贵龙路池恒平楼一楼
连江县凤城镇龙丰食品店	老板：庄先生	地址：连江县凤城镇凤尾花园凤园路20#12店
福建神海生物技术有限公司	总经理：吴先生	地址：连江县黄岐镇赤才村赤才167号
福建省沃特宝环保科技有限公司	总经理：王先生	地址：连江县丹阳镇山边村104国道边
连江县宗信担保有限公司	总经理：徐先生	地址：连江县敖江镇104国道西侧敖江投资区1#
连江县鑫银水产养殖有限公司	总经理：许先生	地址：连江县筱埕镇定海村
连江县益民生态农业专业合作社	联系人：吴国福	地址：连江县苔?镇北茭村渔港新区
连江县贵新会议服务有限公司	总经理：翁冰先生	地址：连江县凤城镇华光西路2号凤凰城11#楼1层11、12店面
连江县骏星企业管理有限公司	总经理：陈星华	地址：连江县凤城镇玉山村工业小区104道西侧2#一层
连江县顺安信息咨询有限公司	总经理：林金友	地址：连江县凤城镇玉荷西路2#A座306
连江县祥丰企业管理有限公司	总经理：余传泉	地址：连江县凤城镇玉山村工业小区104道西侧2幢楼2层
福建省金凤农业发展有限公司	总经理：邱有义	地址：连江县浦口镇益砌村公园新村35号
连江县可门口辉煌水产养殖专业合作社	联系人：阮建慧	地址：连江县下宫乡初芦村初芦52号2户
福建鼎正置业有限公司	总经理：林旺生	地址：连江县透堡镇南街村鱼山新村28号
福州泰宇混凝土有限公司连江分公司	总经理：郑捷先生	地址：连江县坑园镇屿头村金牌山
福州百姓长廊投资有限公司	总经理：陈树森	地址：连江县贵安新天地百姓长廊西廊2号（林姓店）
连江县?头镇祖海油漆店	老板：陈祖海	地址：连江县?头镇东升村大众南路193号东升1号楼第1间
连江县下宫乡下宫村龙娇原生态果场	联系人：陈崇权	地址：连江县下宫乡下宫乡后门山
连江县天竹畲寨旅游开发有限公司	总经理：雷金珠	地址：连江县东湖镇天竹村村委会二层
连江县黄岐镇瑞丰冷冻厂	厂长：林本清	地址：连江县黄岐镇海丰街丰辉路
福州?隆家具有限公司连江分公司	总经理：郭春兰	地址：连江县?头镇工业投资区5#钢结构工业厂房
连江县亿达物流有限公司	总经理：林剑	地址：连江县凤城镇文笔路1号
连江县兴连安安全消防器材有限公司	总经理：马建勇	地址：连江县凤城镇丹凤西路2号宏宇花园14#D16#13号店
连江县非凡贸易有限公司	总经理：余靖	地址：连江县凤城镇丹凤东路15号丹凤花园33#楼7号店面
福建省连江县东吴牧业有限公司	总经理：吴昊	地址：连江县东湖镇东塘村下洋片
福建省棕升纤维制品有限公司	总经理：陈祖嫩	地址：连江县丹阳镇东山村东下104国道边
福州轩怿水产有限公司	总经理：何	地址：连江县苔?镇后湾村朝阳路142号
福州文达水产有限公司	总经理：肖	地址：连江县黄岐镇后仑村西路41号
连江县?头镇翔鹰山庄大酒店	老板：黄	地址：连江县?头镇东边村玉峰路103号C座
福州市农电服务有限公司连江分公司	总经理：薛	地址：连江县凤城镇莲荷西路13#楼二楼（福建省连江县供电有限公司内）
中国民生银行股份有限公司福州连江支行	联系人：陈	地址：连江县凤城镇金安西路2号龙芝国际商业广场
福建江滨房地产开发有限公司	总经理：陈	地址：连江县凤城镇丹凤西路6号丽景华府小区2#楼2层
福州聚力达机电有限公司	总经理：董	地址：连江县敖江镇青塘村工业园区1#楼储存仓库
福州冈冶机电设备有限公司	总经理：吴海兵	地址：连江县凤城镇丹凤东路15号丹凤花园43#302单元
连江县富友农林开发有限公司	总经理：黄存财	地址：连江县凤城镇江滨路景江花园7#603
福建省连江县友好畅辉贸易有限公司	总经理：孙	地址：连江县?头镇门边村龙门路100号
连江县马鼻镇裕丰保温新型建材厂	厂长：陈	地址：连江县马鼻镇横厝村南坑里
福州国泰混凝土有限公司连江分公司	总经理：陈	地址：福州市连江县潘渡乡贵安村科技大楼
福建省连江县?头供销合作社蜗居之恋时尚家居用品店	老板：张	地址：连江县?头镇大众路（供销综合楼一层）
连江县苔?镇德敬鲍鱼场	联系人：何	地址：连江县苔?镇上塘村堤谷山
连江县新品农业机械设备有限公司	总经理：林	地址：连江县凤城镇金安西路22号西凤苑1#10号店
连江县青屿海顺水产育苗场	联系人：郑	地址：连江县马鼻镇南门村青屿
连江县马鼻镇邱治雄碾米加工厂	厂长：邱	地址：连江县马鼻镇文丰村中纵路36号
福州市鑫逵商贸有限公司连江分公司	总经理：连	地址：连江县凤城镇丹凤东路9#113店
福州力德水产有限公司	总经理：肖	地址：福建省连江县黄岐镇后仑村西路10号
福建中威建设工程质量检测有限公司	总经理：周	地址：连江县鳌江工业区富兴中路
福建盛扬实业有限公司	总经理：陈	地址：连江县海峡西岸水产品加工基地（连江县晓澳镇）
福建省浦口建筑工程有限公司连江?头分公司	总经理：程	地址：连江县?头镇东升村渔业新村286号楼
连江县裕友农场	联系人：郑秀玉	地址：连江县东湖镇东塘村东坪洋
连江县饰海装修设计工程有限公司	总经理：黄剑?	地址：连江县凤城镇文山北路7号金凤名都8#楼三层306单元
福州兆龙置业有限公司	总经理：黄兆光	地址：连江县敖江园区青龙路
福建省绿力农业综合开发有限公司	总经理：陈成乐	地址：连江县东湖镇东塘村口
连江县融敦水泥砖制业有限公司	总经理：林敦宏	地址：连江县马鼻镇村前村亭溪边
连江县鼎力房产营销代理有限公司	总经理：赵秋艳	地址：连江县凤城镇丹凤东路15号丹凤花园19座704室
福建省时代华奥建设发展有限公司	总经理：严敏	地址：连江县贵安经济开发区科技楼
福建省连江县奥隆房地产开发有限公司	总经理：严敏	地址：连江县贵安经济开发区科技楼
连江县东明渔业有限公司	总经理：陈华林	地址：连江县苔?镇秀邦村东街33号
福州韦炫商贸有限公司	总经理：刘文进	地址：连江县凤城镇丹凤西路2号宏宇花园9#楼302
福州六福村巴洛克摄影有限公司	总经理：张明娟	地址：连江县凤城镇文山北路5号太一新天地12#楼903单元
福州宏耀建筑劳务有限公司	总经理：瞿宜?	地址：连江县凤城镇北门街文明西路38#503
福州恒博汽车租赁服务有限公司	总经理：陈秀英	地址：连江县凤城镇莲荷东路37号102店
福建晴天电源科技有限公司连江分公司	总经理：陈淋	地址：连江县敖江镇青塘村工业园区
连江县泽惠水产冷冻厂	厂长：缪慈朗	地址：连江县东岱镇北门工业区
连江县凤城镇饶文昌小吃店	老板：饶文昌	地址：连江县凤城镇104国道边(招亮宾馆旁)
连江县凤城镇贴鑫内衣店	老板：杨青	地址：连江县凤城镇安盛大厦102店面
连江县凤城镇呐威儿童装店	老板：林孝景	地址：连江县凤城镇安盛大厦三层（A区）34号店
福州市鸿海船舶工程有限公司	总经理：郭新	地址：连江县凤城镇丹凤东路15号丹凤花园45#楼5店
福建省连江县东信电子有限公司	总经理：陈礼东	地址：连江县凤城镇丹凤花园四区44座7号车库
连江县凤城镇顺心家电维修店	老板：陈锦忠	地址：连江县凤城镇东北街816东路铁工厂1#楼第3店
福建省连江县炫辉新能源有限公司	总经理：严群	地址：连江县凤城镇文山北路5号太一新天地9#楼1502单元
福建省兴达农业机械有限公司	总经理：李云?	地址：连江县安凯乡高塘村港区
连江县丹阳镇山丹丹果蔬专业合作社	联系人：林碧端	地址：连江县丹阳镇山边村山边岗凤边岭
连江县蒙特恩物业管理有限公司	总经理：林雪莲	地址：连江县?头镇塘头龙城新村8#602室
连江县望江生态农业发展有限公司	总经理：林柏宝	地址：连江县?头镇寨洋村
连江县中凯贸易有限公司	总经理：王忠入	地址：连江县凤城镇东辉花园玫瑰楼203
龙泽海产养殖有限公司连江县分公司	总经理：于德华	地址：福州市连江县下宫乡下宫村（苔?镇后湾海域海带养殖区）
连江县鑫穗农民专业合作社	联系人：翁财?	地址：连江县东岱镇中洲岛
连江县双丰农民专业合作社	联系人：滕用双	地址：连江县浦口镇浦江街过浦路43号（经营场所另设）
连江县奇妙雕刻厂	厂长：杜聿自	地址：连江县晓澳镇道澳村北山路3-1号
连江县黄岐兴海旅游开发有限公司	总经理：林贤勋	地址：连江县黄岐镇马祖路85号
福州富盛新型环保建材有限公司	总经理：余亮	地址：连江县东湖镇人民政府五层会议室
福建省国安保安服务有限公司连江分公司	总经理：胡运生	地址：连江县凤城镇丹凤东路2号丹凤广场1#楼B座1502单元
福州京碧家具有限公司连江分公司	成立日期：2011/8/23	地址：连江县敖江投资区上高路下山地段连黄公路南侧公寓A座215房
连江县大足神农足浴城	成立日期：2011/8/23	地址：连江县凤城镇凤凰城2-3#楼连接体1-5店、3#楼7-12店
连江县好旺达超市百货经营部	成立日期：2011/8/23	地址：连江县江南乡华庆花园4-5楼一层（原农贸市场）超市百货区
连江县好旺达超市生鲜经营部	成立日期：2011/8/23	地址：连江县江南乡华庆花园4-5楼一层（原农贸市场）超市生鲜区
连江县坑园镇希望水产养殖专业合作社	成立日期：2011/8/23	地址：连江县坑园镇屿头村屿腰福新路6-1号
连江县滨海生态休闲农庄	成立日期：2011/8/23	地址：连江县浦口镇松坞村至山坑村
连江县明顺贸易有限公司	成立日期：2011/8/16	地址：连江县敖江镇幕浦村口连黄路168号
连江县丹阳镇大地飞歌娱乐城	成立日期：2011/8/16	地址：连江县丹阳镇104国道西侧12号楼
福州绿佳装潢工程有限公司	成立日期：2011/8/16	地址：连江县凤城镇丹凤东路2号丹凤广场1#楼A座702
连江县凤城镇我家聚餐园	成立日期：2011/8/16	地址：连江县凤城镇东渠路5号
福建省海鸿市政建设工程有限公司连江分公司	成立日期：2011/8/16	地址：连江县凤城镇凤尾花园28#1店
福建两岸茶业有限公司	成立日期：2011/8/16	地址：连江县凤城镇凤园路327号天和城14#16号
连江县凤城镇富豪爵西餐厅	成立日期：2011/8/16	地址：连江县凤城镇青年路78号鸿利公寓1#楼
福建省连江县恒汇供水设备有限公司	成立日期：2011/8/16	地址：连江县凤城镇天和城2#309室
连江县新世界百货商场	成立日期：2011/8/9	地址：连江县凤城镇江滨西路3号江夏苑1#店
连江县?头镇天蓝清洁服务中心	成立日期：2011/8/9	地址：连江县?头镇816路60号综合楼二楼
连江县?头镇闽山闽水大酒楼客房部	成立日期：2011/8/9	地址：连江县?头镇拱屿村综合楼九层
连江县?头镇闽山闽水大酒楼	成立日期：2011/8/9	地址：连江县?头镇拱屿村综合楼一层、三层
福建省鑫源伟业投资有限公司	成立日期：2011/8/5	地址：连江县凤城镇文山北路6号龙华花园12楼12层1201单元
连江县苔?镇忠和水产品经营部	成立日期：2011/8/2	地址：连江县苔?镇茭南村一岗山海边
连江县顺莺海水养殖场	成立日期：2011/8/2	地址：连江县苔?镇后湾村龟潭角
连江县黄岐镇赤沃村赤峰红石山鲍鱼场	成立日期：2011/8/2	地址：连江县黄岐镇赤沃村赤峰北路131号
连江县黄岐赤沃国荣鲍鱼场	成立日期：2011/8/2	地址：连江县黄岐镇赤沃村后山
连江县?头镇新紫金惠民大药房	成立日期：2011/8/2	地址：连江县?头镇下塘村开放路西侧一座
连江县供销再生资源有限公司湾边回收点	成立日期：2011/8/2	地址：连江县敖江镇小湾村原配合饲料厂空地内
连江县供销再生资源有限公司清溪磅边回收点	成立日期：2011/8/2	地址：连江县敖江镇清溪村104国道西向地磅边
连江县丹阳镇帆顺农业开发场	成立日期：2011/8/2	地址：连江县丹阳镇新洋村铁炉弯
连江县敖江幕浦石材制品厂	成立日期：2011/8/2	地址：连江县敖江镇福北公路段幕浦段公路边
连江县安凯乡安海安峰庆发养殖场	成立日期：2011/8/2	地址：连江县安凯乡安海村北山里
福州天和水产品有限公司	成立日期：2011/8/2	地址：连江县安凯乡半山村白沙
福州本林木业有限公司	成立日期：2011/8/1	地址：连江县?头镇华星花园104国道边2号楼103#B店面
福建天宏木业有限公司	成立日期：2011/8/1	地址：连江县丹阳镇坂顶村（金隆石材厂办公楼）
福建省连江县乐园农业有限公司	成立日期：2011/7/29	地址：连江县透堡镇西门村大溪里
福建大源投资发展有限公司	成立日期：2011/7/29	地址：连江县凤城镇北门小区文明西路双福楼503
福州恒信达汽车配件有限公司	成立日期：2011/8/26	地址：连江县?头镇工业投资区（1）-46工业用地
凤城宜进食杂店	null	地址：福建省福州市连江县凤城八一六北路
凤城依玉首布来料加工店	null	地址：福建省福州市连江县凤城镇爱民路２２号
凤城亚猴鱼具经营店	null	地址：福建省福州市连江县汽车站门市部
凤城学开木材店	null	地址：福建省福州市连江县新车站门市部
凤城新秋日杂店	null	地址：福建省福州市连江县八一六北路１５６号
凤城晓燕电料店	null	地址：福建省福州市连江县凤城镇八一六北路１１３号
凤星日杂店	null	地址：福建省福州市连江县凤城八一六南路４７号
凤新五交化经营部	null	地址：福建省福州市连江县城关外贸门市部
凤城小敏食杂店	null	地址：福建省福州市连江县凤城八一六北路１５号
凤城香株食杂店	null	地址：福建省福州市连江县凤城八一六北路１００号
凤城细妹食杂店	null	地址：福建省福州市连江县凤城镇玉荷东路１４号
凤城细美粮食店	null	地址：福建省福州市连江县凤城镇玉荷东路３４号
凤城锡桃小吃店	null	地址：福建省福州市连江县凤城北门市场
凤城卫平糕饼店	null	地址：福建省福州市连江县凤城北门路４７号
凤城通达食杂店	null	地址：福建省福州市连江县凤城八一六北路新车站对面第一间
凤城天亨老铺首布加工店	null	地址：福建省福州市连江县凤城玉荷东路１４号
凤城台资食杂店	null	地址：福建省福州市连江县凤城台资大楼门市部
凤城孙琴农机修理店	null	地址：福建省福州市连江县农校前面店内
凤城曙光装璜店	null	地址：福建省福州市连江县八一六北路１６３号企业局新村楼下
凤城叔平粮食复制品店	null	地址：福建省福州市连江县凤城北门市场新村
凤城赛华食杂店	null	地址：福建省福州市连江县文明路２１２号
凤城瑞兰窗帘加工店	null	地址：福建省福州市连江县凤城八一六北路９６号
凤城瑞安自行车店	null	地址：福建省福州市连江县凤城镇八一六北路５９号
凤城荣平冷作店	null	地址：福建省福州市连江县凤城文明西路８１号
凤城钦建小五交店	null	地址：福建省福州市连江县体育场对面店内
凤城奇福首布工艺品加工店	null	地址：福建省福州市连江县凤城玉荷东路２７号
凤城啤酒瓶回收站	null	地址：福建省福州市连江县凤城玉荷西路旧水泥厂隔壁
凤城潘依珠空压机店	null	地址：福建省福州市连江县城关莲荷西路康耀公寓１号楼
凤城隆发装璜经营部	null	地址：福建省福州市连江县凤城莲荷路
凤城刘得食杂店	null	地址：福建省福州市连江县县中医院门口
凤城凌通不锈钢制作店	null	地址：福建省福州市连江县莲荷西路金星楼５号
凤城林根金银首布加工店	null	地址：福建省福州市连江县凤城玉荷东路６号
凤城林芳日用品店	null	地址：福建省福州市连江县凤城镇玉荷东路１７号
凤城林成修表摊	null	地址：福建省福州市连江县凤城镇八一六东路２５号
凤城连星装璜材料店	null	地址：福建省福州市连江县物质公司北侧
凤城丽玉日用杂品店	null	地址：福建省福州市连江县凤城镇八一六北路１８６号
凤城丽芳小百店	null	地址：福建省福州市连江县凤城八一六北路４１号
凤城老三窗帘店	null	地址：福建省福州市连江县凤城镇玉荷西路２号楼１５间
凤城兰芳小百店	null	地址：福建省福州市连江县凤城八一六北路１０号
凤城克荣日杂店	null	地址：福建省福州市连江县凤城镇八一六北路５２号
凤城克强食杂店	null	地址：福建省福州市连江县北门集贸市场内１７号及１６号店面
凤城聚兴小百电器店	null	地址：福建省福州市连江县凤城镇玉荷路台资大楼
凤城锦莺食杂店	null	地址：福建省福州市连江县凤城解放路３８号楼西６号
凤城金仙日用杂品厂	null	地址：福建省福州市连江县凤城八一六北路１５８号
风城铝合金玻璃装璜部	null	地址：福建省福州市连江县八一六北路９７号
凤城江城铝材店	null	地址：福建省福州市连江县莲荷路工商局新村楼下
凤城剑武小百店	null	地址：福建省福州市连江县八一六北路９３号
凤城建明靴帽店	null	地址：福建省福州市连江县凤城玉荷西路３号
凤城惠珍食杂店	null	地址：福建省福州市连江县凤城玉荷西路３号楼
凤城辉煌装璜材料经营部	老板：陈友应	地址：福建省福州市连江县凤城镇文山路９０号
凤城环城标准店	null	地址：福建省福州市连江县凤城八一六北路１４８号
凤城华丽窗帘店	null	地址：福建省福州市连江县莲荷西路
凤城亨强灯具镜框店	null	地址：福建省福州市连江县凤城玉荷西路１号楼
凤城涵华小百店	null	地址：福建省福州市连江县凤城八一六北路９７号（连江新车站
凤城凤玉食杂店	null	地址：福建省福州市连江县凤城镇玉荷东路７号
凤城发松食杂店	null	地址：福建省福州市连江县凤城莲荷路康耀公寓１号楼
凤城大绿小百店	null	地址：福建省福州市连江县八一六北路
凤城存义日杂工具店	null	地址：福建省福州市连江县凤城镇八一六北路万福巷口
凤城春梅粮食复制品店	null	地址：福建省福州市连江县三建公司门市部
凤城传奋针纺店	null	地址：福建省福州市连江县凤城外贸公司门市部
凤城陈静食杂店	null	地址：福建省福州市连江县凤城八一六北路９８号
凤城昌贞玻璃加工店	null	地址：福建省福州市连江县凤城八一六北路１１１号
凤城昌元食杂店	null	地址：福建省福州市连江县凤城体育场边
凤城本东食杂店	null	地址：福建省福州市连江县凤城八一六北路９０号
凤城北门炉具店	null	地址：福建省福州市连江县凤城莲荷路新村
凤城敖北车站食杂店	null	地址：福建省福州市连江县新车站侯车室
凤城爱娇食杂店	null	地址：福建省福州市连江县凤城镇八一六北路新车站东面
边相际进	联系人：末果具	地址：福建省福州市连江县村丰
北门集贸市场	null	地址：福建省福州市连江县北门集贸市场３号楼１９店
福建省连江国盛塑胶制品有限公司	总经理：粱训国	地址：福建省福州市连江县晓沃镇长沙村
福建省连江工商事务服务中心	null	地址：福建省福州市连江县凤城镇文明东路２号
福建省连江福强建材有限责任公司	null	地址：福建省福州市连江县浦口镇浦东路东北街２８号
福建省连江凤都旅游开发有限公司	总经理：董丽珍	地址：福建省福州市连江县凤城镇玉山西门路２５７
福建省连江风华烘干厂	厂长：陈长新	地址：福建省福州市连江县苔录镇后湾村
福建省连江发利林果开发有限公司	总经理：陈发	地址：福建省福州市连江县潘渡乡仁山村廷溪洋
福建省连江东山贸易有限公司	总经理：姚朝勇	地址：福建省福州市连江县凤尾花园5号楼102室
福建省连江东明贸易有限公司	总经理：杨平	地址：福建省福州市连江县凤城镇玉荷西路１０＃楼２０６－２
福建省连江东湖企业集团宁德建设工程公司	null	地址：福建省福州市连江县东湖镇
福建省连江创伟贸易有限公司	null	地址：福建省福州市连江县凤城莲荷东路１号楼７０６
福建省连江诚丰贸易有限公司	null	地址：福建省福州市连江县潘渡乡贵安村
福建省连江百胜山地综合开发有限公司	null	地址：福建省福州市连江县晓沃镇百胜村永泰路５５号
福建省连江百胜供水厂	厂长：池和银	地址：福建省福州市连江县晓沃镇百胜村
福建省汽车运输总公司连江公司	总经理：张振忠	地址：福建省福州市连江县八一六北路58号
福建省汽车运输总公司丹阳运输站	null	地址：福建省福州市连江县丹阳镇
福建省连江中岩石品厂	null	地址：福建省福州市连江县潘渡乡白莲
福建省连江中闽实业有限公司	总经理：魏增旺	地址：福建省福州市连江县凤城镇８１６北路
福建省连江中美实业有限公司	null	地址：福建省福州市连江县凤城八一六北路１４８号
福建省连江招亮服务有限公司	总经理：谢锦曲	地址：福建省福州市连江县１０４国道玉山修车场
福建省连江源华贸易有限公司	总经理：余章秋	地址：福建省福州市连江县城关莲荷东路8号楼704房
福建省连江余氏打磨钻石机械工具有限公司	总经理：庄美英	地址：福建省福州市连江县凤城镇玉荷东路３８号
福建省连江永兴气体抱警器有限公司	null	地址：福建省福州市连江县东岱镇东兴大街
福建省连江永和实业有限公司	总经理：庄志雄	地址：福建省福州市连江县浦口镇塔头村天街2号
福建省连江盈都贸易有限公司	总经理：孙凤如	地址：福建省福州市连江县交通局新村304房
福建省连江信达电脑服务有限责任公司	总经理：吴兆庆	地址：福建省福州市连江县凤城镇莲荷西路22座303室
福建省连江鑫圣水产综合开发有限公司	null	地址：福建省福州市连江县凤城莲荷路北岳大厦五层
福建省连江鑫隆贸易有限公司	总经理：刘必友	地址：福建省福州市连江县莲荷东路１５号３０２
福建省连江鑫荟园艺有限公司	总经理：刘必勇	地址：福建省福州市连江县江南乡江南村
福建省连江新都贸易有限公司	null	地址：福建省福州市连江县凤城镇文山路１５３号华侨新村２０
福建省连江县州洋有限公司	null	地址：福建省福州市连江县凤城八一六南路和同巷４号
福建省连江县中医药学会	联系人：郑淮锋	地址：福建省福州市连江县中医院
连江县计划生育局	局长：陈久嵩	地址：福建省福州市连江县县政府大楼
连江县计划局	null	地址：福建省福州市连江县政府大楼
连江县机动车驾驶员安全教育所	null	地址：福建省福州市连江县交警大队院内
连江县黄岐中心市场	联系人：林勋	地址：福建省福州市连江县黄岐镇海滨路
连江县黄岐中心法律服务所	所长：叶世光	地址：福建省福州市连江县黄岐镇新兴路122号
连江县黄岐镇农业机械管理站	null	地址：福建省福州市连江县黄岐镇政府
连江县黄岐镇村居主干福利基金会	联系人：林乃俊	地址：福建省福州市连江县黄岐镇政府内
连江县黄岐镇车辆停靠管理站	站长：林勋	地址：福建省福州市连江县黄岐镇车站
连江县黄岐兴海私立学校	null	地址：福建省福州市连江县黄岐镇海丰街
连江县黄岐海洋特种养殖实验场	null	地址：福建省福州市连江县黄岐镇赤才村毕与湾
连江县黄岐海盛鲍鱼场	联系人：吴明谊	地址：福建省福州市连江县黄岐镇赤才村
连江县黄岐海岛建设工程指挥部	null	地址：福建省福州市连江县黄岐镇海丰街
连江县黄岐对台贸易管理站	null	地址：福建省福州市连江县黄岐码头
连江县环境科学学会	联系人：江进荣	地址：福建省福州市连江县凤城镇凤园路18号
连江县环境监测站	站长：陈淑贞	地址：福建省福州市连江县凤城镇凤园路18号
连江县环境保护局	局长：江进荣	地址：福建省福州市连江县凤城镇凤园路18号
连江县化工建材公司	null	地址：福建省福州市连江县凤城镇８１６北路９７号
连江县华达海产加工厂	null	地址：福建省福州市连江县下宫乡初芦村
连江县鸿达贸易有限公司	总经理：林世开	地址：福建省福州市连江县８１６北路１６号楼（汽车站对面）
连江县禾盛粮油食品五店	null	地址：福建省福州市连江县凤城农贸市场口
连江县海天娱乐渡假有限公司	总经理：邱英端	地址：福建省福州市连江县晓沃新区道胜路８号
连江县海峰石材经营部	null	地址：福建省福州市连江县敖江镇下山村大众路１７０号
连江县海滨海珍品养殖场	联系人：林振恩	地址：福建省福州市连江县黄岐镇海建街九壁里
连江县国债服务部	null	地址：福建省福州市连江县凤城镇玉荷东路４７号
连江县贵源贸易有限公司	总经理：王景春	地址：福建省福州市连江县城关凤尾花园７＃楼５０２
连江县贵岐中发石油经营部	null	地址：福建省福州市连江县贵岐海丰街
连江县贵安明胜水资源开发有限公司	总经理：黄宝明	地址：福建省福州市连江县潘渡乡贵安村
连江县贵安和旺鳗业服务部	null	地址：福建省福州市连江县潘渡乡贵安村
连江县官头渔港劳动服务部城关救生筏检修站	null	地址：福建省福州市连江县凤城镇文明西路１８号
连江县官岭忠盛门窗厂	厂长：谢木伙	地址：福建省福州市连江县浦口镇官岭村丘东路５４号
连江县供销合作社联合社	联系人：周孝文	地址：福建省福州市连江县凤城镇东城路６号
连江县福兴五金交电经营部	null	地址：福建省福州市连江县晓沃新区振兴路３７－６
连江县扶贫工作领导小组办公室	null	地址：福建省福州市连江县城关八一六北路８１号
连江县扶残助残促进会	联系人：陈起栋	地址：福建省福州市连江县凤城镇文山路１号楼
连江县凤佳服装发展有限公司	null	地址：福建省福州市连江县凤城镇北门外
连江县凤城珠端自行车店	null	地址：福建省福州市连江县凤城镇八一六北路２１号
连江县凤城稚贞机械加工店	null	地址：福建省福州市连江县汽车修配厂
连江县凤城镇玉山村经济合作社	null	地址：福建省福州市连江县凤城镇玉山村
连江县凤城镇西南街劳务队	null	地址：福建省福州市连江县城关西南街中山路２７号
连江县凤城镇西南街环境卫生	null	地址：福建省福州市连江县凤称镇西南街中山路２７号
连江县凤城镇退休基金会	null	地址：福建省福州市连江县凤城镇经济巷３１号
连江县凤城镇社会治安综合治理委员会	联系人：王同生	地址：福建省福州市连江县凤城镇人民政府院内
连江县凤城镇企业管理站	站长：郑忠荣	地址：福建省福州市连江县凤城镇经济巷３１号
连江县凤城镇企业办公室	null	地址：福建省福州市连江县凤城镇经济巷３１号
连江县凤城镇明兴文具用品店	老板：林应明	地址：福建省福州市连江县凤城镇８１６北路２２１号
连江县凤城镇绿茵村新江生产队	null	地址：福建省福州市连江县凤城镇北门
连江县凤城镇绿茵村新丰生产队	null	地址：福建省福州市连江县凤城镇绿茵村
连江县凤城镇劳动就业服务站	null	地址：福建省福州市连江县凤城镇西北街经济巷３１号
连江县凤城镇旧城改建办公室	null	地址：福建省福州市连江县凤城镇旧城改建办公室
连江县凤城镇凤园街卫生组	联系人：林淑端	地址：福建省福州市连江县凤尾花园４６＃２０１房
连江县凤城镇凤凰车店	null	地址：福建省福州市连江县凤城镇八一六北路２６号
连江县凤城镇东南街清洁组	联系人：陈建新	地址：福建省福州市连江县凤城镇东南街建国路５９号
连江县凤城镇成康鳗药经营部	null	地址：福建省福州市连江县莲荷西路
连江县凤城镇陈玲家用电器维修店	老板：陈玲	地址：连江县凤城镇莲荷东路１０号店
连江县凤城源兴水产品经营部	null	地址：福建省福州市连江县凤城镇莲荷路康耀公寓１号楼５０８
连江县凤城勇峰电焊店	null	地址：福建省福州市连江县凤城西南街中山路１２５号
连江县凤城永固橡胶工业经营部	null	地址：福建省福州市连江县新汽车站正对面１０２室
连江县凤城信武汽车修理店	老板：吴信武	地址：福建省福州市连江县石油公司西侧
连江县凤城西南布鞋加工厂	null	地址：福建省福州市连江县凤城镇西南街中山路６５号
连江县凤城维勇木材店	null	地址：福建省福州市连江县凤城镇文山路４号
连江县凤城松芳日杂店	老板：许松芳	地址：福建省福州市连江县凤城镇八一六东路六号
连江县凤城石马首饰加工厂	厂长：黄勇福	地址：福建省福州市连江县凤城镇北门新区文明东路５号楼２０１室
连江县凤城神兴管材店	null	地址：福建省福州市连江县凤城莲荷路北新新村
连江县凤城榕平蓄电经营店	null	地址：福建省福州市连江县凤城体育场游池前面店
连江县凤城南门食杂店	null	地址：福建省福州市连江县八一六南路１６号
连江县凤城明凤气体供应站	站长：孙坦	地址：福建省福州市连江县凤城玉荷西路２７１号
连江县凤城闽海贸易商行	null	地址：福建省福州市连江县凤城镇玉荷西路
连江县凤城联达器材店	老板：陈妫春	地址：福建省福州市连江县物资局楼下第一间
连江县凤城聚鲜馆	联系人：郑云	地址：福建省福州市连江县凤城镇玉荷东路１４３号
连江县凤城佳乐日用杂品店	null	地址：福建省福州市连江县物资公司门市部
连江县凤城鸿兴文印店	null	地址：福建省福州市连江县凤城八一六中路６７号
连江县凤城弘泰家电制冷店	老板：吴京燕	地址：福建省福州市连江县凤城８１６北路１号
连江县凤城亨达鱼网店	null	地址：福建省福州市连江县敖江信用社门市部
连江县凤城和标音响家电店	老板：叶和标	地址：福建省福州市连江县凤城莲荷西路连结体３号店
连江县凤城光明灰加工店	null	地址：福建省福州市连江县塑料包装厂边
连江县凤城恭盛汽车钣金维护店	null	地址：福建省福州市连江县凤城镇玉山停车场
连江县凤城法律事务所	所长：曾贤钢	地址：福建省福州市连江县凤城镇人民政府
连江县凤城春芳小百货	null	地址：福建省福州市连江县石油综合楼第５间
连江县凤城车行自行车贸易商场	null	地址：福建省福州市连江县凤城镇玉荷西路６号
连江县凤城车行车辆贸易分行	null	地址：福建省福州市连江县凤城镇玉荷西路１３号
连江县凤城北门食品原料门市部	老板：杨惠芳	地址：福建省福州市连江县凤城镇北门路47号
连江县凤城板绿麻竹生产基地	联系人：张锦其	地址：福建省福州市连江县潘渡乡坡西村
连江县风城大圣宝饮料良品厂	null	地址：福建省福州市连江县风城镇青年路７８号
连江县反偷私渡教育中心	联系人：林宝明	地址：福建省福州市连江县凤城镇武警大队
连江县二轻劳动服务经理部	null	地址：福建省福州市连江县凤城玉荷东路１４２号
连江县东水学校	null	地址：福建省福州市连江县东岱镇东水村
连江县东湖祖循农具修配店	null	地址：福建省福州市连江县东湖镇
连江县东湖珠宝玉器加工厂	null	地址：福建省福州市连江县东湖镇洋门村
连江县东湖镇洋门村经济合作社	联系人：廖慎贵	地址：福建省福州市连江县东湖镇洋门村经济合作社
连江县东湖乡天竹村经济合作社	联系人：雷益南	地址：福建省福州市连江县东湖乡天竹村
连江县东湖乡牛栏坪村经济合作社	null	地址：福建省福州市连江县东湖镇牛栏坪村
连江县东湖乡湖坪村经济合作社	null	地址：福建省福州市连江县东湖镇政府湖坪村
连江县东湖乡飞石村经济合作社	null	地址：福建省福州市连江县东湖镇飞石村
连江县东湖乡东塘村经济合作社	联系人：吴品奎	地址：福建省福州市连江县东湖乡东塘村
连江县东湖乡东湖村经济合作社	null	地址：福建省福州市连江县东湖镇东湖村
连江县东湖乡祠台村经济合作社	null	地址：福建省福州市连江县东湖镇祠台村
连江县东岱镇洋西村经济合作社	null	地址：福建省福州市连江县东岱镇洋西村
连江县东岱镇山堂村委员会	null	地址：福建省福州市连江县山堂村
连江县东岱镇农业机械管理站	null	地址：福建省福州市连江县东岱镇人民政府
连江县东岱镇流动人口管理工作协调小组办公室	null	地址：福建省福州市连江县东岱镇人民政府
福建省连江县五交化公司交电商店	老板：耿小明	地址：福建省福州市连江县凤城８１６南路６３号
连江县丹阳副食品合作商店	null	地址：福建省福州市连江县丹阳镇丹阳旧街
福建省连江县筱埕京杂合作商店	null	地址：福建省福州市连江县筱埕村大街
连江县城关副食品综合商店	null	地址：福建省福州市连江县凤城镇八一六南路３２号
福建省连江县城关红光商店	null	地址：福建省福州市连江县凤城镇八一六北路１０号
凤城秀珍百货店	null	地址：福建省福州市连江县凤城八一六北路４０号
凤城亚兰百货店	null	地址：福建省福州市连江县敖江运输公司
连江县佳丽装饰商店	null	地址：福建省福州市连江县凤城莲荷路１４号
凤城新星五交水暖材料商店	null	地址：福建省福州市连江县凤城镇八一六北路１０２号
凤城爱珠小百货店	null	地址：福建省福州市连江县北岳大厦
凤城小百商店	null	地址：福建省福州市连江县凤城玉荷东路１７号
连江县城关寿板合作商店	null	地址：福建省福州市连江县城关新连路１５号
凤城秀芳百货商店	null	地址：福建省福州市连江县北门集贸市场
凤城先锋商店	null	地址：福建省福州市连江县凤城镇北路４４号
连江县凤城金辉五交商店	null	地址：福建省福州市连江县凤城北门市场
凤城凤翔装璜装饰商店	null	地址：福建省福州市连江县物资局旁边装璜店
凤城立云化妆商店	null	地址：福建省福州市连江县百货大楼外陈列柜
凤城同乐家电商店	null	地址：福建省福州市连江县凤城新村楼下第八间
连江县凤城闽凤家电商店	null	地址：福建省福州市连江县凤城八一六北路陈第公园门口
凤城来来百货店	null	地址：福建省福州市连江县凤城八一六北路３０号
凤城源远百货商店	null	地址：福建省福州市连江县西北街八一六北路２８号
凤城三友小百货店	null	地址：福建省福州市连江县新车站南侧
凤城小红小百商店	null	地址：福建省福州市连江县凤城八一六北路４４号
凤城淑英日杂商店	null	地址：福建省福州市连江县凤城八一六北路３４号
凤城时韵商店	null	地址：福建省福州市连江县凤城八一六北路４４号
凤城再洪百货店	null	地址：福建省福州市连江县莲荷路６号
风城好再来商店	null	地址：福建省福州市连江县粮油公司综合楼门市部
凤城蓝月亮时装商店	null	地址：福建省福州市连江县凤城玉荷西路２号楼
连江县凤城光明五交化商店	null	地址：福建省福州市连江县凤城镇八一六北路西侧１０１号
连江县凤城万事达商店	null	地址：福建省福州市连江县凤城８１６南路
凤城东平陶瓷商店	null	地址：福建省福州市连江县凤城镇玉荷西路１４间
凤城李芝时装商店	null	地址：福建省福州市连江县粮油工业公司门市部
建兰日杂商店	null	地址：福建省福州市连江县凤城北门集贸市场门口２号楼北２店
凤城再辉百货店	null	地址：福建省福州市连江县新车站
文标日用百货店	null	地址：福建省福州市连江县敖江建筑公司门市部
凤城恒丰小百商店	null	地址：福建省福州市连江县凤城玉荷东路３号
连江县凤城日日新交电商店	null	地址：福建省福州市连江县城关河乾新村４号店面
连江县凤城金凤家私装饰商店	null	地址：福建省福州市连江县凤城莲荷路十字路口西北侧
连江县敖江新华钢材商店	null	地址：福建省福州市连江县凤城八一六路新车站对面
连江县糖酒副食品公司第三零售商店	null	地址：福建省福州市连江县城关八一六东路１６号
连江县凤城希望书店	null	地址：福建省福州市连江县凤城玉荷东路水关口２号
凤城守忠书店	null	地址：福建省福州市连江县凤城镇玉荷东路水关口２号
凤城惠芳鞋帽店	null	地址：福建省福州市连江县凤城镇玉荷东路１７号
凤城丝丝化妆品店	null	地址：福建省福州市连江县凤城集贸市场
凤城时忠眼镜店	null	地址：福建省福州市连江县凤城八一六北路１１０号
福建省连江县凤城齐豪纸品经销部	null	地址：福建省福州市连江县北门路农机修造厂院内
凤城豪华眼镜店	null	地址：福建省福州市连江县八一六北路新书店第六间
凤城多多书店	null	地址：福建省福州市连江县凤城镇八一六东路２２３号
福建省连江县丽华钟表店	null	地址：福建省福州市连江县凤城镇玉荷西路３号
凤城淑英鞋店	null	地址：福建省福州市连江县城关八一六北路才溪水电站新村楼下
城关雅贞鞋店	null	地址：福建省福州市连江县邮电局左侧第二间
凤城连生鞋店	null	地址：福建省福州市连江县凤城八一六北路７９号
连江县凤城北门建材店	null	地址：福建省福州市连江县凤城八一六北路（北门外）
连江县北岳建材经营部	null	地址：福建省福州市连江县敖江镇北岳停车场边
连江县凤城新发建材店	null	地址：福建省福州市连江县敖江供销社
连江县凤城凤达建材经营部	null	地址：福建省福州市连江县新车站东大门口１号店面
连江县浦口辉煌建材经营部	老板：陈承保	地址：福建省福州市连江县浦口街
凤城车站灯具店	null	地址：福建省福州市连江县才溪水电站门市部
连江县凤城实惠灯具店	null	地址：福建省福州市连江县凤城镇玉荷西路１号楼
凤城娟英玻璃店	null	地址：福建省福州市连江县凤城镇八一六北路１０５号
凤城光坚其它副食品店	null	地址：福建省福州市连江县企业局新村楼下
福建省连江县玉山菜场	联系人：郑飚	地址：福建省福州市连江县凤城镇玉山村
连江县糖酒副食品公司副食品经营部	老板：吴本明	地址：福建省福州市连江县敖江镇北岳莲荷西路
连江县道沃兵妹其他付食品店	null	地址：福建省福州市连江县晓沃镇道沃村
连江县凤城裕达副食品商店	null	地址：福建省福州市连江县北门垦区综合楼B座
凤城北门副食品商店	null	地址：福建省福州市连江县凤城莲荷路工商局宿舍第一层
凤城福兴五金店	null	地址：福建省福州市连江县凤城八一六北路１２４号
连江县凤城凤翔食品店	老板：陈义锦	地址：福建省福州市连江县城关莲荷西路６６号
连江县糖酒副食品公司第五零售商店	null	地址：福建省福州市连江县凤城农贸市场１号楼一层西侧
连江县丹阳百货合作商店	null	地址：福建省福州市连江县丹阳百货合作商店
刘必胜食品店	null	地址：福建省福州市连江县三建公司门市部
凤城玉妹食品店	null	地址：福建省福州市连江县城关镇北岳停车场前面第８间
连东县浦口便民加油站	null	地址：福建省福州市连江县浦口镇浦口车站
福建省连江山仔水利枢纽开发公司加油站	null	地址：福建省福州市连江县潘渡乡贵安
福建省连江县东岱镇东水柴油加油站	null	地址：福建省福州市连江县东岱镇东水新村
连江县浦口柴油加油站	站长：陈如顺	地址：福建省福州市连江县浦口镇浦升村星丰路３号
贵安加油站	null	地址：福建省福州市连江县潘渡乡贵安村
连江县丹阳镇丹凤加油站	null	地址：福建省福州市连江县丹阳镇旺村桥头
福建省连江县筱埕蛤沙柴油加油站	站长：魏文德	地址：福建省福州市连江县筱埕镇蛤沙村
凤城车站五金店	null	地址：福建省福州市连江县物资公司门市部
福建省连江县糖酒副食品公司第七零售商店	null	地址：福建省福州市连江县城关八一六西路１０２号
连江县凤城庆仙水暖建材店	null	地址：福建省福州市连江县凤城镇八一六北路１００号
福建华榕超市集团有限公司连江分公司	null	地址：福建省福州市连江县凤城镇玉荷西路
福建省石油公司连江支公司桂林加油站	null	地址：福建省福州市连江县丹阳镇
连江县凤城美如药店	null	地址：福建省福州市连江县凤城镇玉荷东路７０号
连江县凤城连忠医药商店	null	地址：福建省福州市连江县广播电台门市部
福建省连江县第一运输公司加油站	null	地址：福建省福州市连江县敖江乡魁歧村
福建省石油总公司连江支公司魁岐加油站	null	地址：福建省福州市连江县敖江乡魁岐村
连江县百货公司批发部	老板：吴洛华	地址：福建省福州市连江县凤城镇莲荷东路２栋
福建省连江县马鼻昌源炉具家电经营部	null	地址：福建省福州市连江县马鼻街
连江县凤城光明灯饰家电城	联系人：藤家禧	地址：福建省福州市连江县金星商厦一层
连江凤城华宝空调专营店	null	地址：福建省福州市连江县凤城华宝空调专营店
凤城新只瓷砖涂料店	null	地址：福建省福州市连江县凤城莲荷路６号楼
凤城明沿首布工艺品店	null	地址：福建省福州市连江县凤城镇玉荷西路
连江县凤城环岛建材经营部	null	地址：福建省福州市连江县凤城镇八一六北路（车站加油站店面
连江县凤城春惠建材经营部	null	地址：福建省福州市连江县凤城镇莲荷东路５座１１间
福建省连江县马鼻镇墙兜村柴油加油站	站长：陈为环	地址：福建省福州市连江县马鼻镇墙兜村
连江县北茭乐国加油站	null	地址：福建省福州市连江县苔录镇北茭村
福建省连江县浦口镇山坑村延辉加油站	站长：陈延国	地址：福建省福州市连江县浦口镇山坑村
福建省连江县燃料公司加油站	null	地址：福建省福州市连江县凤城镇北岳白洋１０４国道边
连江县透堡中学工会委员会	null	地址：福建省福州市连江县透堡镇塘里
福建省连江县荷山中学	null	地址：福建省福州市连江县敖江镇浦下村荷山
连江县敖南中学食堂	null	地址：福建省福州市连江县敖江镇南塘村
连江县安凯中学	null	地址：福建省福州市连江县安凯村
连江县百胜小学	null	地址：福建省福州市连江县晓沃镇万胜村
连江县海新小学	null	地址：福建省福州市连江县黄岐镇海新小学
连江县丹阳中心小学（学区）	联系人：叶万鹏	地址：福建省福州市连江县丹阳镇新街２号
连江县下宫中心小学	null	地址：福建省福州市连江县下宫
连江县海丰小学	null	地址：福建省福州市连江县黄岐海丰街
连江县透堡中心小学	校长：钟宝灿	地址：福建省福州市连江县透堡镇北街村
连江县拱头小学	null	地址：福建省福州市连江县马鼻镇
连江县海英小学	null	地址：福建省福州市连江县黄岐镇英才路７２号
福州市连江县技工学校	null	地址：福建省福州市连江县城关北门外青塘水田技工学校
福建省连江县农业机械化技术学校	校长：吴黎明	地址：福建省福州市连江县郊县良种场隔墙
连江县水产职业中学	null	地址：福建省福州市连江县坑园乡
连江县实验中心幼儿园	联系人：骆连	地址：福建省福州市连江县凤城镇八一六东路
连江县建筑技术培训中心	联系人：陈祖赛	地址：福建省福州市连江县凤城镇文民东路３３号
连江县江南中心小学	校长：陈推	地址：福建省福州市连江县江南乡江南村
连江县少年儿童体育学校	null	地址：福建省福州市连江县凤城镇西北街县陈第公园内
连江定海小学	null	地址：福建省福州市连江县筱埕镇定海村
连江县辰山小学	null	地址：福建省福州市连江县马鼻镇辰山村
连江县红厦小学	null	地址：福建省福州市连江县坑园乡红厦
连江县下园小学	null	地址：福建省福州市连江县坑园乡下园村
连江县敖江中心小学	校长：吴速建	地址：福建省福州市连江县敖江镇百沙村
连江县前屿小学	校长：颜台涛	地址：福建省福州市连江县坑园乡前屿小学
连江县透堡镇塘里村民委员会	null	地址：福建省福州市连江县透堡镇塘里村
连江县安凯乡奇达村民委员会	null	地址：福建省福州市连江县安凯乡奇达村
连江县潘渡乡朱步村民委员会	null	地址：福建省福州市连江县潘渡乡朱步村
连江县坑园乡坑园村民委员会	null	地址：福建省福州市连江县坑园乡坑园村
连江县儒洋村民委员会	null	地址：福建省福州市连江县儒洋村
连江县潘渡乡仁山村民委员会	null	地址：福建省福州市连江县潘渡乡仁山村
连江县敖江镇澄岩村民委员会	null	地址：福建省福州市连江县敖江镇澄岩村
连江县马鼻镇村前村民委员会	null	地址：福建省福州市连江县马鼻镇村前村
连江县筱埕镇大埕村民委员会	null	地址：福建省福州市连江县筱埕镇大埕村
连江县马鼻镇横厝村民委员会	null	地址：福建省福州市连江县马鼻镇横厝村
连江县蓼沿乡蒲边村民委员会	null	地址：福建省福州市连江县蓼沿乡蒲边村
连江县敖江镇已古村民委员会	null	地址：福建省福州市连江县敖江镇已古村
连江县敖江镇小湾村民委员会	null	地址：福建省福州市连江县敖江镇小湾村
连江县浦口镇中麻村民委员会	null	地址：福建省福州市连江县浦口镇中麻村
连江县透堡镇陇柄村民委员会	null	地址：福建省福州市连江县透堡镇陇柄村
连江县潘渡乡潘渡村民委员会	null	地址：福建省福州市连江县潘渡乡潘渡村
连江县马鼻镇浮曦村民委员会	null	地址：福建省福州市连江县马鼻镇浮曦村
连江县透堡镇南街村民委员会	null	地址：福建省福州市连江县透堡镇南街村
连江县敖江镇幕浦村民委员会	null	地址：福建省福州市连江县敖江镇幕浦村
连江县凤城镇绿茵村民委员会	联系人：杨增健	地址：福建省福州市连江县莲荷西路５号楼
连江县敖江镇花乌村民委员会	null	地址：福建省福州市连江县敖江镇花乌村
连江县敖江镇石头村民委员会	null	地址：福建省福州市连江县敖江镇石头村
连江县安凯乡同心村民委员会	null	地址：福建省福州市连江县安凯乡同心村
连江县筱埕镇官乌村民委员会	null	地址：福建省福州市连江县筱埕镇官乌村
连江县下宫乡大洋村民委员会	null	地址：福建省福州市连江县下宫乡大洋村民委员会
连江县敖江镇北岳村民委员会	null	地址：福建省福州市连江县敖江镇北岳村
连江县敖江镇毗田屯村民委员会	联系人：张学枢	地址：连江县敖江镇毗田屯村
连江县江南乡连沙村民委员会	联系人：谢枝新	地址：福建省福州市连江县江南乡连沙白沙楼
连江县敖江镇南塘村民委员会	null	地址：福建省福州市连江县敖江镇南塘村
连江县敖江镇镜路村民委员会	null	地址：福建省福州市连江县敖江镇镜路村
连江县敖江镇长汀村民委员会	null	地址：福建省福州市连江县敖江镇长汀村
连江县敖江镇文新村民委员会	null	地址：福建省福州市连江县敖江镇文新村
连江县敖江镇岱云村民委员会	null	地址：福建省福州市连江县敖江镇岱云村
连江县敖江镇王庄村民委员会	null	地址：福建省福州市连江县敖江镇王庄村
连江县浦口镇官岭村民委员会	null	地址：福建省福州市连江县浦口镇官岭村
连江县坑园乡红下村民委员会	null	地址：福建省福州市连江县坑园乡红下村
连江县安凯乡安海村民委员会	null	地址：福建省福州市连江县安凯乡安海村
连江县潘渡乡溪利村民委员会	null	地址：福建省福州市连江县潘渡乡溪利村
连江县潘渡乡兰山村民委员会	null	地址：福建省福州市连江县潘渡乡兰山村
连江县东岱镇关头村委会	null	地址：福建省福州市连江县东岱镇关头村
连江县敖江镇连登村民委员会	null	地址：福建省福州市连江县敖江镇连登村
连江县黄岐镇大谷村民委员会	联系人：高孔庆	地址：福建省福州市连江县黄岐镇大谷村
连江县敖江镇浦下村民委员会	null	地址：福建省福州市连江县敖江镇浦下村
连江县公安局透堡派出所	所长：杨孝成	地址：福建省福州市连江县透堡镇南街村
福建省连江县广播电视局音像发行站	null	地址：福建省福州市连江县广播电视局
连江县敖江镇计划生育办公室	null	地址：福建省福州市连江县凤城镇经济巷
连江县敖江镇横槎村民委员会	null	地址：福建省福州市连江县敖江镇横槎村
连江县筱埕镇筱埕村民委员会	null	地址：福建省福州市连江县筱埕镇筱埕村民委员会
连江县马鼻镇合峰村民委员会	null	地址：福建省福州市连江县马鼻镇合峰村
连江县透堡镇馆读村民委员会	null	地址：福建省福州市连江县透堡镇馆读村
连江县筱埕镇历乌村民委员会	null	地址：福建省福州市连江县筱埕镇历乌村
凤城镇玉山村民委员会	联系人：郑本秋	地址：福建省福州市连江县凤城镇玉荷西路凤城中学旁边
连江县苔录镇茭南村民委员会	null	地址：福建省福州市连江县苔录镇茭南村
连江县马鼻镇辰山村民委员会	null	地址：福建省福州市连江县马鼻镇辰山村
连江县安凯乡高塘村民委员会	null	地址：福建省福州市连江县安凯乡高塘村
连江县蓼沿乡后坂村民委员会	null	地址：福建省福州市连江县蓼沿乡后坂村
连江县苔录镇后湾村民委员会	null	地址：福建省福州市连江县苔录镇后湾村
连江县潘渡乡塘坂村民委员会	联系人：兰倍利	地址：福建省福州市连江县潘渡乡塘坂村
连江县东岱镇东水村民委员会	null	地址：福建省福州市连江县东岱镇东水村
连江县敖江镇梅洋村民委员会	null	地址：福建省福州市连江县敖江镇梅洋村
连江县苔录镇横塍村民委员会	null	地址：福建省福州市连江县苔录镇横塍村
连江县安凯乡沙沃村民委员会	null	地址：福建省福州市连江县安凯乡沙沃村
连江县潘渡乡东雁村民委员会	null	地址：福建省福州市连江县潘渡乡东雁村
连江县苔录镇北茭村民委员会	null	地址：福建省福州市连江县苔录镇北茭村
连江县晓沃镇长沙村民委员会	null	地址：福建省福州市连江县晓沃镇长沙村
连江县敖江镇江南村民委员会	null	地址：福建省福州市连江县敖江镇江南村
连江县敖江镇连兴村民委员会	null	地址：福建省福州市连江县敖江镇连兴村
连江县马鼻镇玉井村民委员会	null	地址：福建省福州市连江县马鼻镇玉井村
连江县蓼沿乡兰水村民委员会	null	地址：福建省福州市连江县蓼沿乡兰水村
连江县潘渡乡贵安村民委员会	null	地址：福建省福州市连江县潘渡乡贵安村
连江县筱埕镇定海村民委员会	null	地址：福建省福州市连江县筱埕镇定海村
福建省连江县东岱镇蝉步村委会	null	地址：福建省福州市连江县东岱镇蝉步村委会
连江县马鼻镇贵峰村民委员会	null	地址：福建省福州市连江县马鼻镇贵峰村
连江县公安局下宫派出所	所长：黄兴红	地址：福建省福州市连江县下宫乡政府院内
连江县透堡镇人民武装部	老板：周国强	地址：福建省福州市连江县透堡镇北街村
连江县潘渡乡工会联合会	null	地址：福建省福州市连江县潘渡乡政府
连江县农业系统工会委员会	联系人：庄春樟	地址：福建省福州市连江县凤城镇８１６北路８１号
连江县劳动模范协会	联系人：陈高书	地址：福建省福州市连江县建国路２３号
筱埕镇筱埕村老人协会	联系人：陈超群	地址：福建省福州市连江县筱埕村
连江县人民法院	院长：陈玉明	地址：福建省福州市连江县凤城镇和平路
福建省连江县粮食局	局长：陈木兰	地址：福建省福州市连江县凤城镇八一六西路３号
连江县水产加工与流通协会	联系人：陈庆海	地址：连江县凤城镇八一六北路二十六号
连江县苔录镇村镇规划建设管理站	站长：郑贤章	地址：福建省福州市连江县苔录镇政府院内
福建省连江县丹阳镇人民政府	null	地址：福建省福州市连江县丹阳镇
连江县林业局小沧乡林业站	站长：林国平	地址：福建省福州市连江县小沧乡人民政府
连江县林业局浦口镇林业站	站长：黄曦	地址：福建省福州市连江县浦口镇人民政府
连江县黄岐镇村建规划建设管理站	站长：陈志华	地址：福建省福州市连江县黄岐镇人民政府院内
连江县东岱镇洪塘村经济委员会	null	地址：福建省福州市连江县东岱镇洪塘村
连江县透堡镇村镇规划建设管理站	站长：李乃淦	地址：福建省福州市连江县透堡镇政府院内
连江县林业局长龙乡林业站	站长：王顺水	地址：福建省福州市连江县林业局长龙镇林业站
福建省连江县工商行政管理局敖江工商所	所长：陈义进	地址：福建省福州市连江县敖江镇
连江县工商行政管理局马鼻工商所	null	地址：福建省福州市连江县马鼻镇
连江县小沧乡村镇规划建设管理站	站长：徐祥弟	地址：福建省福州市连江县小沧乡政府院内
福建省连江县交通局	null	地址：福建省福州市连江县凤城镇八一六北路１０３号
连江县东岱镇村镇规划建设管理站	站长：陈能进	地址：福建省福州市连江县东岱镇政府大院
连江县革命老根据地建设委员会办公室	联系人：雷财铨	地址：连江县政府大楼
连江县晓沃镇经济委员会	联系人：胡益国	地址：福建省福州市连江县晓沃镇庆丰路5号
连江县安凯乡村镇规划建设管理站	站长：陈华其	地址：福建省福州市连江县安凯乡政府院内
福建省连江县浦口镇经济委员会	联系人：曾祥栋	地址：福建省福州市连江县浦口镇人民政府院内
连江县工商行政管理局浦口工商所	null	地址：福建省福州市连江县浦口镇
连江县林业局晓沃镇林业站	站长：陈霖栋	地址：福建省福州市连江县晓沃镇人民政府
连江县潘渡乡村镇规划建设管理站	站长：张小冲	地址：福建省福州市连江县潘渡乡政府大院
维斯可（福州）面包食品有限公司	null	地址：福建省福州市连江县晓沃镇百胜村
连江县筱埕历乌华峰饮料厂	null	地址：福建省福州市连江县筱埕历乌
连江县凤城易达手表零件加工厂	null	地址：福建省福州市连江县凤城万福巷１３号
连江县源泉酿酒厂	null	地址：福建省福州市连江县土其山
福建省连江县沉香酒厂	厂长：郑淦基	地址：福建省福州市连江县东湖村台头山肥宅
连江县东岱水产冷冻厂	厂长：林蔚成	地址：福建省福州市连江县东岱镇东岱街
福建省连江县马鼻劳保眼镜厂	null	地址：福建省福州市连江县马鼻镇
福建省连江县大官坂街支饲料鱼粉厂	null	地址：福建省福州市连江县大官坂垦区街支
连江县坑园松皋水产鱼粉厂	null	地址：福建省福州市连江县坑园松皋村
福建省连江县凤城标牌厂	null	地址：福建省福州市连江县凤城西北街万福巷１７号
连江县敖江镇蓉香豆奶厂	null	地址：福建省福州市连江县敖江镇青塘村建星路１６号
福建省连江福利育才电脑有限公司	总经理：吴利通	地址：福建省连江县凤尾花园８１６北路３号楼１０１室
连江县先海水产冷冻加工有限公司	null	地址：福建省福州市连江县筱埕镇定海村
连江县调味品厂第一门市部	null	地址：福建省福州市连江县凤城八一六东路１号
连江县安海鱼粉厂	厂长：吴益善	地址：福建省福州市连江县安凯奇达村
福建省连江县中建石材有限公司	null	地址：福建省福州市连江县凤城镇杭下一小新窗二一３０４
福建省连江县丹阳水产保鲜厂	厂长：滕家元	地址：福建省福州市连江县丹阳镇
中国人民解放军３２３６２部队花岗岩制品厂	null	地址：福建省福州市连江县潘渡乡白莲村
连江县保利来面包厂	null	地址：福建省福州市连江县魁岐村岐山路６１号
福建省连江县闽华酒业有限公司	null	地址：福建省福州市连江县凤城镇玉山村
连江利康饮料厂	null	地址：福建省福州市连江县安凯高塘
福建省连江县龙泰特种胶鞋厂	厂长：郑松茂	地址：福建省福州市连江县东岱镇开通路３号
福建省连江县通宁花岗石制品厂	null	地址：福建省福州市连江县浦口镇阁山新村
连江县利豪工艺品有限公司	成立日期：2004/3/17	地址：中国 福建 福州市 连江县丹阳投资区
福建省连江县敖江首饰工艺品厂	null	地址：福建省福州市连江县凤城镇玉山村
福建省连江县茄磊石业有限公司	null	地址：福建省福州市连江县潘渡乡贵安村
福建岱江集团华盛饲料开发有限公司	null	地址：福建省福州市连江县东岱镇外浦路
福建省连江县纸品厂	厂长：林国威	地址：福建省福州市连江县凤城镇文山路３９号
福建省连江县造纸厂	null	地址：福建省福州市连江县凤城镇荷山
福建省连江县连泉酿酒厂	null	地址：福建省福州市连江县黄岐明泉山
连江县汽车修配厂车辆技术评定点	null	地址：福建省福州市连江县凤城镇敖江工业小区（东湖口）
福建省连江县坑园文山饲料厂	厂长：王为桂	地址：福建省福州市连江县坑园文山饲料厂
福建省连江县葡萄酒厂	null	地址：福建省福州市连江县城关北门处
福建省连江县江峰纺织器材有限公司	总经理：林日景	地址：福建省福州市连江县良种场内
福建省连江县虎山茶叶精制厂	null	地址：福建省福州市连江县丹阳镇
福建省连江县东湖飞石第二石料厂	null	地址：福建省福州市连江县东湖镇飞石村
福建省连江县东岱山堂电信器材厂	厂长：陈美贵	地址：福建省福州市连江县东岱镇山堂村
连江县敖江农机修造厂	null	地址：福建省福州市连江县凤城工业小区
福建省连江县敖江福利纸品厂	null	地址：福建省福州市连江县凤城镇北门新村５号楼１０１房
连江县食品厂方便食品分厂	null	地址：福建省福州市连江县凤城镇八一六东路１０５号
福建省连江县食品厂经营部	null	地址：福建省福州市连江县凤城镇八一六北路４８号
福建省连江县木材公司	null	地址：福建省福州市连江县凤城镇坂尾
福建省连江县马鼻碾米厂	null	地址：福建省福州市连江县马鼻乡横厝村
连江县潘渡塘坂铸铁厂	null	地址：福建省福州市连江县潘渡塘坂村
福建省连江县百洋海威食品有限公司	总经理：池宝朝	地址：福建省福州市连江县晓沃镇百胜村工业区
连江县食品厂饮料分厂	null	地址：福建省福州市连江县凤城镇玉荷西路７２号
连江县鲤鱼山调味品厂	null	地址：福建省福州市连江县敖江镇鲤鱼山
连江县晓沃山海调味品厂	厂长：陈德法	地址：福建省福州市连江县晓沃镇登霞山公路内侧
福建省连江县晓沃塑料制品厂	null	地址：福建省福州市连江县晓沃镇福兴北路１５７号
福建省连江县定海水产冷冻厂	厂长：徐永华	地址：福建省福州市连江县筱埕镇定海长沃
福州升兴水产有限公司	总经理：程东峰	地址：中国 福建 福州市 福建省连江县东岱镇东水村文明街西路68号
福建省连江县浦口镇塔头机砖厂	厂长：庄臣生	地址：福建省福州市连江县浦口镇塔头村
福建省连江县东南旅游鞋厂	null	地址：福建省福州市连江县凤城镇建国路５９号
福建省连江县华鑫石材有限责任公司	总经理：郑起郯	地址：福建省福州市连江县丹阳镇坂顶村龙门堂
福建省连江县江南花岗岩制品厂	厂长：赵华国	地址：福建省福州市连江县江南乡
福建省连江县东岱鞋件厂	null	地址：福建省福州市连江县东岱镇城里路６５号
连江县丹阳奋发石材厂	厂长：庄裕杰	地址：福建省福州市连江县丹阳镇坂顶村
连江县潘渡白莲建筑材料厂	null	地址：福建省福州市连江县潘渡白莲
福建省连江蓼沿新兴石板材厂	null	地址：福建省福州市连江县蓼沿溪东三叉路
连江宝山石材有限公司	null	地址：福建省福州市连江县　头镇
福建省连江县盛美石材厂	null	地址：福建省福州市连江县凤城镇（华兴饲料有限公司内）
连江县东岱山堂花岗石制品厂	null	地址：福建省福州市连江县东岱镇山堂村
福建省连江县龙山福利石板材厂	null	地址：福建省福州市连江县东岱镇龙山村
连江县丹阳镇华达石材厂	厂长：陈爱钦	地址：福建省福州市连江县丹阳镇坑口村
连江县繁荣礼品工艺厂	null	地址：福建省福州市连江县敖江浦下
福建省连江县浦丹石材有限责任公司	总经理：陈如丹	地址：福建省福州市连江县丹阳镇花园村
福建省连江凤隆服装厂	null	地址：福建省福州市连江县凤城镇八一六西路４９号
福建省连江县劳保用品厂	null	地址：福建省福州市连江县浦口镇三角埕６６号
福建省连江县马鼻马峰石料厂	厂长：郭道钦	地址：福建省福州市连江县马鼻镇浮曦村狮岐山
连江县敖江白沙机砖厂	null	地址：福建省福州市连江县敖江白沙
福建省连江县敖江新型建筑材料厂	null	地址：福建省福州市连江县敖江镇工业小区
福建省连江县捷美制衣厂	null	地址：福建省福州市连江县凤城镇建国路１０２号
福建省连江县敖江水泥制品厂	null	地址：福建省福州市连江县敖江镇已古龙浦
