福建诚付天下金融技术服务有限公司福州连江分公司	总经理：林	地址：连江县凤城镇玉山小区104国道西侧1#楼101单元
福建省京舜建设工程有限公司连江分公司	总经理：陈	地址：连江县凤城镇816中路安盛大厦2#楼605
连江县菊红农业综合场	联系人：陈	地址：福建省福州市连江县长龙镇下洋村新建路115号
福州市闽诚家政服务有限公司连江分公司	总经理：范	地址：连江县凤城镇龙华花园二期19号楼4号店面
连江县丹阳镇法增铝合金铁门加工厂	厂长：陈	地址：福州市连江县丹阳镇山兜村长园坪
连江县蓼沿乡宝磊石料场	联系人：黄	地址：福州市连江县蓼沿乡溪东村单兜岗
连江县诚信天商务咨询服务有限公司	总经理：罗	地址：福建省福州市连江县凤城镇丹凤西路2号宏宇花园14#-16#14号店
连江县丹阳镇荣盛石材厂	厂长：黄	地址：福建省福州市连江县丹阳镇花园村
连江县旺居房产代理有限公司	总经理：黄	地址：福建省福州市连江县凤城镇北门街凤园路凤尾花园3#楼11店
福建佳创置业有限公司	总经理：林	地址：福建省福州市连江县凤城镇江滨西路3号江夏苑1#－4#楼二层33店面
福州财缘城投资有限公司	总经理：邵	地址：福建省福州市连江县凤城镇文山北路5号太一新天地1#楼7店面
福建华兰里农业综合开发有限公司	总经理：邱	地址：福建省福州市连江县马鼻镇贵峰村渔池墩路1号
福建瑞玻玻璃有限公司	总经理：陈	地址：福建省福州市连江县可门经济开发区坑园村溪尾路58号
福建省万坤建设工程有限公司	总经理：黄	地址：连江县凤城镇丹凤东路14号绿茵花园5#楼4层401单元
福州励志房地产开发有限公司	总经理：邱	地址：福建省福州市连江县安凯乡高塘村高塘路102号
连江县创宏建材有限公司	总经理：王	地址：福建省福州市连江县凤城镇国优路8号鲤鱼港湾5#楼11层1102单元
连江众安投资有限公司	总经理：王	地址：福建省福州市连江县马鼻镇横厝村红石12-2号
连江县泓帆渔业有限公司	总经理：刘	地址：连江县苔?镇茭南村宏图路43号
连江县兴丰服饰有限公司	总经理：庄	地址：连江县凤城镇丹凤东路15号丹凤花园44#楼13店面
连江县浦口镇山海经农业专业合作社	联系人：林	地址：连江县浦口镇中麻村里澳269号
福建省上善星电缆有限公司	总经理：林	地址：连江县经济开发区敖江工业园区1#楼福建世纪电缆有限公司内
福州市金汇通投资咨询有限公司	总经理：林	地址：连江县凤城镇丹凤东路7号迪鑫花园6#1号店
福州市日志环保科技有限公司	总经理：林	地址：福建省福州市连江县凤城镇莲荷东路25#楼B座3车库
福州市恩佑再生资源有限公司	总经理：王	地址：福建省福州市连江县坑园镇下元村前进路29号
连江县黄岐镇郑秀敏渔需制品厂	厂长：郑	地址：福建省福州市连江县黄岐镇大建村建强路码头边
连江县金莎水产养殖有限公司	总经理：汪	地址：福建省福州市连江县黄岐镇后仑村西路23号
福建泰龙源农业开发有限公司	总经理：黄	地址：福州市连江县透堡镇馆读村门前埕D9号2户
福建省鸿翔广告工程有限公司	总经理：林	地址：连江县凤城镇莲荷东路18#A2号店
连江县庆源燃料油贸易有限公司	总经理：占	地址：福建省福州市连江县浦口镇中麻村
福州源鑫盛源实业有限公司	总经理：林	地址：福建省福州市连江县可门开发区管委会坑园镇坑园村溪尾路58号
福建省连江县西山顶综合农场（普通合伙）	联系人：林	地址：福建省福州市连江县蓼沿乡利畲村西山自然村
中国移动通信集团福建有限公司连江商专营业厅	联系人：陈	地址：连江县潘渡村福建商业高等专科学校新校区商业街
福州盛龙塑胶有限公司牡丹洋分公司	总经理：潘	地址：连江县蓼沿乡定田村牡丹洋垅头厝山地
连江县丹阳镇顶尚丽盾工艺石加工厂	厂长：雷	地址：福州市连江县丹阳镇新洋村
连江县玉平养兔场	联系人：刘	地址：福建省福州市连江县江南乡澄岩村
连江县苔?旺角酒厂	厂长：林	地址：福建省福州市连江县苔?镇苔?村后港1#、2#、3#D6#
福建省假日国际旅行社有限公司连江?头营业部	老板：倪	地址：福建省福州市连江县?头镇街道团结路11号
福建省鑫恒投资有限公司	总经理：韩	地址：连江县凤城镇金安西路2号龙芝国际商业广场1层5店面
福建省生久担保有限公司	总经理：陈	地址：福建省福州市连江县凤城镇丹凤西路2号宏宇花园14-16#14号店
连江县鑫瑞咨询服务有限公司	总经理：谢	地址：连江县凤城镇丹凤东路15号丹凤花园43#楼14店面
福州良特贸易有限公司	总经理：吴	地址：福建省福州市连江县?头镇开放路东侧宏源新苑4#楼503室
福州市超浪养殖有限公司	总经理：林	地址：福建省福州市连江县坑园镇屿头村富新路4号
连江县凤城镇依宝药店	老板：谢	地址：福建省福州市连江县凤城镇丹凤东路15号丹凤花园2#楼6-9号店
福建省新马会旅游开发有限公司	总经理：李	地址：福建省福州市连江县潘渡乡贵安村科技大楼305室
连江县坑园镇颜岐富珍水产品经营部	老板：颜	地址：福建省福州市连江县坑园镇颜岐村新民南路94号
福建连江宏大建筑工程有限公司	总经理：姚	地址：连江县下宫乡厦一村一条山脚
连江县九源燃料油有限公司	总经理：林	地址：福建省福州市连江县?头镇下岐村113号
福建宜联管业有限公司	总经理：林	地址：连江县敖江镇青塘村工业园区1#厂房
福州市宏日建筑劳务有限公司	总经理：杨	地址：福建省福州市连江县凤城镇江滨路景江花园二期D型E12一层
连江县坑园镇光辉海产品厂	厂长：颜	地址：福建省福州市连江县坑园镇颜岐村新民南路礼堂边
福州盛运物流有限公司	总经理：赵	地址：连江县沈海高速公路与文笔东路交叉口东北角
连江县长龙镇龙发农民专业合作社	联系人：陈	地址：福建省福州市连江县长龙镇建庄村后门洋
连江县凤城镇我家聚餐园玉荷分店	老板：林	地址：福建省福州市连江县凤城镇玉荷西路（原西餐厅）2#楼9号店、10号店
神州坤元（福建）建设工程有限公司	总经理：郑	地址：福建省福州市连江县凤城镇816东路109号六层
连江县坑园镇颜岐村广隆超市	联系人：颜	地址：福建省福州市连江县坑园镇颜岐村大兴东路310号
福州市金石馆工艺品有限公司	总经理：王	地址：福建省福州市连江县凤城镇丹凤东路3-460号9#楼1层112号店
兴锋盈（福建）集团有限公司连江分公司	总经理：官	地址：连江县潘渡乡贵安村后垄仔责任田
福建康佰家大药房连锁有限公司一二二店	老板：严	地址：连江县?头镇上坪路18号鑫立大厦第一层店面
连江县渔港旅游开发有限公司	总经理：谢	地址：福建省福州市连江县苔?镇秀邦村北沃五路二扇一直
连江县好帮手家庭服务有限公司	总经理：范	地址：连江县凤城镇金凤名都10#楼1层7号店面
连江县华商翼企业管理有限公司	总经理：林	地址：福建省福州市连江县凤城镇816南路巨林商厦1#楼1-19号店面
福建省得力宝五金工具有限公司	总经理：王	地址：连江县?头镇东边村连港路北侧3#1层
连江县马鼻镇金石石材加工厂	厂长：陈	地址：福建省福州市连江县马鼻镇车站西侧
福建金沙岛投资有限公司	总经理：林	地址：连江县凤城镇华光西路2号凤凰城10#楼1店面
福建中汇典当有限公司	总经理：高	地址：福建省福州市连江县贵安新天地贵锦苑商业1号楼21店
连江县晓澳镇金山禽畜养殖场	联系人：林	地址：连江县晓澳镇道澳村二坪山南面
福州千穗农业开发有限公司	总经理：陈	地址：福建省福州市连江县透堡镇西门村西门街14号3户
福建晟鑫建设工程有限公司连江分公司	总经理：陈	地址：福建省福州市连江县凤城镇东北街816东路109号二层
连江县鱼奇海产品有限公司	总经理：王	地址：福建省福州市连江县凤城镇丹凤东路2号丹凤广场1#楼B座801
福州兴鑫旺贸易有限公司	总经理：陈	地址：连江县马鼻镇半田下村溪边区50号
福州百味食品有限公司连江分公司	总经理：陈	地址：连江县经济开发区东湖园区3#厂房一楼
承洁环保有限公司	总经理：陈	地址：连江县江南乡江南社区居委会307房
福州群龙兴贸易有限公司	总经理：欧	地址：连江县?头镇天麟明珠城7座404号
连江县顺鑫汽车租赁有限公司	总经理：李	地址：连江县凤城镇江滨东路18号景江花园二期D型23号店面
迪凯塑料制品有限公司	总经理：陈	地址：连江县丹阳镇虎山村连江县丹阳造纸厂一层
连江县华源建材贸易有限公司	总经理：陈	地址：福州市连江县凤城镇文山北路5号太一新天地12#楼8层811单元
福州市旺林升汽车租赁有限公司	总经理：林	地址：福州市连江县丹阳镇104国道右侧12号住宅楼4号店面
福州市车迷城汽车服务有限责任公司	总经理：陈	地址：福州市连江县敖江投资区上高速路北侧、敖江路东侧8#标准厂房
福州海中水产有限公司	总经理：陈	地址：连江县马鼻镇玉井村二房里112号
福州创域装饰工程有限公司	总经理：林	地址：福建省福州市连江县凤城镇文山北路5号太一新天地1#楼14店面
福州丰畅购物中心有限公司	总经理：张	地址：连江县潘渡乡贵安村科技大楼
高明实业（福建）有限公司	总经理：赖	地址：连江县凤城镇文明东路1号
连江县卓创企业管理咨询有限公司	总经理：林	地址：福建省福州市连江县凤城镇文笔路6号凤翔国际二区17#楼1层20店面
连江县盛平企业管理咨询有限公司	总经理：张	地址：连江县凤城镇玉荷东路（台资大楼边）1#104
连江县雅顺广告工程有限公司凤城分公司	总经理：陈	地址：福建省福州市连江县凤城镇文山北路6号龙华花园3#楼1层3店面
福建省连江县世长水产养殖场	联系人：赵	地址：福建省福州市连江县筱埕镇定海村鲍鱼海区第一区
福建省连江县乾元水产品贸易有限公司	总经理：刘	地址：福建省福州市连江县苔?镇后湾村海滨路5号
福建连江恒欣村镇银行股份有限公司?头支行	联系人：陈	地址：福建省福州市连江县?头镇拱屿村开放路东川花园B#B单元
福建中永建设工程有限公司连江分公司	总经理：陈	地址：福建省福州市连江县凤城镇文山北路6号龙华花园16#楼2层202单元
福建兴坤达钢结构工程有限公司	总经理：陈	地址：福建省福州市连江县敖江镇浦下村原荷山造纸厂
福建永恒兴投资有限公司	总经理：陈	地址：福建省福州市连江县凤城镇文山北路6号龙华花园商业用房1层4店面
福建省连江县黄岐枝达海洋渔具制造厂	厂长：林	地址：福建省福州市连江县黄岐镇海建街畚箕山
福建省大众农业综合开发有限公司	总经理：黄	地址：福建省福州市连江县蓼沿乡定田村下岩路92号
福建省同友房地产开发有限公司	总经理：唐	地址：福建省福州市连江县凤城镇丹凤西路2号宏宇花园14-16#楼14号店
中国人寿保险股份有限公司连江县支公司第十营销服务部	老板：李	地址：福建省福州市连江县?头镇劳动路100号二层
福建聚磊建材有限公司	总经理：袁	地址：福建省福州市连江县江南乡境路村垅里工业区3号
福建宫福水产进出口有限公司	总经理：卓	地址：连江县晓沃镇道沃村1#楼
连江县东岱镇靓装建材店	老板：林	地址：连江县东岱镇东岱街邮电局对面
连江县北茭富源渔业有限公司	总经理：林	地址：福建省福州市连江县苔?镇北茭村吴城面14号
连江县大宇贸易有限公司	总经理：周	地址：福建省福州市连江县?头镇兰田村1#1层101室
连江县大溪砂石加工场（普通合伙）	联系人：施爱忠	地址：连江县东湖镇飞石村大溪
连江县丹阳镇如艺花卉专业合作社	联系人：周鸣枝	地址：连江县丹阳镇上周村店仔兜32号
福建圣洪酒店管理有限公司	总经理：黄先生	地址：连江县潘渡乡沿江大道1号贵安新天地海峡传统文化街第3号楼2号店面
福建省连江县祥瑞珠宝有限公司	总经理：郑先生	地址：连江县?头镇?福大道12号冠海城1号楼704单元
连江县潘渡乡曾美香日杂店	老板：曾先生	地址：连江县潘渡乡贵安村后巷路16号-6
连江县凤城镇红锦江小吃店	老板：黄先生	地址：连江县凤城镇文山北路5号太一新天地13号楼1层17店面
连江县晓澳镇日兴日杂店	老板：孙先生	地址：连江县晓澳镇百胜村长安街96号
连江县浦口镇圣恩食杂店	老板：魏先生	地址：连江县浦口镇连江五中校内
连江县?头镇至真至爱化妆品店	老板：林先生	地址：连江县?头镇上中路190号二楼
连江县凤城镇华珍窗帘布店	老板：黄先生	地址：连江县凤城镇马祖西路2号上一日出东方2#楼2层01-02店面
连江县凤城镇丽雅轩服装店	老板：王先生	地址：连江县凤城镇安盛大厦二层89号店面
连江县浦口镇骏壬食杂店	老板：孙先生	地址：连江县浦口镇南路14号
连江县凤城镇爱国乐园冷饮店	老板：林先生	地址：连江县凤城镇文山北路6号龙华花园15#楼1层7店面
连江县凤城镇壹号台球会所	所长：姚先生	地址：连江县凤城镇马祖西路2号上一日出东方5#9店面
福建申远新材料有限公司	总经理：陈凤先生	地址：福州市连江县坑园镇坑园村溪尾路58号
连江县凤城镇零距离服饰店	老板：陈先生	地址：连江县凤城镇916中路安盛大厦二层14号店
连江县黄岐惠好百姓医药商店	老板：游先生	地址：连江县黄岐镇新城中路218号
连江县凤城镇她啦服装店	老板：黄先生	地址：连江县凤城镇莲荷东路10号楼1层4号店面
连江县敖江镇又好又多食品商行	联系人：陈先生	地址：连江县敖江镇青塘村集贸市场边
连江县丹阳镇联达汽车租赁店	老板：汤先生	地址：连江县丹阳镇丹凤小区22号第5间
连江县敖江镇好兄弟摩托车行	联系人：林先生	地址：连江县敖江镇投资区山山创业区北侧配套房4-5号店面
连江县凤城镇添明饮食店	老板：陈先生	地址：连江县凤城镇莲荷东路18号凤尾村委会梯西两间店
连江县凤城镇凤城贝贝婴幼儿用品店	老板：潘先生	地址：连江县凤城镇文山北路7号金凤名都2#楼1层4店面
连江县黄岐镇杨德摩托车配件销售店	老板：杨先生	地址：连江县黄岐镇海丰街丰恒路163号
连江县敖江镇爽乐客家香脆泡爪店	老板：肖先生	地址：连江县敖江镇小湾村小湾87号
连江县潘渡乡金帛酒楼	联系人：杨先生	地址：连江县潘渡乡贵安村龙山路7号
连江县凤城镇淘衣馆服装店	老板：卓先生	地址：连江县凤城镇安盛大厦二层26号
连江县凤城镇兵菲服装店	老板：孙先生	地址：连江县凤城镇安盛大厦二层80号
百年人寿保险股份有限公司连江支公司	总经理：赖先生	地址：连江县凤城镇东北街玉荷东路侨隆花园A区A幢东单元2层
连江县骏驰建筑工程有限公司	总经理：谢先生	地址：连江县凤城镇丹凤东路15号丹凤花园27#楼1-4店面
连江县长龙镇福瑞蔬果专业合作社	联系人：邱先生	地址：连江县长龙镇建庄村西榨
福州龙斌水产品有限公司	总经理：陈先生	地址：连江县江南乡复兴路8号科灵新天地17#楼1层5店面
连江县豪佳物业管理有限公司	总经理：吴先生	地址：连江县凤城镇文山北路温麻公园大门南侧1#楼8店面
福州北茭源洋食品有限公司	总经理：俞先生	地址：连江县苔?镇苔?村后山路180号
福州海福康生物科技有限公司	总经理：杨先生	地址：福建省连江县安凯乡沙澳村沙澳路27号
连江县苔?镇横?思旺鲍鱼养殖场	联系人：周先生	地址：连江县苔?镇横?村北头尾路1号
连江县西溪农业综合开发有限公司	总经理：邱信强	地址：连江县凤城镇丹凤西路2号宏宇花园3#楼夹层101单元
连江县凤城镇文山路好心情小吃店	老板：陈先生	地址：连江县凤城镇文山北路凤尾农贸市场文山A4店
连江县东湖镇阿钦日杂店	老板：张先生	地址：连江县东湖镇牛栏坪村白城3号
连江县晓澳镇庆源食杂店	老板：孙先生	地址：连江县晓澳镇百胜村市场旁2号店
连江县天龙投资有限公司	总经理：李吉美	地址：连江县凤城镇丹凤东路15号丹凤花园48#楼1店面
连江县航发机电设备有限公司	总经理：陈鸿银	地址：连江县黄岐镇海建街建新路186号
福建省连江县?头牲畜定点屠宰场	联系人：汤绍杰	地址：连江县?头镇阳岐村
福州周六福珠宝有限公司	总经理：陈美忠	地址：连江县凤城镇玉荷东路集贸市场壹层一号楼东向第二间
连江济雅医院有限公司	总经理：林其辉	地址：连江县凤城镇玉山村104国道旁
福州红叶白蚁防治有限公司连江分公司	总经理：黄惠燕	地址：连江县凤城镇文山北路5号太一新天地4#楼703单元
连江县凤城镇亿罗家居用品店	老板：黄先生	地址：连江县凤城镇文山南路469号凤山商住楼1#-3#楼10、11号店
连江县黄岐镇冠亚手机专营店	老板：张先生	地址：连江县黄岐镇海滨路44号
连江县凤城镇俏佳人婚纱店	老板：陈先生	地址：连江县凤城镇安盛大厦2层17、18、20、21号店
连江县苔?镇横塍玉钦干品店	老板：林先生	地址：连江县苔?镇横塍村新码头
连江县凤城镇上品男装店	老板：董先生	地址：连江县凤城镇816中路安盛大厦二层23号店
连江县凤城镇发祯自行车店	老板：谢先生	地址：连江县凤城镇莲荷西路11楼
连江县凤城镇伍味汉堡店	老板：林先生	地址：连江县凤城镇丹凤东路15号丹凤花园4#楼3号店
连江县凤城镇陈钦五金店	老板：陈先生	地址：连江县凤城镇玉荷西路311号
连江县凤城镇祥发木门店	老板：严先生	地址：连江县凤城镇金凤名都9号楼12店
连江县蓼沿乡华凯地磅称重服务部	老板：杨先生	地址：连江县蓼沿乡赤南岗工业区
连江县凤城镇唯艾服装店	老板：林先生	地址：连江县凤城镇安盛大厦一层35-36号店
连江县坡西旅游开发有限公司	总经理：林国霖	地址：连江县凤城镇丹凤西路2号宏宇花园3#楼夹层102单元
福州品沃贸易有限公司	总经理：林健萍	地址：连江县潘渡乡贵安新天地海峡传统文化街27#-15
福建宝岛眼镜（连锁）有限公司连江第二经营部	老板：林菊先生	地址：连江县凤城镇莲荷东路百凤花园连结体1#-3#14店
福建省连江县海燕城水产有限公司	总经理：刘秀燕	地址：连江县苔?镇茭南村宏图路49号
连江县鼎盛电子科技有限公司	总经理：陈冰先生	地址：连江县凤城镇凤城镇816西路银河丽景1#907单元
连江县丹阳镇翔福养鸡场	联系人：林家新	地址：连江县丹阳镇山边村里湾11-10号
连江县敖江镇宝新食杂店	老板：张先生	地址：连江县敖江镇毗田屯村先进路24号
连江县凤城镇阿亮饮食坊	联系人：孙先生	地址：连江县凤城镇文山北路温麻公园门口北起1号、2号店
连江县凤城镇一惠饭店	老板：陈先生	地址：连江县凤城镇丹凤东路15号丹凤花园42#楼2-7号店及车库
连江县凤城镇楚天瓷砖店	老板：孙先生	地址：连江县凤城镇马祖西路日出东方11#楼07店
连江县凤城镇天元新兴房产中介服务部	老板：陈先生	地址：连江县凤城镇天元花园1#楼1号杂物间
连江县凤城镇鸿源酒业商行	联系人：孙先生	地址：连江县凤城镇文笔路凤翔国际二区17#楼17店面
连江县凤城镇小张轮胎店	老板：张先生	地址：连江县凤城镇西凤路16#楼一层第四直（从南到北）
连江县敖江镇邱惠钦奶粉店	老板：邱先生	地址：连江县敖江镇青塘村青中路7号店
连江县凤城镇强强装饰建材店	老板：林先生	地址：连江县凤城镇凤翔现代城（凤翔国际二区）5号楼86号店面
连江县凤城镇世通汽车租赁服务部	老板：瞿先生	地址：连江县凤城镇凤翔名仕1号楼20店
连江县透堡镇明悦川湘酒楼	联系人：杨先生	地址：连江县透堡镇南街村新桥头北塘路口
连江县松丰鲍鱼养殖场	联系人：肖先生	地址：连江县下宫乡松皋村东五
连江县鼎冠鸿贸易有限公司	总经理：郑先生	地址：连江县凤城镇江滨东路19号傲江景城B1#楼09店面
连江县凤城镇新天然居筒骨海鲜火锅店	老板：杨先生	地址：连江县凤城镇北门街816北路北岳大厦二楼
连江县昌丰鲍鱼养殖场	联系人：肖先生	地址：连江县下宫乡松皋村屿仔后2区
福州茅酒酒业有限公司	总经理：郑先生	地址：连江县凤城镇华光西路2号凤凰城12#楼1层3店面
福建省冠宇汽车销售有限公司	总经理：林先生	地址：连江县江南乡复兴路8号科灵新天地8#楼6层604单元
连江县永利木材加工厂	厂长：郑先生	地址：连江县蓼沿乡后坂村
连江县凤城镇女人行服装店	老板：谭先生	地址：连江县凤城镇安盛大厦二层29号店
连江县丹阳镇佛降亭休闲饭庄	联系人：陈先生	地址：连江县丹阳镇朱山佛降亭外厅
连江县潘渡乡恒忠装修建材店	老板：池先生	地址：连江县潘渡乡贵龙路池恒忠楼一楼
连江县筱埕镇定海爱民水产养殖场	联系人：李爱民	地址：连江县筱埕镇定海村长沃码头附近
连江县苔?镇沃尔体鲍鱼场	联系人：陈宗先生	地址：连江县苔?镇后湾村和岩头
连江县神墨教育信息咨询有限公司	总经理：陈钧界	地址：连江县凤城镇丹凤东路2号丹凤广场1#楼B座601
连江县泉旺鲍鱼养殖基地（普通合伙）	联系人：王依忠	地址：连江县黄岐镇赤才村赤才115号
连江县环球假日旅行社有限公司透堡营业部	老板：林毫贤	地址：连江县透堡镇尖墩村三叉路1号
连江县凤城镇健康富侨足浴会所（普通合伙）	联系人：吴东红	地址：连江县凤城镇金安西路2号龙芝国际商业广场四层3号店面（4-3-2）、5号店面（4-5-1）
福州可门新城投资有限公司	总经理：林家书	地址：连江县坑园镇坑园村宏达路122号
福建光泽万福房地产发展有限公司连江分公司	总经理：施旭先生	地址：连江县凤城镇华光西路2号凤凰城7#楼1层4店面
连江县筱埕镇官坞村林旭五金店	老板：林先生	地址：连江县筱埕镇官坞村临海东路123号
连江县苔?镇??奋硕科技电脑店	老板：游先生	地址：连江县苔?镇??村安南七路45号
连江县苔?镇尚品时尚鞋店	老板：黄先生	地址：连江县苔?镇后港新村东北路
连江县苔?镇奇锋干货店	老板：郑先生	地址：连江县苔?镇后港西北路
连江县苔?镇后港佰艾家居内衣店	老板：林先生	地址：连江县苔?镇后港西南路
连江县浦口镇周淑云小吃店	老板：周先生	地址：连江县浦口镇浦西路16号
连江县黄岐镇旺客来火锅店	老板：王先生	地址：连江县黄岐镇海丰街
连江县?头镇移动通信通世界指定专营店	老板：陈先生	地址：连江县?头镇拱屿村福新花园2#6号店
福建省集茂源建设工程有限公司	总经理：庄先生	地址：连江县浦口镇塔头村天街2号7#、10#
福建省祥海投资发展有限公司	总经理：徐先生	地址：连江县苔?镇北茭村牛埠70号
福建榕之晖建设工程有限公司	总经理：翁先生	地址：连江县经济开发区敖江园区（福州兆棋亮建材有限公司）厂房四层401室
福建闽信建材实业有限公司?头分公司	总经理：林先生	地址：连江县?头镇三千吨码头长门隧道口
福州康达食品有限公司	总经理：林发仁	地址：中国.福建省.福州市.连江县中国福州食品工业园（敖江投资区）
福州正欣礼品有限公司	成立日期：2002/5/13	地址：中国.福建省.福州市.连江县敖江投资区
福州百佳气动有限公司	成立日期：2002/5/18	地址：福州市连江县馆头镇
福建省连江县南方环保设备厂	厂长：林春	地址：连江县敖江工业小区
畅行天下运动鞋服加工贸易有限公司	成立日期：2000/11/22	地址：福建省福州市连江县凤城在日出东方9号
福州爱莱格游艇工业有限公司	成立日期：2007/8/15	地址：福建省连江县浦口镇南?一号
福建多多罐头有限公司	总经理：陈媛	地址：福建省福州市连江县敖江投资区104国道旁
连江县坑园镇坑园村喜客来宾馆	联系人：廖	地址：连江县坑园镇坑园村宏达新区
中国工商银行股份有限公司连江广场支行	联系人：张	地址：连江县凤城镇文山北路龙华花园29号楼1号店（一、二层）
连江县升祥贸易有限公司凤城第二分销处	联系人：陈桂英	地址：连江县凤城镇文山北路7号金凤名都
连江县升祥贸易有限公司安凯分销部	老板：吴益美	地址：连江县安凯乡奇达村沃前新村七间排第二间
连江县升祥贸易有限公司敖江分销部	老板：黄忠宝	地址：连江县敖江经济开发区管委会旁边
连江县升祥贸易有限公司凤城第一分销处	联系人：林家帆	地址：连江县凤城镇丹凤东路15号丹凤花园29#楼
连江县下宫乡华峰冷藏库	联系人：陈明?	地址：连江县下宫乡下宫村滨海新区华峰大道1号
连江县泰宏信息咨询服务有限公司	总经理：林继明	地址：连江县凤城镇凤尾花园76#202房
福建省鑫通沥青混凝土工程有限公司	总经理：连炎斌	地址：连江县东湖镇政府大院1栋301室
福建元星投资有限公司	总经理：林孟光	地址：连江县凤城镇百凤小区南路205号底层一闽
连江县澳兴海水养殖有限公司	总经理：陈训灿	地址：连江县晓澳镇晓兴街福兴南路318号
福州皓宇通信工程有限公司	总经理：周祖皓	地址：连江县凤城镇东北街816东路1#楼第6店
连江县祥发木业有限公司	总经理：严详	地址：连江县敖江投资区青霞路南侧标准厂房
连江县凤凰娱乐城	联系人：蒋启祥	地址：连江县凤城镇华光西路6号凤翔现代城1#楼一层34-41店，二层、三层商店
连江县正道推拿养生会所	所长：林鑫	地址：连江县凤城镇文笔路6号凤翔国际二区2#楼一层48店面、49店面、二层商场
连江县华盛大酒店	老板：夏阳	地址：连江县?头镇青芝大道2号青芝凤凰城6号楼1层、5层、6层
连江县万豪足浴城	联系人：陈华杰	地址：连江县?头镇青芝大道2号青芝凤凰城城6号楼2-4层
福州仁泰织造有限公司	总经理：赵克山	地址：连江县敖江镇青塘村青霞路南侧标准厂房
福建省连江县黄岐鑫丰海产品综合基地	联系人：卢统锋	地址：连江县黄岐镇黄岐镇赤沃村南面红石湾
连江县苔?镇王建进鲍鱼养殖场	联系人：王建进	地址：连江县苔?镇后湾村同心路95号
连江县安凯乡新发渔需制品厂	厂长：杨清国	地址：连江县安凯乡奇达村白云山岭脚
连江县苔?镇蔡维兴鱼粉厂	厂长：谢	地址：连江县苔?镇??村山仔
连江县华顺装饰建材商行	联系人：穆	地址：连江县凤城镇丹凤东路凤翔帝景1-2#楼25-27号店
连江县丹阳镇绿野果蔬种植专业合作社	联系人：夏	地址：连江县丹阳镇丹阳村丹山路2号楼202室
连江县诚鑫农民专业合作社	联系人：林	地址：连江县下宫乡初芦村6号
连江县安凯乡寿安鲍鱼养殖场	联系人：陈	地址：连江县安凯乡奇达村前山路31号
福州侨兴消防设备有限公司敖江分公司	总经理：庄	地址：连江县敖江工业区
福建省连江县御泉酿酒有限公司	总经理：陈	地址：连江县敖江镇杉塘村卫星路
福建省连江县行海船舶配件贸易有限公司	总经理：毛	地址：连江县凤城镇文明西路15#112店
福建连江华兴小额贷款股份有限公司	总经理：郑	地址：连江县凤城镇玉荷西路建行大楼7楼
福建恒声建设发展有限公司连江分公司	总经理：吴	地址：连江县凤城镇文山南路82号宏宙花园2#楼1层2车库
福州星艺杰办公设备有限公司连江第一分公司	总经理：谢成春	地址：连江县凤城镇北门路农机新村2号楼第九店
福州星艺杰办公设备有限公司连江第二分公司	总经理：林日	地址：连江县凤城镇北门路农机新村2号楼第9店
福建永佳盛投资发展有限公司	总经理：刘用端	地址：连江县安凯乡半山村碧头领1号
连江县鑫农种植专业合作社	联系人：庄成群	地址：连江县东湖镇东塘村胡东路12号
连江县马鼻镇赤海养殖场	联系人：邱	地址：连江县马鼻镇合峰村模头前埭
连江县和德忠建设工程有限公司	总经理：洪	地址：连江县凤城镇绿茵村816北路153号楼
连江县丹阳镇富林休闲农庄	联系人：余	地址：连江县丹阳镇桂林村贤义路
福建省连江县创智千汇文化传媒有限公司	总经理：魏	地址：连江县凤城镇816西路凤江新村1#1店
连江县振伟兴种植专业合作社	联系人：陈从伟	地址：连江县敖江镇石头村下庄1号
连江县潘渡文峰加油站	站长：冯公斌	地址：连江县潘渡乡文峰省道新东线26公里500米
连江县明时尚投资有限公司	总经理：张明娟	地址：连江县凤城镇816南路巨林商厦1#楼6号店面
连江县凯翔农业有限公司	总经理：吴翔	地址：连江县东湖镇东塘村后街新街以东至新路为止
福州市欣邦渔业有限公司	总经理：吴国清	地址：连江县苔?镇北茭村茭后18号
福州市福亿物流有限公司	总经理：郑新	地址：连江县凤城镇玉山村玉荷西路345号
福建省星野玻璃纤维有限公司	总经理：曾兴?	地址：连江县丹阳镇东山村104国道旁
福州兆福珠宝有限公司	总经理：杨文振	地址：连江县玉荷东路市场对面安通大楼前座34号店
福建民隆现代渔业综合开发有限公司	总经理：郑孝国	地址：连江县浦口镇松坞村
福建宏泽置业有限公司	总经理：黄世远	地址：连江县马鼻镇横厝村横厝街二扇一直
连江县春鸿摄影有限公司	总经理：程春	地址：连江县黄岐镇新城海滨新村西12#二扇一间第二层
连江县黄岐镇源达海珍品养殖场	联系人：陈扬清	地址：连江县黄岐镇海英街后沙拆船厂边
连江县海昊鲍鱼养殖场	联系人：魏芬	地址：连江县黄岐海新街新明路22号
连江县华奥物业管理有限公司	总经理：林新欣	地址：连江县贵安经济开发区科技楼
连江县三六零度广告有限公司	总经理：刘训	地址：连江县凤城镇文汇路3号凤翔名仕6#6号店
连江县中加贸易有限公司	总经理：黄甫廷	地址：连江县凤城镇江滨路景江花园10、11、12店面
连江县桂人堂礼品商行	联系人：庄伟红	地址：连江县凤城镇丹凤东路凤翔帝景1#-2#楼16店面
福州建国贸易有限公司	总经理：吴丽红	地址：连江县敖江投资区新连黄路1#厂房（福州琦琳竹木实业有限公司1#厂房）
福州市闽源投资有限公司	总经理：陈敏	地址：福州市连江县小沧畲族乡小沧村部
连江县大洋健发种畜场	联系人：俞传健	地址：连江县下宫乡大洋村东面
连江县坑园镇颜岐福兴超市	联系人：陈济雄	地址：连江县坑园镇颜岐村新丰东路1号
连江县?头镇边城星光灿烂歌城	联系人：陈金裕	地址：连江县?头镇东边村大众路边城大厦三层
福建省鼎才农业开发有限公司	总经理：苏德才	地址：连江县凤城镇马祖西路2号上一 日出东方4#楼二层02店面
福州浩翔文化传播有限公司	总经理：朱磊	地址：连江县凤城镇华光西路2号凤凰城10#楼1店面
福州益全贸易有限公司连江分公司	总经理：黄云成	地址：连江县凤城镇816西路9号银河丽景4#楼306单元
连江县东岱镇惠又康医药商店	老板：唐克文	地址：连江县东岱镇东岱街东旺路5号
连江县奋辉贸易有限公司	总经理：曾	地址：连江县敖江镇白沙东北路431号
连江县?头镇发祥沙场	联系人：原	地址：连江县?头镇后一村下塘浦码头两边空地
连江县绿原种植专业合作社	联系人：许	地址：连江县敖江镇山亭村财溪路25号
福建西诺水产品贸易有限公司	总经理：张	地址：连江县丹阳镇桂林村澳中路1号桂林村委会3层
连江县小神龙家政服务有限公司	总经理：梁	地址：连江县江南乡复兴路8号科灵新天地18#楼1层1店面
连江县永冠林木有限公司	总经理：肖	地址：连江县凤城镇文山北路5号太一新天地6#楼4层403单元
连江县冠之华贸易有限公司	总经理：陈	地址：连江县凤城镇玉荷东路173号
福建东方海岸投资有限公司	总经理：林	地址：连江县凤城镇文山北路凤尾花园农贸市场文明B4号
连江县?头镇东岸水泥砖厂	厂长：黄	地址：连江县?头镇秦川村沃尾粪池下
连江县煲宝仔风味小吃店	老板：魏	地址：连江县凤城镇北门街816北路北岳大厦二楼
福建贵安新天地旅游文化开发有限公司	总经理：林	地址：连江县贵安新天地旅游度假区
福州创明网络技术有限公司连江分公司	总经理：许	地址：连江县潘渡乡仁山村科技园
连江县筱埕镇信兴海产品厂	厂长：张	地址：连江县筱埕镇定海村长澳马路西面
福建省融盛网络有限公司连江分公司	总经理：郑	地址：连江县潘渡乡仁山村科技园
连江县东帅种植专业合作社	联系人：陈帅	地址：连江县东湖镇东湖村大桥路3-3号
福州傲农生物科技有限公司	总经理：钟小明	地址：连江县敖江投资区下山村
连江县下宫乡闽澳鲍鱼养殖场	联系人：廖慎端	地址：连江县下宫乡江湾村下澳海区
连江县龙井鲍鱼养殖场	联系人：肖良栋	地址：连江县下宫乡松皋村东五溪边
连江县苔?镇上塘村谢忠华鲍鱼场	联系人：谢忠华	地址：连江县苔?镇上塘村库里
连江县起奋鲍鱼养殖场	联系人：谢起奋	地址：连江县下宫乡松皋村屿仔后
连江县下宫永固建材商行	联系人：吴祯位	地址：连江县下宫乡下宫村华峰南路46号
福建茂达建材有限公司	总经理：陈必琛	地址：连江县敖江镇敖江投资区青龙路（福州港发机电工业有限公司内12#楼）
福建省连江县饮食服务公司金都大酒店	老板：刘亮	地址：连江县凤城镇816北路79号
福建宏利兴纸业有限公司	总经理：林涛	地址：福建省连江县连江经济技术开发区管委会办公楼四层
连江县兴顺新型建材有限公司	总经理：柯学义	地址：连江县敖江镇山亭村官巷自然村西面
福建省连江县宏冠纸品有限公司	总经理：滕玉仙	地址：连江县敖江投资区104国道边青塘口3#楼
福州恒隆食品有限公司	总经理：谢起来	地址：连江县敖江开发区104国道西侧青塘路口
福建省连江县和盛食品冷冻厂	厂长：刘必云	地址：连江县安凯乡安海村后才峡
福建盛和房地产开发有限公司	总经理：曾慧芳	地址：连江县816路巨林商厦3#楼1-02号
连江县筱埕永盛鲍鱼养殖场	联系人：周玉平	地址：福州市连江县筱埕镇筱埕村后沃
福建省连江县三和鲍鱼养殖场	联系人：魏新华	地址：福州市连江县筱埕镇定海村可门
福建省连江定海海胜鲍鱼养殖场	联系人：黄世坤	地址：福州市连江县筱埕镇定海村教练场
福建佳宇建材制品有限公司	总经理：宋家华	地址：福建省连江县可门经济开发区管委会
连江县鑫隆贸易有限公司	总经理：陈杏顺	地址：福建省连江县丹凤路丹凤三区3816车库
福州捷丰海珍品开发有限公司	总经理：黄爱祯	地址：福建省连江县安凯乡奇达村
连江县永新装璜工程有限公司	总经理：谢永强	地址：福建省连江县816中路37号二楼A1-2
福建宏盛建设集团有限公司连江分公司	总经理：胡秀明	地址：福建省福州市连江县凤城镇永得花园８＃楼２０１房
福建南台食品添加剂发展有限公司	总经理：林益	地址：福建省连江县水产品加
福州龙福食品有限公司	总经理：邹子北	地址：福建省福州市连江县敖江投资区
连江县凤城镇中鸿其它副食品店	老板：郑家忠	地址：福建省福州市连江县凤城镇１０４国道西侧玉泉公园前
福州鼎源食品有限公司	总经理：谢义书	地址：福建省福州市连江县凤城镇北郊１０４国道边
福建省连江县福兴食品有限公司	总经理：江铭福	地址：福建省福州市连江县筱埕镇大埕村
福建金山冷冻食品有限公司	总经理：崔煌吉	地址：福建省福州市连江县敖江投资区
福建省连江县蓝天假日酒店有限公司	总经理：庄裕长	地址：福建省福州市连江县凤城镇丹凤西路宏宇花园７＃楼
连江县粮食购销有限公司禾盛酒店	老板：杨世强	地址：福建省福州市连江县８１６中路７６号
连江县东方大酒店	老板：林东	地址：福建省福州市连江县凤城镇文明西路６０号
福州精通网络有限公司	总经理：郑海生	地址：福建省福州市连江县凤城镇西渠路３１２号
中国网络通信集团公司福州市连江营销中心	联系人：廖建强	地址：福建省福州市连江县凤城镇玉荷西路２８２号楼一层
福建省连江县万嘉物业管理有限公司	总经理：许可贵	地址：福建省连江县凤城镇西北街玉荷西路购物中心二层110店
福州连港物业管理有限公司连江分公司	总经理：朱林彬	地址：福建省连江县坑园镇（福建华电可门发电有限公司内）
福建光亚半导体科技有限公司	总经理：程遥	地址：福建省连江县经济开发
连江县讯捷网络科技有限公司	总经理：张时雨	地址：福建省福州市连江县凤城镇金凤西城１＃８０３
福建省连江县可门港农业科技综合开发场	联系人：林元增	地址：福建省福州市连江县下宫乡上宫村郭婆岭
连江县冠宇电脑有限公司	总经理：吴噍	地址：福建省连江县凤城镇凤园路321号B座201
福建欣隆生物科技有限公司	总经理：王明绍	地址：福建省福州市连江县江南工业区国道路２号
连江县光发造纸厂	厂长：李光发	地址：福州市连江县东岱镇关头村原农中
连江县召发食品加工厂	厂长：郑必奋	地址：福建省福州市连江县凤城镇东南街文山路１０号
连江县苔录镇兴辉制冰厂	厂长：苏家兴	地址：福建省福州市连江县苔录镇后湾村江滨路１０８号
连江县蓼沿乡达利石板厂	厂长：黄金俊	地址：福建省福州市连江县蓼沿乡蓼沿村青南岗
福建省连江县湖里环保工程发展有限公司	总经理：詹定星	地址：福建省福州市连江县凤城镇莲荷西路１９＃１０１Ａ
福建裕鑫环保设备有限公司	总经理：陈丽香	地址：福建省福州市连江县城关北门路１４号Ａ座
连江县金冠物资贸易有限公司	总经理：林家铿	地址：福建省福州市连江县凤城镇文山南路２１２号凤贵新村２＃４０３室
福建省盛辉物流集团有限公司连江分公司	总经理：刘用辉	地址：福建省福州市连江县１０４国道边小湾口
连江县闽榕渔业物流有限公司	总经理：陈增海	地址：福建省福州市连江县东岱镇东水村文明街西６１号
福建连兴粉煤灰综合开发利用有限公司	总经理：练玉华	地址：福建省福州市连江县坑园镇颜岐村
福州冠融机电有限公司	总经理：林茂松	地址：福建省福州市连江县敖江投资区
江阴市新桥千姿韵服饰商行	联系人：胡恒敏	地址：福建省连江县江南乡花坞村澳里27号
福州市国际旅行社连江营业部	老板：王信明	地址：福建省福州市连江县凤城镇莲荷东路３９幢１１号
连江县环球假日旅行社有限公司	总经理：刘斌	地址：福建省福州市连江县凤城镇莲荷东路４＃楼
福建省连江县飞跃经济文化传播有限公司	总经理：陈剑	地址：福建省福州市连江县凤城镇爱民路住宅小区１号２０３房
教育部关工委家庭教育中心连江工作站	站长：邱吉平	地址：福建省福州市连江县城关天和城２号楼１５间
福建纵横投资实业集团有限公司连江分公司	总经理：王心	地址：福建省福州市连江县江南乡复兴路乡政府对面
连江县上一房地产开发有限公司	总经理：刘必东	地址：福建省福州市连江县凤城镇文明路水果市场二楼１号店
福州金星房地产开发有限公司连江分公司	总经理：陈美榕	地址：福建省福州市连江县凤城镇玉荷东路金星商厦二层
福州同康建筑装饰有限公司	总经理：杨昌光	地址：福建省福州市连江县敖江投资区
福建省畅元建筑工程有限公司	总经理：吴明朝	地址：福建省福州市连江县?头镇凤仪楼二层
连江县下宫乡下宫村永固建材商行	联系人：吴祯位	地址：福建省连江县下宫乡下宫村华峰南路46号
连江县力铭建材有限公司	总经理：李登华	地址：福建省连江县凤城镇凤江新村2#5号店
亨一新型建材有限公司	总经理：郑斌	地址：福建省连江县凤城镇北门小区文明西路54407号
福州利废新型建材有限公司	总经理：黄唐官	地址：福建省连江县经济开发区?头园区管委会办公楼二层
福州芳贝工艺品有限公司	总经理：柳添祥	地址：福建省福州市连江县江南乡工业园区
连江县新温泉花园宾馆	联系人：郑美娟	地址：福建省福州市连江县丹凤西路１号温泉花园８号楼３、４店
吴江市横扇镇天华娱乐游戏室	联系人：陈传华	地址：福建省连江县晓澳镇晓江街联合巷96号
常熟市虞山镇阜康台球娱乐室	联系人：谢长恩	地址：福建省连江县东岱镇龙山村龙发北路130-2号
连江县喜来健医疗器械有限公司	总经理：林秀英	地址：福建省福州市连江县凤城镇玉荷东路安通广场裙楼三层
福州龙泉化工有限公司	总经理：吴文钟	地址：福建省连江县经济开发区管委会二层
福州金瀚化工有限公司	总经理：张少华	地址：福建省福州市连江县敖江投资区
福州晶茂精细化工有限公司	总经理：黄炳炀	地址：福建省福州市连江县?头投资区
福州富业五金制造有限公司	总经理：翁少敏	地址：福建省福州市连江县敖江投资区
福建省连江县马鼻镇东湾?塘建设集团有限公司	总经理：陈为富	地址：福州市连江县马鼻镇东湾村?塘路
福建省福州市鑫材建筑材料有限公司	null	地址：中国 福建 福州市 福州市连江县
新海建材公司	null	地址：中国 福建 福州市 福建省连江县
航佳贸易有限公司	null	地址：中国 福建 福州市 福建省连江县莲河东路101号
福建省连江县华宏农牧农场	null	地址：中国 福建 福州市 连江县江南乡
福建省连江县嘉豪食品有限公司	总经理：林清	地址：中国 福建 福州市 福建省连江县黄岐镇英才路77号
詹能国(个体经营）	null	地址：中国 福建 福州市 连江县
福建省连江县兴旺鲍鱼养殖场	null	地址：中国 福建 福州市 连江县马鼻镇
福建福兴公司	null	地址：中国 福建 福州市 连江县
林国天（个人）	null	地址：中国 福建 福州市 福州连江县坑园镇下屿村
林水梅(个体经营)	null	地址：中国 福建 福州市 福州连江县可门港下宫乡华峰西路21号
福建省连江县黄岐宏武水产有限公司	null	地址：中国 福建 福州市 连江县黄岐镇新城东区
福建省连江县康乐食品有限公司	null	地址：中国 福建 福州市 福州市连江县敖江镇
可门港钓鱼岛鱼排有限公司	null	地址：中国 福建 福州市 连江县下屿村
郑哲学（个体经营）	null	地址：中国 福建 福州市 福建省连江县黄歧镇大建村新村楼
陈艳华（个人经营）	null	地址：中国 福建 福州市 福州连江县苔录镇秀邦村东街14号
福州坑口线面生产基地	null	地址：中国 福建 福州市 连江县丹阳镇坑口村
捷丰海珍品开发有限公司	null	地址：中国 福建 福州市 福州市连江县安凯乡奇达村开发区
可门港物流有限公司	null	地址：中国 福建 福州市 连江县下宫乡
中铁二是二局第三工程有限公司	null	地址：中国 福建 福州市 福建福州连江县后安村
华益电器有限公司	null	地址：中国 福建 福州市 连江县玉荷东路１８号
福州市泊朗整体橱柜有限公司	null	地址：中国 福建 福州市 福州市连江北路293号新南方名品家居410-411号~~~分店地址：福州市连江县
容与轩实业有限公司	null	地址：中国 福建 福州市 福建省福州市连江县爱国路49号
福建省福州市龙泽贸易有限公司	null	地址：中国 福建 福州市 福建省福州市连江县中巷6号
陈晓尧（个人）	null	地址：中国 福建 福州市 连江县丹凤东路丹凤朝阳5#604
郑丽华（个体经营）	null	地址：中国 福建 福州市 连江县管头镇东边村玉峰路63号
杨忠坤（个体经营）	null	地址：中国 福建 福州市 连江县透堡镇南街村杨厝里127号
连江县凤磊石材厂	null	地址：中国 福建 福州市 福州市连江县蓼沿乡
创辉艺雕厂	null	地址：中国 福建 福州市 连江县江南
福建省韵芳茶叶包装批发商行	null	地址：中国 福建 福州市 福州市连江县丹凤朝阳1号楼109店
完美（中国）日用品有限公司福建分公司	null	地址：中国 福建 福州市 福建省福州市连江县宏宇花园4-305
肖肖化妆品店	null	地址：中国 福建 福州市 连江县管头镇阳岐村中舟路6号
林举（个体经营）	null	地址：中国 福建 福州市 福建省福州市连江县馆头镇
福建嘉诚高强紧固件有限公司	null	地址：中国 福建 福州市 福州市连江县?头镇
新技电子有限公司	null	地址：中国 福建 福州市 连江县
连江县浦口镇农业机械管理站	null	地址：福建省福州市连江县浦口镇政府院内
连江县浦口镇计划生育服务队	null	地址：福建省福州市连江县浦口镇政府大楼里面
连江县浦口镇官岭增水柴油店	老板：叶增水龙头	地址：连江县浦口镇官岭村
连江县浦口镇福利信托贸易部	null	地址：福建省福州市连江县浦口镇镇府路５９号
连江县浦口镇董事会服务中心	null	地址：福建省福州市连江县浦口镇
连江县浦口增时废旧回收店	null	地址：福建省福州市连江县浦口街车站边
连江县浦口压铸厂	null	地址：福建省福州市连江县浦口新村
连江县浦口沃头海产站	null	地址：福建省福州市连江县浦口镇沃头村
连江县浦口豪盛机械配件厂	null	地址：福建省福州市连江县浦口镇车站
连江县皮肤病防治院	院长：孙厚善350122	地址：福建省福州市连江县凤城镇文山路
连江县潘溪水利管理处	联系人：林仕丰	地址：福建省福州市连江县凤城镇西渠路2号
连江县潘渡乡陀市老区福利果场	null	地址：福建省福州市连江县潘渡乡陀市村
连江县潘渡乡陀市村下坂果场	null	地址：福建省福州市连江县潘渡乡陀市村
连江县潘渡乡水利水电工作站	站长：黄宝明	地址：福建省福州市连江县潘渡乡政府
连江县潘渡乡社救款	null	地址：福建省福州市连江县潘渡乡
连江县潘渡乡仁山村经济合作社	null	地址：福建省福州市连江县潘渡乡仁山村
连江县潘渡乡仁山村金州果场	联系人：赵公荣	地址：福建省福州市连江县潘渡乡仁山村
连江县潘渡乡计划生育服务队	null	地址：福建省福州市连江县潘渡乡潘渡村３０号
连江县潘渡乡贵安村经济合作社	null	地址：福建省福州市连江县潘渡乡贵安村
连江县潘渡乡法律服务所	所长：庄淑平	地址：福建省福州市连江县潘渡乡人民政府
连江县潘渡陀市梧桐果场	null	地址：福建省福州市连江县潘渡陀市梧桐果场
连江县排污收费监理所	所长：贺健	地址：福建省福州市连江县凤城镇凤园路18号
连江县农校黄国平机动车辆修理所	null	地址：福建省福州市连江县连江农校
连江县南门海珍品养殖场	null	地址：福建省福州市连江县马鼻南门
连江县南湖太极道观	联系人：吴盛官	地址：福建省福州市连江县敖江镇南湖
连江县马鼻镇水利水电工作站	站长：陈学民350122	地址：福建省福州市连江县马鼻镇横厝街
连江县马鼻镇墙兜村经济合作社	null	地址：福建省福州市连江县马鼻镇墙兜村
连江县马鼻镇企业办公室	null	地址：福建省福州市连江县马鼻镇政府
连江县马鼻镇南门村经济合作社	null	地址：福建省福州市连江县马鼻镇南门村
连江县马鼻镇东湾石料场	null	地址：福建省福州市连江县马鼻镇东湾村山溪口
连江县马鼻镇当里村经济合作社	联系人：林向栋	地址：福建省福州市连江县马鼻镇当里村
连江县马鼻镇半田下村经济合作社	null	地址：福建省福州市连江县马鼻镇半田下村
连江县马鼻农业机械管理站	null	地址：福建省福州市连江县马鼻镇政府内
连江县马鼻木材加工厂	null	地址：福建省福州市连江县透堡镇尖墩三叉口
连江县马鼻金龙家用电器经营部	null	地址：福建省福州市连江县马鼻镇粮站边上
连江县马鼻街中心市场	联系人：陈龙邃	地址：福建省福州市连江县马鼻镇横厝街城墙头１２号
连江县马鼻个协分会基金担保会	null	地址：福建省福州市连江县马鼻镇横厝街
连江县龙山金登花岗石制品加工场	null	地址：福建省福州市连江县东岱镇龙山村２３号
连江县蓼沿运输有限公司	总经理：杨其应	地址：福建省福州市连江县蓼沿乡
连江县蓼沿乡朱公村经济合作社	null	地址：福建省福州市连江县蓼沿乡朱公村
连江县蓼沿乡周溪村经济合作社	null	地址：福建省福州市连江县蓼沿乡周溪村
连江县蓼沿乡掌洋坂老区福利果场	null	地址：福建省福州市连江县蓼沿乡掌洋坂
连江县蓼沿乡杏林村经济合作社	null	地址：福建省福州市连江县蓼沿乡杏林村
连江县蓼沿乡仙屏村经济合作社	null	地址：福建省福州市连江县蓼沿乡仙屏村
连江县蓼沿乡溪东村经济合作社	null	地址：福建省福州市连江县蓼沿乡溪东村经济合作社
连江县蓼沿乡王坑村经济合作社	null	地址：福建省福州市连江县蓼沿乡王坑村
连江县蓼沿乡通伙木材加工店	老板：郑通伙	地址：福建省福州市连江县蓼沿乡蓼沿村
连江县蓼沿乡四定村经济合作社	null	地址：福建省福州市连江县蓼沿四定村
连江县蓼沿乡双丰石材制品厂	厂长：林宇	地址：福建省福州市连江县蓼沿乡秦南岗
连江县蓼沿乡首占村经济合作社	null	地址：福建省福州市连江县蓼沿乡首占村
连江县蓼沿乡仁坂村经济合作社	null	地址：福建省福州市连江县蓼沿乡仁坂村
连江县蓼沿乡岐山村经济合作社	null	地址：福建省福州市连江县蓼沿乡岐山村民委员会
连江县蓼沿乡蒲边村经济合作社	null	地址：福建省福州市连江县蓼沿乡蒲边村
连江县蓼沿乡蓼沿经济合作社	null	地址：福建省福州市连江县蓼沿乡蓼沿村民委员会
连江县蓼沿乡后垅村经济合作社	null	地址：福建省福州市连江县蓼沿乡后垅村
连江县蓼沿乡后坂种植养殖综合场	联系人：郑远华	地址：福建省福州市连江县蓼沿乡后坂村
连江县蓼沿乡后坂全太木器加工店	null	地址：福建省福州市连江县蓼沿乡后坂村
连江县蓼沿乡凤岩村经济合作社	null	地址：福建省福州市连江县蓼沿乡凤岩村委会
连江县蓼沿乡定田村经济合作社	null	地址：福建省福州市连江县蓼沿乡定田村
连江县蓼沿乡大沧村经济合作社	null	地址：福建省福州市连江县蓼沿乡大沧村
连江县蓼沿乡赤石村经济合作社	null	地址：福建省福州市连江县蓼沿乡赤石村民委员会
连江县蓼沿乡白沙村经济合作社	null	地址：福建省福州市连江县蓼沿乡白沙村
连江县蓼沿上凤石材方料店	null	地址：福建省福州市连江县蓼沿岐山村
连江县蓼沿木忠石油经营部	null	地址：福建省福州市连江县蓼沿乡坪岗顶
连江县蓼沿后坂石料场	null	地址：福建省福州市连江县蓼沿乡后坂村
连江县蓼沿航利石料厂	厂长：郑荫木	地址：福建省福州市连江县蓼沿兰水村
连江县蓼沿供销合作社	null	地址：福建省福州市连江县蓼沿乡蓼沿村
连江县蓼沿公社服务站	null	地址：福建省福州市连江县蓼沿公社服务站
连江县蓼沿法律服务所	所长：洪飞	地址：福建省福州市连江县蓼沿乡蓼沿村
连江县粮食复制品二厂	厂长：林国威	地址：福建省福州市连江县凤城镇文山路３９号
连江县利宏水利水电设计有限公司	总经理：苏松华	地址：连江县凤城镇文明东路３７号
连江县离退休干部活动中心	null	地址：福建省福州市连江县凤城镇爱国路１３２号
连江县矿产资源管理委员会办公室	null	地址：福建省福州市连江县人民政府四层
连江县坑园中心法律服务所	null	地址：福建省福州市连江县坑园乡坑园村
连江县坑园鱼业养殖场	null	地址：福建省福州市连江县坑园乡坑园村
连江县坑园颜岐围垦工程指挥部	老板：颜家宋	地址：福建省福州市连江县坑园乡颜岐村
连江县坑园学区	联系人：陈德用	地址：福建省福州市连江县坑园乡
连江县坑园乡下屿围海造地建设工程指挥部	老板：郑德钗	地址：福建省福州市连江县坑园乡下屿村
连江县坑园乡下屿村经济合作社	null	地址：福建省福州市连江县坑园乡下屿村
连江县坑园乡土地管理所	null	地址：福建省福州市连江县坑园乡人民政府院内
连江县坑园乡坑园村经济合作社	null	地址：福建省福州市连江县坑园乡坑园村
连江县坑园乡红厦村经济合作社	null	地址：福建省福州市连江县坑园乡红厦村
连江县坑园虾贝养殖场	null	地址：福建省福州市连江县坑园乡坑园村
连江县坑园老区福利果场	null	地址：福建省福州市连江县坑园乡坑园村
连江县坑园初芦海产品购销部	null	地址：福建省福州市连江县坑远初芦村
连江县经济体制改革委员会	null	地址：福建省福州市连江县凤城镇八一六北路８１号
连江县经济技术协作办公室	null	地址：福建省福州市连江县政府大楼四层
连江县金沙陈长潮兴文董事会	null	地址：福建省福州市连江县马鼻镇横厝
连江县教育学会	null	地址：福建省福州市连江县教师进修学校
连江县教育事业费附加征管办公室	null	地址：福建省福州市连江县凤城镇玉荷东路４７号
连江县江南乡水利水电工作站	null	地址：福建省福州市连江县江南乡江南村
连江县江南乡农业机械管理站	null	地址：福建省福州市连江县江南乡人民政府院内
连江县江南乡南塘村经济合作社	联系人：陈琳官	地址：福建省福州市连江县江南南塘村村委会
连江县江南乡江南村经济合作社	联系人：陈华强	地址：福建省福州市连江县江南村委会
连江县江南乡花坞村经济合作社	联系人：陈允强	地址：福建省福州市连江县江南乡花坞村
连江县江南乡澄岩村经济合作社	联系人：叶增清	地址：福建省福州市连江县江南乡澄岩村
连江县江南法律服务所	所长：林孔信	地址：福建省福州市连江县江南乡人民政府
连江县江滨路改造建设指挥部	老板：何宗乐	地址：福建省福州市连江县县委党校
连江县建筑文明安全监察站	站长：何维康	地址：福建省福州市连江县凤城镇文明东路３３号县建设局内
连江县建设项目预决算审计中心	联系人：黄宜建	地址：福建省福州市连江县凤城镇８１６北路新江写字楼四层
福建省连江县第二粮食购销有限公司	总经理：陈济湘	地址：福建省福州市连江县凤城镇８１６东路７６号
福建省连江县军粮供应站	站长：陈勇	地址：福建省福州市连江县凤城镇８１６西路３号
依金饲料店	null	地址：福建省福州市连江县凤城玉荷东路食品公司门市部
连江县凤城浦兴农机经营部	null	地址：福建省福州市连江县新汽车站边油库第６房
敖江妹春木材经营部	null	地址：福建省福州市连江县凤城北门停车场
连江县供销社实业开发总公司贸易经营部	null	地址：福建省福州市连江县凤城镇城东路６号
连江县供销社实业开发总公司农副产品开发经营部	null	地址：福建省福州市连江县凤城镇北门敖江供销社大楼
连江县马鼻利兴木材经营部	null	地址：福建省福州市连江县马鼻镇林厝前
宫坂供销社蘑菇管理站	null	地址：福建省福州市连江县宫坂镇宫坂村
福建省连江县下宫水产购销部	null	地址：福建省福州市连江县厦宫乡下宫村
连江县供销社实业开发总公司副食品公司	null	地址：福建省福州市连江县凤城镇东城路６号
福州市贸易拍卖行连江分行	联系人：王玉树	地址：福建省福州市连江县凤城镇（原拖拉机站台１号楼１层）
连江县塔头木材经营部	null	地址：福建省福州市连江县浦口镇塔头村
福建省连江县黄岐电信支局	局长：林乃章	地址：福建省福州市连江县黄岐镇
福建省连江县电信局	局长：刘兴旺	地址：福建省福州市连江县凤城镇八一六东路１２９号
福建省连江县浦口电信支局	局长：郑福勇	地址：福建省福州市连江县浦口镇
福建省连江县东岱电信支局	局长：陈晓东	地址：福建省福州市连江县东岱镇
福建省连江县敖北农机供应站	null	地址：福建省福州市连江县凤城八一六北路１３９号
福建省连江县马鼻电信支局	局长：林晨	地址：福建省福州市连江县马鼻镇
福建省连江县下宫电信支局	局长：姚河祝	地址：福建省福州市连江县下宫乡
福建省连江县透堡电信支局	局长：陈锋	地址：福建省福州市连江县透堡镇
福建省连江县安凯电信支局	局长：林道务	地址：福建省福州市连江县安凯乡
福建省连江县筱埕电信支局	局长：王 奇	地址：福建省福州市连江县筱埕乡
福建省连江县蓼沿电信支局	局长：陈寿春	地址：福建省福州市连江县蓼沿乡
福建省连江县潘渡电信支局	局长：吴为标	地址：福建省福州市连江县潘渡乡
福建省连江县种子公司经营部	老板：唐永晖	地址：福建省福州市连江县凤城镇玉荷东路63号
饲料店	null	地址：福建省福州市连江县八一六北路
福建省连江县东湖电信支局	局长：程尼亚	地址：福建省福州市连江县东湖镇
福建省连江县丹阳砂石开发公司	null	地址：福建省福州市连江县丹阳镇新街
凤城浦下饲料店	null	地址：福建省福州市连江县凤城镇玉荷东路４５号
福建省连江信远电信有限公司	总经理：张辛代	地址：福建省福州市连江县凤城镇莲荷东路３０＃１层
福建省连江县长龙电信支局	局长：陈水通	地址：福建省福州市连江县长龙乡
福建省连江县丹阳电信支局	局长：林春榕	地址：福建省福州市连江县丹阳镇
福建省连江县晓沃电信支局	局长：陈成光	地址：福建省福州市连江县晓沃镇
福建省连江县小沧电信支局	局长：卢松松	地址：福建省福州市连江县小沦乡
福建省连江县苔录电信支局	局长：黄心旭	地址：福建省福州市连江县苔录镇
福建省连江县坑园电信支局	局长：陈裕禄	地址：福建省福州市连江县坑园镇
福建省连江县马鼻南门水产养殖有限公司	总经理：陈金光	地址：福建省福州市连江县马鼻镇南门村委会楼下
连江县东水水产养殖场	联系人：陈增海	地址：福建省福州市连江县东岱外浦路江百公路边
福建省连江闽江口综合水产养殖示范基地	联系人：占必华	地址：福建省福州市连江县晓澳镇赤湾村
福建省连江大埕湾水产养殖场	联系人：陈雄	地址：福建省福州市连江县筱埕镇大埕村
连江县丹阳镇凤翔蛋鸡场	联系人：陈明辉	地址：福建省福州市连江县丹阳镇新洋村后山岗
连江县兴发水产养殖场	联系人：邱兵中	地址：福建省福州市连江县马鼻镇合峰村名堂路２５号
福建省连江县坑园乡水产养殖场	联系人：黄德宝	地址：福建省福州市连江县坑园乡坑园村
连江县春丰水产养殖场	联系人：林端庄	地址：福建省福州市连江县坑园下屿村
连江县下宫乡松皋村咸亨水产养殖育苗场	联系人：肖华腾	地址：福建省福州市连江县下宫乡松皋村
福建省连江县马鼻水产养殖公司	null	地址：福建省福州市连江县马鼻镇官塘村
连江县厦宫鼎鑫水产养殖场	联系人：黄康林	地址：福建省福州市连江县厦宫乡板铁头
福建省连江县透堡镇南街茶厂	厂长：杨孝勋	地址：福建省福州市连江县透堡镇西门月峰桥头
福建省连江县长龙第一茶厂	厂长：梁序维	地址：福建省福州市连江县长龙镇下洋村
福建省连江县长龙宏辉茶厂	厂长：卓其海	地址：福建省福州市连江县长龙镇建庄村
福建省连江县透堡东风茶厂	null	地址：福建省福州市连江县透堡镇北街村
福建省连江县茶厂经销部	null	地址：福建省福州市连江县凤城镇玉荷东路４号
福建省连江县透堡高山茶厂	null	地址：福建省福州市连江县透堡镇北街村
连江县百胜生猪养殖场	联系人：陈仕光	地址：福建省福州市连江县百胜村店头
福建省连江县透堡庐山茶厂	null	地址：福建省福州市连江县透堡镇北街
福建省连江县贵安新茂水产养殖公司	null	地址：福建省福州市连江县潘渡乡贵安村乾头
福建省连江县茶厂	厂长：卢先仁	地址：连江县东湖村
福建省连江县厦宫水产养殖有限公司	总经理：陈俊海	地址：福建省福州市连江县下宫乡政府大院内
连江县罗源湾水产养殖场	联系人：林毅	地址：福建省福州市连江县坑园乡下屿村
福建省连江县坑园碧海特家禽繁育场	null	地址：福建省福州市连江县坑园乡坑园村
福建省连江榕兴养猪场	联系人：陈榕平	地址：福建省福州市连江县敖江己古村梅洋路口
福建省连江县东湖司台茶场	null	地址：福建省福州市连江县司台村
连江亚细亚水产养殖有限公司	总经理：林世樵	地址：福建省福州市连江县丹阳镇水产养殖场
福建省国营连江陀市林场	null	地址：福建省福州市连江县潘渡乡陀市林场
连江县蓼沿乡林场	null	地址：福建省福州市连江县蓼沿乡岭头村
连江县贵安陈洋畜牧场	null	地址：福建省福州市连江县潘渡乡贵安村
福建省连江县定海水产育苗场	联系人：陈明端	地址：福建省福州市连江县筱埕镇定海村
连江县东岱镇星光畜牧场	null	地址：福建省福州市连江县东岱镇东岱街城里路６５号
福建省连江官坞龙安水产育苗有限公司	总经理：董志增	地址：福建省福州市连江县筱埕镇官坞村
福建省连江县良种场茶厂	null	地址：福建省福州市连江县良种场
连江县安凯新发水产养殖场	null	地址：福建省福州市连江县安凯乡奇达村
连江县坑园源兴水产养殖场	联系人：陈德春	地址：福建省福州市连江县坑园乡红下三叉路７５号
福建省连江县合发水产养殖有限公司	null	地址：福建省福州市连江县马鼻镇合丰村
连江县透堡镇林场	null	地址：福建省福州市连江县透堡镇林场西门上新村
福建省连江县官乌水产养殖场	null	地址：福建省福州市连江县筱埕镇官乌村临海南路１号
福建省连江县安凯恒盛水产养殖场	null	地址：福建省福州市连江县安凯乡文湾村
福建省连江县潘渡果牧场	联系人：林伙英	地址：福建省福州市连江县潘渡乡宝溪
福建省连江县马鼻农业开发综合场	联系人：张艳国	地址：福建省福州市连江县马鼻镇政府内
中国人民解放军３２３６０部队农场服务社	null	地址：福建省福州市连江县宫坂镇
连江县畲山生态农场	联系人：谢建文	地址：福建省福州市连江县小沧畲族小沧乡
连江县安凯乡畜牧兽医站	null	地址：福建省福州市连江县安凯乡
连江县筱埕镇蓝田水产养殖场	联系人：邱宝敬	地址：福建省福州市连江县筱埕镇定海村长沃
连江县坑园畜牧兽医站	null	地址：福建省福州市连江县坑园乡坑园村
连江县长龙畜牧兽医站	null	地址：福建省福州市连江县长龙畜牧兽医站
福建省连江县兽医卫生监督检验所	所长：林银弟	地址：福建省福州市连江县百凤小区畜牧兽医站楼
连江县畜牧兽医技术服务中心试验羊场	null	地址：福建省福州市连江县凤城西郊玉泉山
连江县黄岐畜牧兽医站	站长：陈孝理	地址：福建省福州市连江县黄岐畜牧兽医站
连江县东湖畜牧兽医站	站长：郑光寿	地址：福建省福州市连江县东湖镇东湖村
连江县畜牧兽医站	null	地址：福建省福州市连江县农业局
连江县透堡镇兽医站	null	地址：福建省福州市连江县透堡镇政府
连江县筱埕镇兽医站	站长：陈本香	地址：福建省福州市连江县筱埕镇筱埕村龙舟路７６号
连江县丹阳畜牧兽医站	null	地址：福建省福州市连江县丹阳镇丹阳新街
连江县农业局桂林园艺场	null	地址：福建省福州市连江县丹阳镇桂林村
连江县园艺场	null	地址：福建省福州市连江县敖江镇横槎村
连江县小沧畜牧兽医站	null	地址：福建省福州市连江县小沧乡人民政府
福建省连江县贵安温泉鳗场	null	地址：福建省福州市连江县潘渡乡贵安村
福建省连江县贵安友源养鳗场	null	地址：福建省福州市连江县潘度乡贵安村桃源
福建省连江恒丰远洋渔业有限公司	null	地址：福建省福州市连江县苔录镇苔录村
福建省连江雄利远洋渔业开发有限公司	总经理：姚河品	地址：福建省福州市连江县凤城镇西渠路２５号
连江县公安局长龙派出所	所长：吴庆辉	地址：福建省福州市连江县长龙镇建庄村
连江县筱埕镇人民武装部	null	地址：福建省福州市连江县筱埕镇政府
连江县?头镇人民武装部	null	地址：福建省福州市连江县?头镇连江路１号
连江县公安局城关派出所	所长：邱去煌	地址：福建省福州市连江县凤城镇青年路1号
连江县公安局东岱边防派出所	null	地址：福建省福州市连江县东岱镇
连江县公安局安凯派出所	所长：方金泉	地址：福建省福州市连江县安凯乡安凯村
连江县晓沃镇人民武装部	null	地址：福建省福州市连江县晓沃镇晓丰街庆丰路６号
连江县公安局蓼沿派出所	所长：林 琰	地址：福建省福州市连江县蓼沿乡
连江县公安局小沧派出所	所长：林英东	地址：福建省福州市连江县小沧乡李园坪
连江县公安局晓沃派出所	所长：刘宜文	地址：福建省福州市连江县晓沃镇晓锋街庆丰路６号
连江县公安局黄岐派出所	所长：陈应增	地址：福建省福州市连江县黄岐镇海丰街
连江县公安局坑园派出所	所长：邱少武	地址：福建省福州市连江县坑园乡坑园村宏达路
连江县公安局丹阳林业派出所	null	地址：福建省福州市连江县丹阳镇
连江县公安局苔录派出所	所长：江光遴	地址：福建省福州市连江县苔录镇茭南村
连江县看守所	所长：赵依发	地址：福建省福州市连江县敖江镇小湾村
中共连江县委台湾工作办公室	联系人：陈玉平	地址：福建省福州市连江县中共连江县委大院
连江县凤城镇人民武装部	null	地址：福建省福州市连江县凤城镇经济巷３１号
连江县敖江镇人民武装部	null	地址：福建省福州市连江县凤城镇经济巷
连江县人民武装部	null	地址：福建省福州市连江县凤城镇西北街爱国路１５６号
连江县蓼沿乡人民武装部	老板：林功波	地址：福建省福州市连江县蓼沿乡人民武装部
福建省连江县妇女联合会	联系人：王少霞	地址：福建省福州市连江县凤城镇八一六北路县委大院
连江县公安局浦口派出所	所长：林世新	地址：福建省福州市连江县浦口镇浦江街
中国共产主义青年团连江县透堡镇委员会	null	地址：福建省福州市连江县透堡镇南街村
连江县归国华侨联合会	联系人：李贤团	地址：福建省福州市连江县凤城镇八一六北路县委大院
中国共产主义青年团连江县浦口镇委员会	联系人：吴安华	地址：福建省福州市连江县浦口镇人民政府院内
连江县凤城镇妇女联合会	null	地址：福建省福州市连江县凤城镇经济巷３１号
连江县晓沃镇妇女联合会	null	地址：福建省福州市连江县晓沃镇晓丰街庆丰路６号
连江县蓼沿乡妇女联合会	null	地址：福建省福州市连江县蓼沿乡人民政府院内
连江县浦口镇妇女联合会	联系人：傅丽华	地址：福建省福州市连江县浦口镇人民政府院内
连江县蓼沿乡计划生育办公室	null	地址：福建省福州市连江县蓼沿乡人民政府院内
连江县透堡镇妇女联合会	null	地址：福建省福州市连江县透堡镇南街村
连江县公安局丹阳派出所	所长：柯小萼	地址：福建省福州市连江县丹阳镇新街１号
中国共产主义青年团连江县蓼沿乡委员会	null	地址：福建省福州市连江县蓼沿乡人民政府院内
中国共产主义青年团连江县晓沃镇委员会	null	地址：福建省福州市连江县晓沃镇晓丰街庆丰路６号
连江县工商业联合会	联系人：黄烂汉	地址：福建省福州市连江县凤城镇莲荷东路21号楼203房
共青团连江县凤城镇委员会	null	地址：福建省福州市连江县凤城镇经济巷３１号
连江县基督教三自爱国运动委员会	联系人：陈月华	地址：福建省福州市连江县凤城镇玉山村基督教两会
连江县公安局潘渡派出所	所长：程文生	地址：福建省福州市连江县潘渡乡潘渡村
连江县公安局敖江派出	联系人：王闽华	地址：福建省福州市连江县凤城镇经济巷31号
连江县公安局马鼻派出所	所长：陈建华	地址：福建省福州市连江县马鼻镇横厝村
连江县坑园乡人民武装部	null	地址：福建省福州市连江县坑园乡坑园村
连江县公安局筱埕派出所	所长：廖修兴	地址：福建省福州市连江县筱埕乡筱埕村
连江县公安局东岱派出所	所长：刘用辉	地址：福建省福州市连江县东岱镇演宫村
连江县科学技术协会	联系人：冯坤明	地址：福建省福州市连江县凤城镇八一六北路县委大院
连江县凤城镇西北街居民委员会	null	地址：福建省福州市连江县凤城镇经济巷２９号
连江县凤城镇凤园街居民委员会	null	地址：福建省福州市连江县凤城镇凤园路３８号
连江县黄岐镇海丰街居民委员会	联系人：王依平	地址：福建省福州市连江县黄岐镇海丰街居委会
连江县晓沃镇晓江街居民委员会	null	地址：福建省福州市连江县晓沃镇晓江街
连江县凤城镇东南街居民委员会	null	地址：福建省福州市连江县凤城镇东南街建国路５９号
连江县凤城镇西南街居民委员会	null	地址：福建省福州市连江县西南街中山路２７号
连江县敖江镇凤尾村民委员会	null	地址：福建省福州市连江县敖江镇凤尾村
连江县凤城镇东北街居民委员会	null	地址：福建省福州市连江县凤城八一六东路１号楼２０２房
连江县凤城镇北门街居民委员会	null	地址：福建省福州市连江县凤城镇北门街文明西路２０号楼
连江县浦口镇浦旗居民委员会	null	地址：福建省福州市连江县浦口镇浦旗居民委员会
连江县黄岐镇海英街居民委员会	null	地址：福建省福州市连江县黄岐镇海英街
连江县公安局东湖派出所	所长：杨 青	地址：福建省福州市连江县东湖乡东湖村
连江县黄岐镇古石村民委员会	联系人：陈锋	地址：福建省福州市连江县黄岐镇古石村
连江县黄岐镇赤沃村民委员会	null	地址：福建省福州市连江县黄岐镇赤沃村
连江县敖江镇白沙村民委员会	null	地址：福建省福州市连江县敖江镇白沙村
连江县苔录镇苔录村民委员会	null	地址：福建省福州市连江县苔录村城墙头路３４号
连江县透堡镇西门村民委员会	null	地址：福建省福州市连江县透堡镇西门村
连江县敖江镇杉塘村民委员会	null	地址：福建省福州市连江县敖江镇杉塘村
连江县敖江镇毗盹村民委员会	null	地址：福建省福州市连江县敖江镇毗盹村
连江县黄岐镇海建街居民委员会	null	地址：福建省福州市连江县黄岐镇海建街
连江县筱埕镇逻回村民委员会	null	地址：福建省福州市连江县筱埕镇逻回村
连江县下宫乡厦一村民委员会	null	地址：福建省福州市连江县下宫乡厦一村
连江县黄岐镇大建村民委员会	null	地址：福建省福州市连江县黄岐镇大建村民委员会
连江县浦口镇浦升居民委员会	联系人：滕国锋	地址：福建省福州市连江县浦口镇浦升居民委员会
连江县筱埕镇凤贵村民委员会	null	地址：福建省福州市连江县筱埕镇凤贵村
连江县个体劳动者协会筱埕分会	null	地址：福建省福州市连江县筱埕镇工商所院内
连江县凤城镇西北街居委会粪管组	null	地址：福建省福州市连江县凤城镇西北街经济巷２９号
连江县个体劳动者协会敖江分会	联系人：陈顺英350122	地址：福建省福州市连江县凤城镇凤尾王家村
连江县离退休教师协会	null	地址：福建省福州市连江县玉荷西路
中国鱼船船东互保协会福建黄岐营业部	null	地址：福建省福州市连江县黄岐镇
连江县个体交通运输协会	null	地址：福建省福州市连江县凤城镇八一六北路１０３号
连江县个体劳动者协会东岱分会	null	地址：福建省福州市连江县东岱镇通学路６３号
连江县个体劳动者协会浦口分会	null	地址：福建省福州市连江县浦口镇浦口街浦西路５０号
福建省连江县筱埕东坪老人协会	null	地址：福建省福州市连江县筱埕东坪村
连江县公安局可门边防派出所	所长：翁新春	地址：福建省福州市连江县下宫乡可门村
连江县公安局安海边防派出所	所长：邱和银	地址：福建省福州市连江县安凯乡安海村安峰路３１号
连江县敖江镇魁岐村民委员会	null	地址：福建省福州市连江县敖江镇魁岐村
连江县计划生育协会	null	地址：福建省福州市连江县政府大院二楼
连江县个体劳动者协会马鼻分会	联系人：陈友国	地址：福建省福州市连江县马鼻镇横厝街
连江县个体劳动者协会潘渡分会	null	地址：福建省福州市连江县潘渡乡工商所院内
连江县凤城镇东南街老人协会	null	地址：福建省福州市连江县凤城镇东南街
连江县个体劳动者协会黄岐分会	null	地址：福建省福州市连江县黄岐镇工商所院内
连江县个体劳动者协会晓沃分会	null	地址：福建省福州市连江县晓沃镇政府办公大楼内
连江县东岱镇东岱街居民委员会	null	地址：福建省福州市连江县东岱镇东岱街开通路１号
连江县黄岐镇海新街居民委员会	null	地址：福建省福州市连江县黄岐镇海新街
连江县浦口镇浦东居民委员会	null	地址：福建省福州市连江县浦口镇浦东街
连江县透堡镇人民代表大会主席团	联系人：陈就光	地址：福建省福州市连江县透堡镇北街村
连江县浦口镇人民代表大会主席团	联系人：吴孔亮	地址：福建省福州市连江县浦口镇人民政府院内
连江县蓼沿乡人民代表大会主席团	null	地址：福建省福州市连江县蓼沿乡人民政府院内
连江县?头镇人民代表大会主席团	null	地址：福建省福州市连江县?头镇连江路１号
中共连江县　头镇纪律检查委员会	null	地址：福建省福州市连江县　头镇连江路１号
中国共产党连江县丹阳镇委员会	联系人：林强	地址：福建省福州市连江县丹阳镇
中共连江县凤城镇委员会	联系人：雷存良	地址：福建省福州市连江县凤城镇经济巷３１号
中共连江县委组织部	老板：袁苏欣	地址：福建省福州市连江县八一六北路８１号
连江县敖江镇人民代表大会主席团	联系人：杨元太	地址：福建省福州市连江县敖江镇白沙村
中共连江县委机要局	局长：张理太	地址：福建省福州市连江县凤城镇八一六北路县委大院
福建省连江县潘渡贵安机砖厂	null	地址：福建省福州市连江县潘渡乡贵安
福州海发水产有限公司	总经理：孙贞铿	地址：福建省福州市连江县苔录镇秀邦村白沙
福建省连江县长龙兴隆空心机砖厂	null	地址：福建省福州市连江县长龙乡下洋村
福建省连江县安凯船舶修配厂	null	地址：福建省福州市连江县安凯乡高塘村
连江余庆堂水产有限公司	总经理：魏阿旺	地址：福建省福州市连江县筱埕镇逻回村　　　　法定代表人：魏阿旺
福建省连江县恒达水产有限公司	null	地址：福建省福州市连江县苔录镇北茭村
福建省连江县华顺金属制品有限公司	总经理：林传源	地址：福建省福州市连江县潘渡乡坡西村
福州超达日用化工有限公司日用化工厂	null	地址：福建省福州市连江县百胜半埕南片工业开发区内
福建省连江县山边食品厂	null	地址：福建省福州市连江县丹阳镇山边村
福建省连江县兴业水产有限公司	null	地址：福建省福州市连江县黄岐水产站
福建省连江县蓝赐冷冻食品有限公司	总经理：黄家信	地址：福建省福州市连江县凤城镇玉荷东路
福建省连江县丹阳镇水产食品厂	null	地址：福建省福州市连江县丹阳镇新街
连江旭隆食品有限公司	成立日期：1993/9/14	地址：中国 福建 福州市 福建省连江县晓沃镇福兴北路38号`
福建省连江县双猫水产食品有限公司	null	地址：福建省福州市连江县坑园乡下与村
福建省连江县闽新塑胶厂	null	地址：福建省福州市连江县敖江镇鲤鱼山（配合饲料厂）
福建省连江县安凯奇达水产品加工厂	厂长：林通利	地址：福建省福州市连江县安凯乡奇达村
福建省连江北茭宏顺水产冷冻厂	厂长：欧国福	地址：福建省福州市连江县苔录镇北茭村
福州露卡水产有限公司	总经理：许永寿	地址：福建省福州市连江县苔录镇茭南村　　　　法定代表人：许永寿
福建省连江奔腾电脑有限公司	null	地址：福建省福州市连江县城关温麻路２５０号
福建省连江福星水产有限公司	null	地址：福建省福州市连江县凤城镇凤园路４９号
福州荣辉食品有限公司	总经理：郑洪仁	地址：福建省福州市连江县苔录镇苔录村后山路28号
连江县益龙水产食品有限公司	总经理：林华义	地址：福建省福州市连江县坑园乡下屿村
福州青芝食品有限公司	总经理：卢彬	地址：福建省福州市连江县敖江镇鲤鱼山村
福建省连江县丹阳创兴食品厂	厂长：黄高玉	地址：福建省福州市连江县丹阳镇山边村
福建省连江正亚电脑有限公司	总经理：林超武	地址：福建省福州市连江县凤城镇莲荷东路７号楼３０５室
福建省连江县四丁电脑有限公司	总经理：林海滨	地址：福建省福州市连江县文山路１号楼１１１号
福州旭煌食品有限公司	总经理：邱德标	地址：福建省福州市连江县晓沃镇晓兴街福兴北路２７１号
福建省鲜美食品饮料有限公司	null	地址：福建省福州市连江县新大桥南
连江县鹏翔卫生纸品厂	厂长：熊晓鹏	地址：福建省福州市连江县凤城镇东南街卫民路７７号
福建省连江县透堡乡机砖厂	厂长：杨自如	地址：福建省福州市连江县透堡乡
福建省连江县多功能电焊机厂	null	地址：福建省福州市连江县敖江镇工业小区（东湖头）
福建省连江县华盛水产制冰厂	null	地址：福建省福州市连江县苔录镇秀邦村
福建省连江县华凤水产制冰厂	厂长：杨凤娥	地址：福建省福州市连江县苔录镇北交村
福建省连江县天键电脑有限公司	总经理：王秋皓	地址：福建省福州市连江县凤城镇凤园路１５号
福建省连江盛源水产有限公司	null	地址：福建省福州市连江县筱埕镇定海长沃
福建省宏声水产有限公司连江苔录加工部	null	地址：福建省福州市连江县苔录镇横?村
福建省连江县福连食品厂	null	地址：福建省福州市连江县凤城镇玉山村原部队酱奇厂内
福建省连江县酱奇调味品厂	厂长：黄立国	地址：福建省福州市连江县凤城镇８１６西路４９号
福建省连江腾达干鲜食品冷冻厂	厂长：郑祯佃	地址：福建省福州市连江县晓沃镇福兴路２７９号
连江县黄岐旺达水产精品加工冷冻厂	厂长：林登东	地址：福建省福州市连江县黄岐镇海建居委会楼下
福建省连江县腾达食品冷冻厂	厂长：邱碧玉	地址：福建省福州市连江县晓沃镇福兴北路1号
福建连江凤华石油液化气有限公司第二门市部	null	地址：福建省福州市连江县玉荷西路裕曦楼东一间
福建省连江县定海冷冻厂	null	地址：福建省福州市连江县定海长沃
福建省连江县坑园象韦水产冷冻厂	null	地址：福建省福州市连江县坑园象韦岭头
福建省连江县金辉水产品加工厂	null	地址：福建省福州市连江县筱埕东平村
福建省连江县东岱塑料鞋革厂	厂长：詹金国	地址：福建省福州市连江县东岱镇湖里村
福建连江凤华石油液化气有限公司第一门市部	null	地址：福建省福州市连江县莲荷西路６号楼１１间
福建省连江县透堡生猪定点屠宰场	联系人：黄梅德	地址：福建省福州市连江县透堡镇南街村上坂
连江县官岭陈翔农机修配厂	厂长：陈翔	地址：连江县浦口镇官岭村
连江县中麻由兴水产品加工场	联系人：张由兴	地址：福建省福州市连江县浦口镇中麻村
福建省连江县东坪水产品加工厂	null	地址：福建省福州市连江县筱埕镇东坪村
福建省连江县晓丰水产食品厂	null	地址：福建省福州市连江县晓沃晓丰
连江县敖江建林碾米加工场	null	地址：福建省福州市连江县良种场内
连江县凤城兴达鱼钙饲料厂	null	地址：福建省福州市连江县提坝外
福州禄丰水产食品有限公司	null	地址：福建省福州市连江县黄岐镇码头边
福建省连江县凤城铸造厂	厂长：洪森木	地址：福建省福州市连江县凤城镇（气象站对面）
福州航盛饲料有限公司连江经营部	null	地址：福建省福州市连江县莲荷路福来新村Ａ座３０３室
福建省连江郑联塑料包装制品有限公司	null	地址：福建省福州市连江县丹阳镇虎山村
连江县坑园红下饲料厂	null	地址：福建省福州市连江县坑园乡红下村
连江县凤城镇五金机电修配厂	null	地址：福建省福州市连江县凤城镇彩云巷１１８号
连江县文化用品厂	厂长：陈美伙	地址：福建省福州市连江县凤城镇八一六东路６号
福建省连江县坑园厦宫水产品加工厂	null	地址：福建省福州市连江县坑园乡厦宫村
福建省连江县食品厂南门经营部	null	地址：福建省福州市连江县凤城镇八一六南路１８号
连江县马鼻水产品加工厂	null	地址：福建省福州市连江县马鼻镇玉井村
福州富拉马斯塑胶有限公司	成立日期：2002/9/24	地址：中国 福建 福州市 福州市连江县敖江镇下山村连黄路
福建兴义金属制品有限公司	null	地址：福建省福州市连江县 头镇竹岐村新车站
