福建诚付天下金融技术服务有限公司福州连江分公司	总经理：林	地址：连江县凤城镇玉山小区104国道西侧1#楼101单元
福建省京舜建设工程有限公司连江分公司	总经理：陈	地址：连江县凤城镇816中路安盛大厦2#楼605
连江县菊红农业综合场	联系人：陈	地址：福建省福州市连江县长龙镇下洋村新建路115号
福州市闽诚家政服务有限公司连江分公司	总经理：范	地址：连江县凤城镇龙华花园二期19号楼4号店面
连江县丹阳镇法增铝合金铁门加工厂	厂长：陈	地址：福州市连江县丹阳镇山兜村长园坪
连江县蓼沿乡宝磊石料场	联系人：黄	地址：福州市连江县蓼沿乡溪东村单兜岗
连江县诚信天商务咨询服务有限公司	总经理：罗	地址：福建省福州市连江县凤城镇丹凤西路2号宏宇花园14#-16#14号店
连江县丹阳镇荣盛石材厂	厂长：黄	地址：福建省福州市连江县丹阳镇花园村
连江县旺居房产代理有限公司	总经理：黄	地址：福建省福州市连江县凤城镇北门街凤园路凤尾花园3#楼11店
福建佳创置业有限公司	总经理：林	地址：福建省福州市连江县凤城镇江滨西路3号江夏苑1#－4#楼二层33店面
福州财缘城投资有限公司	总经理：邵	地址：福建省福州市连江县凤城镇文山北路5号太一新天地1#楼7店面
福建华兰里农业综合开发有限公司	总经理：邱	地址：福建省福州市连江县马鼻镇贵峰村渔池墩路1号
福建瑞玻玻璃有限公司	总经理：陈	地址：福建省福州市连江县可门经济开发区坑园村溪尾路58号
福建省万坤建设工程有限公司	总经理：黄	地址：连江县凤城镇丹凤东路14号绿茵花园5#楼4层401单元
福州励志房地产开发有限公司	总经理：邱	地址：福建省福州市连江县安凯乡高塘村高塘路102号
连江县创宏建材有限公司	总经理：王	地址：福建省福州市连江县凤城镇国优路8号鲤鱼港湾5#楼11层1102单元
连江众安投资有限公司	总经理：王	地址：福建省福州市连江县马鼻镇横厝村红石12-2号
连江县泓帆渔业有限公司	总经理：刘	地址：连江县苔?镇茭南村宏图路43号
连江县兴丰服饰有限公司	总经理：庄	地址：连江县凤城镇丹凤东路15号丹凤花园44#楼13店面
连江县浦口镇山海经农业专业合作社	联系人：林	地址：连江县浦口镇中麻村里澳269号
福建省上善星电缆有限公司	总经理：林	地址：连江县经济开发区敖江工业园区1#楼福建世纪电缆有限公司内
福州市金汇通投资咨询有限公司	总经理：林	地址：连江县凤城镇丹凤东路7号迪鑫花园6#1号店
福州市日志环保科技有限公司	总经理：林	地址：福建省福州市连江县凤城镇莲荷东路25#楼B座3车库
福州市恩佑再生资源有限公司	总经理：王	地址：福建省福州市连江县坑园镇下元村前进路29号
连江县黄岐镇郑秀敏渔需制品厂	厂长：郑	地址：福建省福州市连江县黄岐镇大建村建强路码头边
连江县金莎水产养殖有限公司	总经理：汪	地址：福建省福州市连江县黄岐镇后仑村西路23号
福建泰龙源农业开发有限公司	总经理：黄	地址：福州市连江县透堡镇馆读村门前埕D9号2户
福建省鸿翔广告工程有限公司	总经理：林	地址：连江县凤城镇莲荷东路18#A2号店
连江县庆源燃料油贸易有限公司	总经理：占	地址：福建省福州市连江县浦口镇中麻村
福州源鑫盛源实业有限公司	总经理：林	地址：福建省福州市连江县可门开发区管委会坑园镇坑园村溪尾路58号
福建省连江县西山顶综合农场（普通合伙）	联系人：林	地址：福建省福州市连江县蓼沿乡利畲村西山自然村
中国移动通信集团福建有限公司连江商专营业厅	联系人：陈	地址：连江县潘渡村福建商业高等专科学校新校区商业街
福州盛龙塑胶有限公司牡丹洋分公司	总经理：潘	地址：连江县蓼沿乡定田村牡丹洋垅头厝山地
连江县丹阳镇顶尚丽盾工艺石加工厂	厂长：雷	地址：福州市连江县丹阳镇新洋村
连江县玉平养兔场	联系人：刘	地址：福建省福州市连江县江南乡澄岩村
连江县苔?旺角酒厂	厂长：林	地址：福建省福州市连江县苔?镇苔?村后港1#、2#、3#D6#
福建省假日国际旅行社有限公司连江?头营业部	老板：倪	地址：福建省福州市连江县?头镇街道团结路11号
福建省鑫恒投资有限公司	总经理：韩	地址：连江县凤城镇金安西路2号龙芝国际商业广场1层5店面
福建省生久担保有限公司	总经理：陈	地址：福建省福州市连江县凤城镇丹凤西路2号宏宇花园14-16#14号店
连江县鑫瑞咨询服务有限公司	总经理：谢	地址：连江县凤城镇丹凤东路15号丹凤花园43#楼14店面
福州良特贸易有限公司	总经理：吴	地址：福建省福州市连江县?头镇开放路东侧宏源新苑4#楼503室
福州市超浪养殖有限公司	总经理：林	地址：福建省福州市连江县坑园镇屿头村富新路4号
连江县凤城镇依宝药店	老板：谢	地址：福建省福州市连江县凤城镇丹凤东路15号丹凤花园2#楼6-9号店
福建省新马会旅游开发有限公司	总经理：李	地址：福建省福州市连江县潘渡乡贵安村科技大楼305室
连江县坑园镇颜岐富珍水产品经营部	老板：颜	地址：福建省福州市连江县坑园镇颜岐村新民南路94号
福建连江宏大建筑工程有限公司	总经理：姚	地址：连江县下宫乡厦一村一条山脚
连江县九源燃料油有限公司	总经理：林	地址：福建省福州市连江县?头镇下岐村113号
福建宜联管业有限公司	总经理：林	地址：连江县敖江镇青塘村工业园区1#厂房
福州市宏日建筑劳务有限公司	总经理：杨	地址：福建省福州市连江县凤城镇江滨路景江花园二期D型E12一层
连江县坑园镇光辉海产品厂	厂长：颜	地址：福建省福州市连江县坑园镇颜岐村新民南路礼堂边
福州盛运物流有限公司	总经理：赵	地址：连江县沈海高速公路与文笔东路交叉口东北角
连江县长龙镇龙发农民专业合作社	联系人：陈	地址：福建省福州市连江县长龙镇建庄村后门洋
连江县凤城镇我家聚餐园玉荷分店	老板：林	地址：福建省福州市连江县凤城镇玉荷西路（原西餐厅）2#楼9号店、10号店
神州坤元（福建）建设工程有限公司	总经理：郑	地址：福建省福州市连江县凤城镇816东路109号六层
连江县坑园镇颜岐村广隆超市	联系人：颜	地址：福建省福州市连江县坑园镇颜岐村大兴东路310号
福州市金石馆工艺品有限公司	总经理：王	地址：福建省福州市连江县凤城镇丹凤东路3-460号9#楼1层112号店
兴锋盈（福建）集团有限公司连江分公司	总经理：官	地址：连江县潘渡乡贵安村后垄仔责任田
福建康佰家大药房连锁有限公司一二二店	老板：严	地址：连江县?头镇上坪路18号鑫立大厦第一层店面
连江县渔港旅游开发有限公司	总经理：谢	地址：福建省福州市连江县苔?镇秀邦村北沃五路二扇一直
连江县好帮手家庭服务有限公司	总经理：范	地址：连江县凤城镇金凤名都10#楼1层7号店面
连江县华商翼企业管理有限公司	总经理：林	地址：福建省福州市连江县凤城镇816南路巨林商厦1#楼1-19号店面
福建省得力宝五金工具有限公司	总经理：王	地址：连江县?头镇东边村连港路北侧3#1层
连江县马鼻镇金石石材加工厂	厂长：陈	地址：福建省福州市连江县马鼻镇车站西侧
福建金沙岛投资有限公司	总经理：林	地址：连江县凤城镇华光西路2号凤凰城10#楼1店面
福建中汇典当有限公司	总经理：高	地址：福建省福州市连江县贵安新天地贵锦苑商业1号楼21店
连江县晓澳镇金山禽畜养殖场	联系人：林	地址：连江县晓澳镇道澳村二坪山南面
福州千穗农业开发有限公司	总经理：陈	地址：福建省福州市连江县透堡镇西门村西门街14号3户
福建晟鑫建设工程有限公司连江分公司	总经理：陈	地址：福建省福州市连江县凤城镇东北街816东路109号二层
连江县鱼奇海产品有限公司	总经理：王	地址：福建省福州市连江县凤城镇丹凤东路2号丹凤广场1#楼B座801
福州兴鑫旺贸易有限公司	总经理：陈	地址：连江县马鼻镇半田下村溪边区50号
福州百味食品有限公司连江分公司	总经理：陈	地址：连江县经济开发区东湖园区3#厂房一楼
承洁环保有限公司	总经理：陈	地址：连江县江南乡江南社区居委会307房
福州群龙兴贸易有限公司	总经理：欧	地址：连江县?头镇天麟明珠城7座404号
连江县顺鑫汽车租赁有限公司	总经理：李	地址：连江县凤城镇江滨东路18号景江花园二期D型23号店面
迪凯塑料制品有限公司	总经理：陈	地址：连江县丹阳镇虎山村连江县丹阳造纸厂一层
连江县华源建材贸易有限公司	总经理：陈	地址：福州市连江县凤城镇文山北路5号太一新天地12#楼8层811单元
福州市旺林升汽车租赁有限公司	总经理：林	地址：福州市连江县丹阳镇104国道右侧12号住宅楼4号店面
福州市车迷城汽车服务有限责任公司	总经理：陈	地址：福州市连江县敖江投资区上高速路北侧、敖江路东侧8#标准厂房
福州海中水产有限公司	总经理：陈	地址：连江县马鼻镇玉井村二房里112号
福州创域装饰工程有限公司	总经理：林	地址：福建省福州市连江县凤城镇文山北路5号太一新天地1#楼14店面
福州丰畅购物中心有限公司	总经理：张	地址：连江县潘渡乡贵安村科技大楼
高明实业（福建）有限公司	总经理：赖	地址：连江县凤城镇文明东路1号
连江县卓创企业管理咨询有限公司	总经理：林	地址：福建省福州市连江县凤城镇文笔路6号凤翔国际二区17#楼1层20店面
连江县盛平企业管理咨询有限公司	总经理：张	地址：连江县凤城镇玉荷东路（台资大楼边）1#104
连江县雅顺广告工程有限公司凤城分公司	总经理：陈	地址：福建省福州市连江县凤城镇文山北路6号龙华花园3#楼1层3店面
福建省连江县世长水产养殖场	联系人：赵	地址：福建省福州市连江县筱埕镇定海村鲍鱼海区第一区
福建省连江县乾元水产品贸易有限公司	总经理：刘	地址：福建省福州市连江县苔?镇后湾村海滨路5号
福建连江恒欣村镇银行股份有限公司?头支行	联系人：陈	地址：福建省福州市连江县?头镇拱屿村开放路东川花园B#B单元
福建中永建设工程有限公司连江分公司	总经理：陈	地址：福建省福州市连江县凤城镇文山北路6号龙华花园16#楼2层202单元
福建兴坤达钢结构工程有限公司	总经理：陈	地址：福建省福州市连江县敖江镇浦下村原荷山造纸厂
福建永恒兴投资有限公司	总经理：陈	地址：福建省福州市连江县凤城镇文山北路6号龙华花园商业用房1层4店面
福建省连江县黄岐枝达海洋渔具制造厂	厂长：林	地址：福建省福州市连江县黄岐镇海建街畚箕山
福建省大众农业综合开发有限公司	总经理：黄	地址：福建省福州市连江县蓼沿乡定田村下岩路92号
福建省同友房地产开发有限公司	总经理：唐	地址：福建省福州市连江县凤城镇丹凤西路2号宏宇花园14-16#楼14号店
中国人寿保险股份有限公司连江县支公司第十营销服务部	老板：李	地址：福建省福州市连江县?头镇劳动路100号二层
福建聚磊建材有限公司	总经理：袁	地址：福建省福州市连江县江南乡境路村垅里工业区3号
福建宫福水产进出口有限公司	总经理：卓	地址：连江县晓沃镇道沃村1#楼
连江县东岱镇靓装建材店	老板：林	地址：连江县东岱镇东岱街邮电局对面
连江县北茭富源渔业有限公司	总经理：林	地址：福建省福州市连江县苔?镇北茭村吴城面14号
连江县大宇贸易有限公司	总经理：周	地址：福建省福州市连江县?头镇兰田村1#1层101室
连江县宜又佳一心堂大药房	联系人：杨伙祯	地址：连江县凤城镇丹凤东路3号迪鑫花园7-9#5-6号店
中国联合网络通信有限公司连江县分公司?头营业厅	联系人：江兆逵	地址：福州市连江县?头镇拱屿村开放路福鑫花园三鑫楼一层店面2-3间
连江尚艺文化艺术创作中心	联系人：吴秋明	地址：连江县?头镇东川大厦5号店
福建榕冠建材有限公司	总经理：邹祖江	地址：连江县?头镇莲花小镇3#楼301
连江县下宫乡初芦村饶丰水产养殖场	联系人：戴起平	地址：连江县下宫乡初芦村海区（鲍鱼海区第6区）2#
连江县下宫乡初芦村鸿洋水产养殖场	联系人：吴诗富	地址：连江县下宫乡初芦村海区（鲍鱼海区第8区）2#
连江县下宫乡初芦村福盛水产养殖场	联系人：郑家乐	地址：连江县下宫乡初芦村海区（鲍鱼海区第5区）
连江县苔?镇?邦村茂恒塑料厂	厂长：谢茂行	地址：连江县苔?镇?邦村塔仔下
连江县南洋水产开发有限公司	总经理：郑树立	地址：连江县坑园镇下屿村建胜路6-2号
福州市银浩电子有限公司	总经理：陈举先生	地址：连江县凤城镇丹凤路北侧5号丹凤朝阳花园3A#楼4层402单元
福州乾开装饰设计工程有限公司	总经理：尹炳乾	地址：连江县凤城镇文笔路6号凤翔国际二区2#楼1层51店面
福州昌育农业开发有限公司	总经理：郑秀玉	地址：连江县丹阳镇山边村溪下
福建五木农业综合开发有限公司	总经理：林群先生	地址：连江县蓼沿乡仁板村委员会办公楼二层201室
福建鸿元混凝土有限公司	总经理：李光敏	地址：连江县?头镇青芝大道6号天麟城4#楼2层202单元（生产场所另设）
东宝利（连江）投资有限公司	总经理：魏能雄	地址：连江县黄岐镇海建街漠沙湾
连江县东湖镇顺兴木材加工厂	厂长：兰先生	地址：连江县东湖镇飞石村山岗（福飞路中截）
连江县黄岐镇赤才村吴品贵水产养殖场	联系人：吴先生	地址：连江县黄岐镇赤才村赤才2号（养殖场所：赤才海区）
连江县盛源金凤百货有限公司	总经理：周先生	地址：连江县816西路金凤西城一层1-20店
福建省交泰建设工程有限公司	总经理：罗小星	地址：连江县凤城镇莲荷东路27号楼6号店面
连江县丹阳镇冠峰果蔬专业合作社	联系人：兰先生	地址：连江县丹阳镇后冠村后湾7-15号
福州市拓?砂石加工有限公司	总经理：林先生	地址：连江县潘渡乡沿江大道一号贵安新天地贵邦苑17号店
福州卉盛生态农业科技有限公司	总经理：陈先生	地址：连江县长龙镇岚下村院后64号
中国邮政储蓄银行股份有限公司连江县?头营业所	所长：董端清	地址：连江县?头镇联合路23号侨隆花园1区C、D幢11-15店
连江县黄岐建乐海珍品育苗场	联系人：郑尚乐	地址：连江县黄岐镇大建村岭下
华泰保险销售有限公司福建省分公司福州市连江凤城营业部	老板：汪?先生	地址：连江县凤城镇玉山村玉荷西路592号
连江县友长贸易有限公司	总经理：陈先生	地址：连江县凤城镇莲荷西路3#楼7号店面
福州东昌建设工程有限公司	总经理：郑先生	地址：连江县敖江镇青塘村3#楼
福州市广源再生资源回收有限公司	总经理：陈先生	地址：连江县凤城镇东北街816东路4号1#
连江县苔?镇后湾村黄勋水产养殖场	联系人：黄先生	地址：连江县苔?镇后湾村友谊路84号（养殖场所：后湾海区）
连江县招亮宾馆	联系人：谢先生	地址：连江县凤城镇玉山村玉荷西路104国道东侧
连江县七色光家庭服务有限公司	总经理：谢先生	地址：连江县凤城镇解放路风都花园3#-4#10号店
福建锦绘包装有限公司	总经理：翁先生	地址：连江县敖江镇敖江投资区青龙路
福建省连江县新天地建材有限公司	总经理：李先生	地址：福建省连江县贵安新天地贵香苑25幢303单元
闽材（福州）实业有限公司	总经理：范先生	地址：连江县蓼沿乡赤南岗石材加工区
福州市天泉生态养殖有限公司连江分公司	总经理：陈先生	地址：连江县丹阳镇新洋村原养鳗场
连江县安凯乡凤达鲍鱼养殖场（普通合伙）	联系人：吴先生	地址：连江县安凯乡奇达村外澳路60号
福州万星商贸有限公司	总经理：谢先生	地址：连江县江南乡南江滨西路1号华庆花园B区3#楼402单元
福建纵横农业有限公司	总经理：魏先生	地址：连江县透堡镇陇柄村建新路45号-2
福建超雅食品有限公司连江县文山经营部	老板：陈先生	地址：连江县凤城镇文山北路5号太一新天地13#楼01店面
连江县苔?镇??村新海源渔需制品厂	厂长：何先生	地址：连江县苔?镇??村山仔
福建宏江置业有限公司	总经理：林义奇	地址：连江县敖江工业园区上山村（福州金铭机械有限公司）1#办公楼二层
连江县苔?镇后湾村鸿通鲍鱼场	联系人：黄元楚	地址：连江县苔?镇后湾村小汴港
连江县三强建材有限公司	总经理：洪茂青	地址：连江县县城区敖江路与丹凤路交叉口东南角玉沙综合商场一层12号店面
励德置业（福州）有限公司	总经理：吕仲琦	地址：连江县东湖镇山岗交通管理站
连江县东岱镇家元便利店	老板：林财玉	地址：连江县东岱镇东旺路35号
连江县苔?镇开实修船厂	厂长：谢礼俊	地址：连江县苔?镇后港西北路
连江县盛豪机械有限公司	总经理：腾先生	地址：连江县浦口镇锦山寺边
连江县凯翔闽剧团	联系人：周先生	地址：连江县?头镇竹岐村建新路194号
连江县透堡镇尖墩村永达力水产养殖场	联系人：王先生	地址：连江县透堡镇尖墩村海堤边
连江县筱埕镇埕口村方是和燃料油销售站	站长：方先生	地址：连江县筱埕镇埕口村东昌路35号
连江县安凯乡双龙养殖专业合作社	联系人：吴碧娟	地址：连江县安凯乡奇达村金海湾3#203室
连江县敖江尧俊种植专业合作社	联系人：陈碧芳	地址：连江县敖江镇幕浦村南门三排1号
连江县长龙镇云上茶乡农民专业合作社	联系人：陈为秀	地址：连江县长龙镇岚下新村56号
连江县丹阳镇鑫源旧塑料颗粒加工厂	厂长：林世宝	地址：连江县丹阳镇松岭村油降顶
福建申发水务有限公司	总经理：陈学申	地址：连江县凤城镇丹凤东路66号A座
福州闽侨物业管理有限公司连江分公司	总经理：林琼先生	地址：连江县凤城镇华光西路金凤名都9#-10#中间
平安银行股份有限公司福州连江支行	联系人：关强先生	地址：连江县凤城镇金安西路2号龙芝国际商业广场1层1店面、2层1店面、2层1店面商业附属
连江县双福源贸易有限公司	总经理：滕国岑	地址：连江县凤城镇莲荷东路27号楼1店面
连江县蓼沿乡恒博制沙厂	厂长：张海龙	地址：连江县蓼沿乡首占村牛溪自然村过溪荒地
连江县马鼻镇红双喜大酒店	老板：陈裕欣	地址：连江县马鼻镇下街
福建日兴置业有限公司	总经理：江铭福	地址：连江县筱埕镇大埕村1#
连江县旺农农业综合开发有限公司	总经理：吴祯秋	地址：连江县下宫乡下宫村范厝后
连江县苔?镇后湾世纪群升鲍鱼养殖场	联系人：何可拳	地址：连江县苔?镇后湾村友谊路15号
连江县苔?镇后湾立晟鲍鱼养殖场	联系人：林立先生	地址：连江县苔?镇后湾村海滨路28号
连江县金苗养殖专业合作社	联系人：谢延备	地址：连江县坑园镇象纬村象新路75-2号
连江县贵安汤山温泉服务中心	联系人：龚兴胜	地址：连江县潘渡乡贵安村汤岭路
福州醉丰收餐饮管理有限公司	总经理：林惠富	地址：连江县凤城镇文山北路8号龙华花园二期28楼1层9店面
福建省连江县宏盛太阳电缆有限公司	总经理：宁勇娥	地址：连江县贵安新天地海峡传统文化街33号楼-16
福建省连江天都实业有限公司百胜分公司	总经理：叶峰华	地址：连江县晓澳镇百胜村长安街49号
福建连江县恒昌建材有限公司	总经理：陈民志	地址：连江县下宫乡下宫村华峰北路107-1号
连江县下宫乡初芦村鑫发水产养殖场	联系人：吴诗钦	地址：连江县下宫乡初芦村海区（鲍鱼海区第9区）
连江县下宫乡初芦村闽浩水产养殖场	联系人：吴克秀	地址：连江县下宫乡初芦村海区（鲍鱼海区第8区）
连江县下宫乡初芦村天洋水产养殖场	联系人：吴诗思	地址：连江县下宫乡初芦村海区（鲍鱼海区第7区）
连江县下宫乡初芦村万信水产养殖场	联系人：吴让会	地址：连江县下宫乡初芦村海区（鲍鱼海区第6区）
连江县真善美服装商行	联系人：郑云先生	地址：连江县马鼻镇横厝村委会楼下
连江县黄岐镇铭金水产养殖场	联系人：林本铭	地址：连江县黄岐镇海丰街丰兴路1号（养殖场所：黄岐澳边至赤沃红石边）
连江县茂丰乳品有限公司	总经理：苏芬先生	地址：连江县凤城镇玉荷东路金星综合楼一层内65店
福州市剀岩石油化工有限公司	总经理：陈榕先生	地址：连江县凤城镇莲荷西路6#楼603室
连江县凤城镇大友建材店	老板：孙大友	地址：连江县凤城镇凤翔国际二区5#楼77号店
福建省康辉国际旅行社股份有限公司连江营业部	老板：孙义恩	地址：连江县凤城镇丹凤东路14号绿茵花园1#楼1号店
连江县苔?镇亨凯水产经营部（普通合伙）	联系人：刘宏记	地址：连江县苔?镇茭南村后弄尾
连江县扬帆投资管理有限公司	总经理：黄章先生	地址：连江县凤城镇玉荷西路建行大楼1#六楼
福州裕胜物流有限公司	总经理：余惠乐	地址：连江县凤城镇文山北路7号金凤名都9#楼1304单元
连江县宇祥白蚁防治有限公司	总经理：许金龙	地址：连江县凤城镇816北路23#205
福建宏江酒店有限公司	总经理：刘用忠	地址：连江县敖江工业园区上山村（福州金铭机械有限公司）1#办公楼二层
连江县下宫乡下宫村大头建材店	老板：黄元钦	地址：连江县下宫乡下宫村滨海新区（电信局旁边）
连江县?头镇小脚丫童装店	老板：董金钗（香港居民）	地址：连江县?头镇开放路西侧侨隆花园I区第三号店
福建省连江县健康园大药房	联系人：张焰先生	地址：连江县?头镇开放路凤仪楼一层店
连江县凤城镇敏贵族宝贝童装店	老板：林赛平	地址：连江县凤城镇玉荷西路1#楼第19间店
连江县邦大投资有限公司	总经理：陈宜?	地址：连江县凤城镇文山北路7号金凤名都2#楼1层2店面
福建香山农业开发有限公司	总经理：张军妹	地址：连江县凤城镇莲荷西路36号玉泉住宅小区16#楼
连江县朝阳贸易有限公司	总经理：林承焕	地址：连江县凤城镇莲荷东路37#楼106店面
福建贞固沥青混凝土有限公司	总经理：林挺先生	地址：连江县凤城镇江滨东路19号傲江景城A2#楼1层03店面
北京华油鑫业工程技术有限公司连江分公司	总经理：朱建国	地址：连江县凤城镇丹凤东路12号
福州贵德贸易有限公司	总经理：郭仕章	地址：连江县凤城镇北门街816北路103号连江县交通局3#503房
福州贵润贸易有限公司	总经理：谢树娥	地址：连江县凤城镇北门街816北路103号连江县交通局3#502房
连江县平和闽剧团	联系人：刘纲彬	地址：连江县敖江镇经济开发区敖江园区厂房1座福州永日香食品有限公司内第三层
连江县畅恒贸易有限公司	总经理：林先生	地址：连江县江南乡复兴路8号科灵新天地2#楼1层3店面
神脑商贸（福建）有限公司福州连江八一六分公司	总经理：叶先生	地址：福州市连江县凤城镇西北街816北路94号
连江县顺昌闽剧团	联系人：王先生	地址：连江县凤城镇凤园路327号天和城2#楼11号车库
连江县坑园镇润丰建材经营部	成立日期：2011/8/30	地址：连江县坑园镇前屿村跃进路47号
福建省连江县淘阳贸易有限公司	成立日期：2011/8/30	地址：连江县坑园镇红下村三叉路111号
福州乾丰投资顾问有限公司	成立日期：2011/8/31	地址：连江县凤城镇丽景华府小区1#楼二层（丹凤西路6号）
连江县苔?镇宝忠水产经营部	成立日期：2011/9/1	地址：连江县苔?镇苔?村后山路11号
连江县苔?镇通恒海带养殖场	成立日期：2011/9/1	地址：连江县苔?镇后湾村朝阳路135号
连江县安峰水产专业合作社	成立日期：2011/9/2	地址：连江县安凯乡安海村安境路21号
连江县鸿发惠农种植专业合作社	成立日期：2011/9/2	地址：连江县安凯乡安海村安境路21号
福建省蓝碧环保工程有限公司	成立日期：2011/9/2	地址：连江县凤城镇莲荷东路百凤花园12#204单元
连江县好旺达超市食品经营部	成立日期：2011/9/2	地址：连江县江南乡华庆花园4-5楼一层（原农贸市场）食品区
连江县筱埕镇桂湾宝旺综合农场	成立日期：2011/9/5	地址：连江县筱埕镇筱埕村鸡沃湾
连江县坑园镇金成水产育苗场	成立日期：2011/9/6	地址：连江县坑园镇屿头村金牌
福州铭仕源礼品包装有限公司	成立日期：2011/9/7	地址：连江县安凯乡镇安村
连江县浩森贸易有限公司	成立日期：2011/9/7	地址：连江县凤城镇莲荷东路百凤花园连结体1#-3#第8店
福建省福能山煤投资有限公司	成立日期：2011/9/7	地址：福建省福州市连江县凤城镇北门街816北路14#
连江县苔?镇顺海虾皮经营部	成立日期：2011/9/8	地址：连江县苔?镇后港新区
连江县丹阳镇金运超市	成立日期：2011/9/8	地址：连江县丹阳镇104国道边4号楼2号
连江县双益机械有限公司	成立日期：2011/9/13	地址：连江县敖江投资区青龙路福州港发机电工业有限公司8号9号
福建汉森生物工程有限公司	成立日期：2011/9/13	地址：连江县江南乡（滨江社区居民委员会）南江滨西路1号华庆花园B区7#楼1704单元
福建省连江县台山置业管理服务有限公司	成立日期：2011/9/13	地址：连江县潘渡乡陀市村130号
连江县可门口鲍鱼养殖专业合作社	成立日期：2011/9/14	地址：连江县下宫乡下宫村滨海大道1号
连江县凤城镇小猴子台湾茶饮店	成立日期：2011/9/19	地址：连江县凤城镇文山北路7号金凤名都9#楼1层7附属间、1层7店面
连江县达兴园食品加工厂	成立日期：2011/9/19	地址：连江县敖江镇青塘村青龙路17号
福建省农春贸易有限公司	成立日期：2011/9/20	地址：连江县晓澳镇晓丰街庆丰路6号晓澳镇人民政府办公楼一楼办公室
连江县苔?镇??盛旺鲍鱼场	成立日期：2011/9/21	地址：连江县苔???村下塘
福建省连江县协富沙石贸易有限公司	成立日期：2011/9/22	地址：连江县?头镇街道开放路新村2#楼701
连江县坑园乡红下村林晨食杂店	成立日期：2011/9/22	地址：连江县坑园镇红下村三叉路63号
福建省连江县芳盛石材设备厂	厂长：林发枝	地址：连江县晓澳镇道沃村旋江路一巷25号
福州好前程投资有限公司	总经理：刘秀姬	地址：连江县凤城镇百凤二区百福路7号一层靠东二间
周口龙兴公路工程有限公司连江分公司	总经理：宋佳	地址：连江县凤城镇文山北路农贸市场花园1#花园A2店
福州嘉元正大贸易有限公司	总经理：孙鹏程	地址：连江县?头镇投资区2#楼1层（福建嘉成高强紧固件有限公司内）
福州市华隆汽车服务有限公司	总经理：刘用华	地址：连江县凤城镇玉山村工业小区104国道边（塑料拉丝厂1-3#楼）
连江县坑园乡红下立赛食杂店	老板：张立赛	地址：连江县坑园镇红下村三叉路65号
福建黄岐湾海洋生物科技股份有限公司	总经理：林哲龙	地址：福州市连江县筱埕镇官坞村连黄公路北侧官坞村村委会办公楼第五层
福州市连江县榕鑫水产养殖场	联系人：陈祯	地址：连江县安凯乡奇达村里澳路18号
连江县天达服装有限公司	总经理：谢祖义	地址：连江县长龙镇长龙村新华路14号原塑料厂厂房
连江县下宫乡江湾村琅湾水产养殖场	联系人：许财宝	地址：连江县下宫乡江湾村鲍鱼海区第2区
连江县透堡镇鑫晟果蔬种植专业合作社	联系人：陈久务	地址：连江县透堡镇馆读村门前埕3弄2号
福建省连江县富裕鲍鱼育苗场	联系人：陈裕彬	地址：连江县苔?镇??村海滨路66号（养殖场所另设）
连江县闽海江南石化有限公司	总经理：杨榕敏	地址：连江县江南乡南塘村（国道104线2291公里150米）
福建省连江天都实业有限公司黄岐第二分公司	总经理：林锦荣	地址：连江县黄岐镇海新街海滨路81-83号店
连江县合众房地产开发有限公司	总经理：林忠科	地址：连江县?头镇拱屿村梅屿新村16号
连江县贤都装潢设计服务部	老板：吴银	地址：连江县凤城镇文山路龙华花园17号楼1-2号店
连江县吴氏鲍鱼养殖专业合作社	联系人：吴晓峥	地址：连江县凤城镇文山北路6号龙华花园17#楼1层9店面
连江县新力担保有限公司	总经理：庄庚	地址：连江县凤城镇东北街816东路50号
连江县凤城镇阳光形象设计沙龙	联系人：林东兴	地址：连江县凤城镇北门816北路1#楼（北岳大厦）2层
福建正友电气设备有限公司	总经理：余昌敬	地址：连江县敖江镇幕浦村南门三排36号
福州鼎冠贸易有限公司	总经理：魏成辉	地址：连江县凤城镇文山北路6号龙华花园1#1单元3号店
福建省春朝农林开发有限公司	总经理：邱镇武	地址：连江县江南乡己古村南垅山（104国道向梅洋村的方向约1.5公里）
福建省茂宏建设工程有限公司	总经理：吴清仁	地址：连江县凤城镇西南街玉荷西路1#楼606房
福州大丰钢化玻璃有限公司	总经理：陈开辉	地址：连江县东湖镇人民政府办公楼内四楼
连江县安凯乡建春水产养殖场	联系人：杨建春	地址：连江县安凯乡沙澳村沙澳路13号
福建省连江县铭旺养殖有限公司	总经理：林览	地址：连江县凤城镇104国道西侧玉泉小区B#7号店
连江宏铭金属制品有限公司	总经理：李子棠	地址：连江县?头投资区福州兴荣机械有限公司A座厂房
连江县新海岸养殖专业合作社	联系人：张由镇	地址：连江县浦口镇中麻村外澳333号（生产场所另设）
连江县下宫乡江荣鲍鱼养殖场	联系人：许在荣	地址：连江县下宫乡江湾村当街33号
连江县福禄家具城	联系人：严剑林	地址：连江县敖江镇104国道西侧敖江投资区1#
连江县凤城镇新海岸酒楼	联系人：陈能贤	地址：连江县凤城镇丹凤花园13#楼1号店
连江县鑫华贸易商行	联系人：吴家兴	地址：连江县凤城镇莲荷东路32#楼1-4店面
福建祥兴房地产开发有限公司	总经理：郑寿兴	地址：连江县凤城镇莲荷西路（原北新新村1#楼）3#楼301房
连江县年年大丰收鱼庄	联系人：林惠富	地址：连江县凤城镇龙华花园28号楼7-9号店面
连江县?头镇梅屿酒楼	联系人：张培华	地址：连江县?头镇华星花园4号楼
福建省连江县当来建筑工程有限公司	总经理：郑真珠	地址：连江县?头镇秦川村（玉华山自然生态农业试验场）
连江县黄岐镇鸿德水泥砖厂	厂长：穆支好	地址：连江县黄岐镇海新街赤才路羊仔栏山
连江县透堡镇兴发果树蔬菜专业合作社	联系人：郑启用	地址：连江县透堡镇塘里村塘北路1号1户
连江县月星雨衣厂	厂长：林乐星	地址：连江县晓澳镇长沙村工业小区西区
连江县生源水产开发有限公司	总经理：许	地址：连江县坑园镇下屿村建胜路6-2号
福州旭升置业有限公司	总经理：庄	地址：连江县浦口镇浦口街旗新路212号
连江县东湖镇西庄村六和苗木场专业合作社	联系人：张	地址：连江县东湖镇西庄村长通西路29号
连江县阿玛尼海峡音乐歌城	联系人：栾	地址：连江县莲荷西路北岳大厦3-4层
福州百详物业管理有限公司连江分公司	总经理：包晓红	地址：连江县江南乡南江滨1号华庆花园1号楼二层
福建省?头建筑工程有限公司可门港分公司	总经理：王文松	地址：连江县坑园镇红下村坂前路12号
福建省连江县一见红酒业有限公司	总经理：李承宝	地址：连江县晓澳镇福兴北路19号
福建省龙鑫建设工程有限公司连江分公司	总经理：郑琳	地址：连江县凤城镇北岳村西渠路8号
连江县兴和贸易有限公司	总经理：占春飞	地址：连江县敖江投资区上高路北侧山山创业区
福建省连江县兴城出租车运输有限公司	总经理：林木增	地址：连江县凤城镇丹凤东路14号绿茵花园3#楼2号店
连江县供销再生资源有限公司山岗回收点	联系人：王岩松	地址：连江县东湖镇山岗（原耐火砖厂内）
连江县供销再生资源有限公司玉山回收点	联系人：谢和金	地址：连江县凤城镇玉山村竹木市场边
连江县供销再生资源有限公司瑞丰回收点	联系人：许妹妹	地址：连江县透堡镇长马公路边（原瑞丰木浆造纸厂）
连江县供销再生资源有限公司透堡三叉口回收点	联系人：陈为武	地址：连江县透堡镇尖墩三叉路发顺花圃场内
连江县供销再生资源有限公司透堡南街回收点	联系人：陈道敏	地址：连江县透堡镇透堡中学对面
连江县供销再生资源有限公司魁岐回收点	联系人：杜鸿桂	地址：连江县江南乡魁岐村（供电所对面）
福建省连江县博胜船舶货物代理有限责任公司	总经理：李友兴	地址：连江县?头镇冠海城20栋303室
连江县盛威砂石有限责任公司	总经理：孙仁连	地址：连江县凤城镇丹凤东路2号丹凤广场1#B座楼701
福州凯平船业有限公司	总经理：陈宗生	地址：连江县苔?镇?邦村浮东里工业园区
福建省连江县永禾农业开发有限公司	总经理：陈建阳	地址：连江县凤城镇凤园街凤尾花园14#505
连江县鑫源石材厂	厂长：林朝义	地址：连江县东岱镇湖里村兴村路116号
连江县福顺汽车租赁有限公司	总经理：黄唐华	地址：连江县凤城镇玉山小区104国道西侧1#楼107单元
连江县名桂园酒楼	联系人：林柏华	地址：连江县凤城镇莲荷东路21号B座
福建省龙宾房地产开发有限公司	总经理：陈天彬	地址：连江县凤城镇文笔路6号（凤翔现代城销售部二楼）
中国人民财产保险股份有限公司连江支公司凤城营销服务部	老板：孙	地址：连江县凤城镇玉山村工业小区104国道边拉丝厂1#105、106店
连江县余胜农业种植专业合作社	联系人：余	地址：连江县东岱镇湖里村沃中101号
连江县筱埕镇荣辉水产养殖专业合作社	联系人：林	地址：连江县筱埕镇官坞村旭升东路144号
连江县凤城镇永帆烟酒商行	联系人：郑	地址：连江县凤城镇丹凤东路绿茵花园4号楼10店
连江县东岱镇桥头砂场	联系人：陈	地址：连江县东岱镇洪塘村岐下
福州万联贸易有限公司	总经理：雷	地址：连江县凤城镇江滨路19号傲江景城C3#楼18店面
福州峻岭东边生态旅游开发有限公司	总经理：杨	地址：连江县?头镇拱屿村104国道东侧鑫隆花园B座803号
福州大明居物业管理有限公司	总经理：张	地址：连江县?头镇塘头新村1#楼605房
福州创誉商贸有限公司	总经理：李	地址：连江县?头镇开放西路2号1幢803室
福建省连江县绿洲新型建材有限公司	总经理：林	地址：福建省连江县江南乡镜路村镜路路12号
福建冠豪置业有限公司	总经理：王昆国	地址：连江县文山北路6号龙华花园3#楼
福建省连江县中山织造厂	null	地址：福建省福州市连江县敖江镇浦下村
福建省连江县志华贸易开发有限公司	null	地址：福建省福州市连江县凤城镇凤尾花园北区３号楼５０１房
福建省连江县云峰石材制品厂	null	地址：福建省福州市连江县敖江镇南塘鹅罗坑
福建省连江县远洋鱼业有限公司	总经理：张伙利	地址：福建省福州市连江县台录镇北交村
福建省连江县源盛矿业集团有限公司	null	地址：福建省福州市连江县蓼沿乡
福建省连江县元盛贸易公司	null	地址：福建省福州市连江县凤城镇八一六北路１６３号
福建省连江县裕华水产贸易有限公司	总经理：陈裕华	地址：福建省福州市连江县苔录镇秀邦村
福建省连江县玉鑫养殖有限公司	null	地址：福建省福州市连江县潘渡乡坡西村
福建省连江县与头水产综合养殖场	null	地址：福建省福州市连江县坑园乡与头村
福建省连江县油运石化贸易有限公司	null	地址：福建省福州市连江县凤城镇玉荷西路1号
福建省连江县永华建材有限公司	总经理：陈兆在	地址：福建省福州市连江县凤城镇莲荷东路白沙桥２号楼２０４房
福建省连江县永丰贸易有限公司	总经理：邱	地址：福建省福州市连江县凤城镇凤园街莲荷东路６号楼第十三店１８－６
福建省连江县易鑫摩托车贸易有限公司	null	地址：福建省福州市连江县城关玉荷西路７号楼A幢西２间
福建省连江县洋西花岗岩安装设备厂	厂长：郑永钦	地址：福建省福州市连江县东岱洋西
福建省连江县颜岐水产品经营部	null	地址：福建省福州市连江县坑园乡颜岐村
福建省连江县烟草公司金叶经理部	null	地址：福建省福州市连江县凤城八一六中路３８号
福建省连江县秀邦进富酱奇厂	null	地址：福建省福州市连江县台录镇秀邦村
福建省连江县雄峰贸易有限公司	null	地址：福建省福州市连江县筱埕镇筱埕街文明路１４７号
福建省连江县雄风海珍品养殖有限公司	null	地址：福建省福州市连江县凤城镇莲荷东路５号楼４０１＃
福建省连江县雄晨工业气有限公司	null	地址：福建省福州市连江县凤城镇莲荷路１３４号
福建省连江县兴业水产综合场	null	地址：福建省福州市连江县坑园乡下与村
福建省连江县兴顺水产加工厂	厂长：江铭福	地址：福建省福州市连江县筱埕镇逻回村
福建省连江县兴隆塑胶制品厂	厂长：梁训倍	地址：福建省福州市连江县晓沃镇长沙村
福建省连江县兴海渔需油料有限公司	null	地址：福建省福州市连江县黄岐镇柯泥湾
福建省连江县兴达石材开发有限公司	null	地址：福建省福州市连江县蓼沿乡秦南岗
福建省连江县信昌贸易有限公司	null	地址：福建省福州市连江县凤城玉荷东路７８号
福建省连江县新兴塑胶制品厂	厂长：林孝国	地址：福建省福州市连江县晓沃镇长沙村
福建省连江县新纪元经贸开发有限公司	总经理：林金平	地址：福建省福州市连江县敖江镇白沙村
福建省连江县新辉物资贸易有限公司	null	地址：福建省福州市连江县厦宫新辉
福建省连江县新都贸易有限公司五交化商场	null	地址：福建省福州市连江县凤城镇玉荷西路４号
福建省连江县筱埕围海造地工程指挥部	老板：谢永光	地址：福建省福州市连江县筱埕镇
福建省连江县筱埕海味贸易经营部	null	地址：福建省福州市连江县筱埕镇泰山路
福建省连江县筱埕海味经营部	null	地址：福建省福州市连江县筱埕镇泰山路
福建省连江县筱埕供销合作社定海煤场	null	地址：福建省福州市连江县筱埕镇定海村
福建省连江县晓沃镇水利水电工作站	站长：梁祖举	地址：福建省福州市连江县晓沃镇新区市场头
福建省连江县晓沃晓峰船具用品店	null	地址：福建省福州市连江县晓沃镇晓峰街大园路７０号
福建省连江县晓沃琼脂厂	null	地址：福建省福州市连江县晓沃镇晓兴街
福建省连江县晓沃企业经营部	null	地址：福建省福州市连江县晓沃镇政府大楼
福建省连江县晓沃企业供销公司	总经理：邱国瑞	地址：福建省福州市连江县晓沃镇福兴北路
福建省连江县晓沃花岗岩制品装配公司	总经理：邱吉康	地址：福建省福州市连江县晓沃镇晓丰街
福建省连江县晓沃道沃水产贸易货栈	null	地址：福建省福州市连江县晓沃镇道沃村
福建省连江县晓江水产加工厂	null	地址：福建省福州市连江县晓沃镇晓江振江路６６号
福建省连江县晓澳名特优林果场	联系人：占文星	地址：福建省福州市连江县晓澳镇赤湾村
福建省连江县小沧石材制品厂	厂长：兰伙瑞	地址：福建省福州市连江县小沧乡东风村
福建省连江县翔龙农业工程有限公司	null	地址：福建省福州市连江县凤城镇莲荷东路１９＃１０６房
福建省连江县乡镇企业开发公司	总经理：林伯佃	地址：福建省福州市连江县凤城镇八一六北路１１６号
福建省连江县现代装修工程公司	null	地址：福建省福州市连江县凤城镇玉荷东路１号楼１０２房
福建省连江县厦宫岩松海产品加工厂	null	地址：福建省福州市连江县厦宫乡江湾村
福建省连江县厦宫海运公司	null	地址：福建省福州市连江县厦宫乡政府
福建省连江县厦宫海味品经营部	null	地址：福建省福州市连江县厦宫村
福建省连江县下屿海珍品养殖加工场	null	地址：福建省福州市连江县坑园乡下屿村
福建省连江县下宫乡上宫洋水产综合场	null	地址：福建省福州市连江县下宫乡上宫洋
福建省连江县下宫乡民政办公室	null	地址：福建省福州市连江县下宫乡下宫村
福建省连江县下宫厦乙农副产品经营部	null	地址：福建省福州市连江县下宫厦乙村
福建省连江县下宫松皋水产综合场	null	地址：福建省福州市连江县下宫乡松皋村
福建省连江县下宫水产综合场	null	地址：福建省福州市连江县下宫乡下宫村
福建省连江县下宫水产加工厂	null	地址：福建省福州市连江县下宫乡下宫村
福建省连江县下宫海味加工厂	厂长：黄太暖	地址：福建省福州市连江县厦宫乡下宫村
福建省连江县下宫海产品开发部	null	地址：福建省福州市连江县下宫村
福建省连江县西溪林果场	联系人：林建永	地址：福建省福州市连江县江南乡
福建省连江县物资化轻公司	null	地址：福建省福州市连江县凤城镇八一六北路９７号
福建省连江县五金电器机械厂	null	地址：福建省福州市连江县凤城镇八一六北路４８号
福建省连江县卫生制品厂	null	地址：福建省福州市连江县凤城玉山县纺织厂内
福建省连江县万事达水产渔需有限公司	null	地址：福建省福州市连江县凤城镇玉荷西路２７８号
福建省连江县土产日杂公司日用品经济部	null	地址：福建省福州市连江县凤城镇北门路
福建省连江县透堡镇老区柑桔场	联系人：郑启用	地址：福建省福州市连江县透堡镇财岭
福建省连江县透堡翠竹精制厂	null	地址：福建省福州市连江县透堡镇公路边
福建省连江县通用花岗岩制品有限公司	总经理：林柏通	地址：福建省福州市连江县凤城镇八一六北路敖建三层
福建省连江县糖酒副食品公司文明路综合批发部	老板：郑发强	地址：福建省福州市连江县凤城镇文明路14号
福建省连江县苔录兴旺烘干厂	厂长：邹依寿	地址：福建省福州市连江县苔录镇苔录村
福建省连江县苔录凯旋养育场	null	地址：福建省福州市连江县苔录镇后湾村
福建省连江县台录天海经贸公司	null	地址：福建省福州市连江县台录镇交南村宏图路５６号
福建省连江县税务局	null	地址：福建省福州市连江县凤城镇八一六北路１１号
福建省连江县水珍品开发公司	null	地址：福建省福州市连江县浦口镇柘尾村
福建省连江县水产综合场逻回海产品加工厂	null	地址：福建省福州市连江县筱埕镇逻回村
福建省连江县树德公交公司	null	地址：福建省福州市连江县城关丹凤西路
福建省连江县市场服务中心	null	地址：福建省福州市连江县凤城集贸市场
福建省连江县盛达水产品有限公司	null	地址：福建省福州市连江县苔录镇苔录村
福建省连江县盛达电子教材设备厂	厂长：李德彬	地址：福建省福州市连江县凤城凤园路１５０号
福建省连江县圣灵鳗业有限公司	null	地址：福建省福州市连江县蓼沿乡溪东村
福建省连江县升洋水产加工厂	厂长：颜开仁	地址：福建省福州市连江县筱埕镇定海村长沃
福建省连江县上宫盛业鱼禽钙粉厂	null	地址：福建省福州市连江县下宫乡上宫村
福建省连江县山仔水利枢纽开发公司	总经理：曾永	地址：福建省福州市连江县凤城镇西渠路３９号
福建省连江县山堂石制品厂	null	地址：福建省福州市连江县东岱镇山堂村
福建省连江县山岗交通运输联合检查站	null	地址：福建省福州市连江县东湖镇山岗
福建省连江县三友宏业鱼品厂	null	地址：福建省福州市连江县苔录镇秀邦村
福建省连江县三城商贸有限公司	总经理：邱同安然无恙	地址：福建省福州市连江县八一六北路北岳大厦
福建省连江县奇达海味供应站	null	地址：福建省福州市连江县安凯乡奇达村
福建省连江县七彩珍禽发展有限公司	null	地址：福建省福州市连江县坑园乡
福建省连江县浦口镇农械厂	null	地址：福建省福州市连江县浦口镇浦口街浦西路１１７号
福建省连江县浦口上浦电信厂	null	地址：福建省福州市连江县浦口镇上浦２６５号
福建省连江县浦东木材加工厂	null	地址：福建省福州市连江县浦口镇外厝尾
福建省连江县潘渡乡溪利腊石矿	null	地址：福建省福州市连江县潘渡乡溪利
福建省连江县潘渡粮食管理站	null	地址：福建省福州市连江县潘渡乡
福建省连江县农业机械管理站	站长：魏景威	地址：福建省福州市连江县凤城镇八一六北路政府大楼
福建省连江县农业办公室	联系人：陈金乐	地址：福建省福州市连江县凤城镇八一六北路８１号政府大楼
福建省连江县农垦服务公司	null	地址：福建省福州市连江县丹阳镇朱山
福建省连江县南沿石材制品厂	厂长：曾不金	地址：福建省福州市连江县蓼沿乡蓼沿村秦南岗
福建省连江县南方石材制品厂	厂长：林春	地址：福建省福州市连江县敖江镇工业小区
福建省连江县闽山养殖有限公司	null	地址：福建省福州市连江县浦口镇柘尾村
连江县文艺演出管理站	null	地址：福建省福州市连江县凤城镇展览馆内
连江县退休职工管理委员会	null	地址：福建省福州市连江县总工会
连江县退休干部管理办公室	联系人：林土	地址：福建省福州市连江县凤城镇八一六北路政府大楼
连江县土木建筑学会	null	地址：福建省福州市连江县建设局
连江县土地监察队	队长：谢碧芳	地址：福建省福州市连江县凤尾花园凤园路30号
连江县土地管理局小沧土地所	null	地址：福建省福州市连江县小沧乡
连江县土地管理局下宫土地所	null	地址：福建省福州市连江县下宫乡
连江县土地管理局苔录土地所	null	地址：福建省福州市连江县苔录镇
连江县土地管理局东湖土地所	null	地址：福建省福州市连江县东湖镇
连江县土地发展中心	联系人：吴永强	地址：凤城镇凤园路３６号连江县国土资源局
连江县透堡镇企业管理站	站长：杨忠福	地址：福建省福州市连江县透堡镇人民政府大院内
连江县透堡镇企业办公室	null	地址：福建省福州市连江县透堡镇
连江县透堡镇南北塘果场	null	地址：福建省福州市连江县透堡乡财岭
连江县透堡镇民政办公室	null	地址：福建省福州市连江县透堡镇政府
连江县透堡镇龙头村经济合作社	null	地址：福建省福州市连江县透堡镇龙头村
连江县透堡镇尖墩村经济合作社	null	地址：福建省福州市连江县透堡镇尖墩村
连江县体育埔导中心	null	地址：福建省福州市连江县凤城镇西北街县陈第公园内
连江县苔录镇后湾村经济合作社	null	地址：福建省福州市连江县苔录镇后湾村
连江县苔录秀邦盛兴鱼品厂	null	地址：福建省福州市连江县苔录镇秀邦村
连江县苔录茭南水产品精制烘干厂	厂长：林文弟	地址：福建省福州市连江县苔录镇茭南村发展路１２号
连江县苔录村经济合作社	联系人：姚朝宾	地址：福建省福州市连江县苔录镇苔录村
连江县苔录北茭路徽海产品加工厂	null	地址：福建省福州市连江县苔录镇北茭村
连江县私立思远学校	校长：陈华泉	地址：连江县安凯乡
连江县私立明智学校	null	地址：福建省福州市连江县苔录镇北交村
连江县税务局文山税务检查站	null	地址：福建省福州市连江县坑园乡江厦村
连江县税务局城关分局	null	地址：福建省福州市连江县凤城镇八一六北路１４２号
连江县水政水资源管理站	null	地址：福建省福州市连江县凤城镇文明路１７号
连江县水利水电工程综合服务部	老板：黄国标	地址：福建省福州市连江县凤城镇文明路３５号
连江县水利电力设计院	院长：陈汉生	地址：福建省福州市连江县凤城镇新文明路３７号
连江县水产品购销站	null	地址：福建省福州市连江县安凯乡安海村
连江县蔬菜基地服务站	null	地址：福建省福州市连江县农业局
连江县牲畜定点屠宰办公室	联系人：林辉	地址：福建省福州市连江县政府四楼
连江县社会治安综合治理委员会办公室	联系人：游开东	地址：福建省福州市连江县城关八一六北路县委大院
连江县上坂柑桔场	联系人：张长思	地址：福建省福州市连江县江南乡横槎村
连江县三胞妇女联谊会	联系人：王少霞	地址：福建省福州市连江县妇联会
连江县日用品厂	厂长：吴兆铨	地址：福建省福州市连江县凤城镇八一六西路13号
广东康力医药连锁有限公司连江莲荷东分店	老板：游何风	地址：连江县凤城镇莲荷东路６号楼１０５房
福州松乌龙眼示范场	null	地址：福建省福州市连江县农业局
福州怡丽农牧开发有限公司	null	地址：福建省福州市连江县丹阳镇朱山村
福州新山水科技农业有限公司	null	地址：中国 福建 福州市 福州市连江县玉荷东路三号台资大楼２Ａ－３Ａ
福州信福塑胶雨具有限公司	总经理：彭文信	地址：福建省福州市连江县晓沃镇百胜村　　　　法定代表人：彭文信
福州贤汇贸易有限公司连江公司	null	地址：福建省福州市连江县凤城镇莲荷西路１２号
福州先锋晋发电器工程有限公司连江分公司	总经理：刘文成	地址：福建省福州市连江县凤城镇玉荷西路３９７号
福州新邦畜牧业有限公司	总经理：杨声祥	地址：福建省福州市连江县东湖镇西庄村　　　　法定代表人：杨声祥
福州田丰水产开发有限公司	null	地址：福建省福州市连江县黄岐镇港务码头边
福州泰威克科贸有限公司连江经销处	null	地址：福建省福州市连江县凤城镇供销新村２号楼５０２室
江西汇仁营销有限公司连江分公司	总经理：陈涛	地址：福建省福州市连江县凤城金星大厦Ｃ座５０７室
卢飞食杂店	null	地址：福建省福州市连江县凤城停车场
明秀食杂店	null	地址：福建省福州市连江县北门集贸市场
闽凤大埕海带养殖场	联系人：王依嫩	地址：福建省福州市连江县筱埕镇大埕村
和兴食杂店	null	地址：福建省福州市连江县八一六北路９８号
《福州日报》连江发行站	站长：林漉	地址：福建省福州市连江县公路局五楼
连江县溪利水电开发有限公司	总经理：杨奇	地址：福建省连江县潘渡乡溪利村
连江县众源砂石有限责任公司	总经理：黄振杰	地址：福建省连江县凤城镇莲荷西路康耀公寓３＃１１店
连江县教育发展促进会	联系人：黄齐秋	地址：福建省福州市连江县凤城镇玉荷西路２１号
连江县黄岐镇兴建船舶管理服务站	站长：郑尚照	地址：福建省连江县黄岐镇大建村委会办公楼３层
连江县蓼沿乡兴隆能源加工厂	厂长：许国勇	地址：连江县首占村楚博农业科技开发有限公司内
连江县海鑫机电有限公司	总经理：林小玲	地址：连江县经济开发区?头园区
连江县磊盛石材有限公司	总经理：雷木伙	地址：连江县蓼沿乡林场村岭头坪
连江县雅柔服装店	老板：叶巧娟	地址：连江县凤城镇西北街北门路49号
连江县丹阳镇伙娇加油店	老板：周伙娇	地址：福州市连江县丹阳镇公路边县道丹西线200米
连江县顺顺机动车安全检测有限公司	总经理：曾文芳	地址：福建省连江县凤城镇莲荷东路１８－３９号３９幢６０７单元
连江县蓼沿仙峰水厂	厂长：陈新水	地址：福建省连江县蓼沿乡仙屏村
连江县景利现代农业示范基地	联系人：陈木雄	地址：福建省福州市连江县?头镇拱屿村?路旁
连江县晓澳镇村务工作促进会	联系人：邱吉发	地址：福建省福州市连江县晓澳镇自来水有限公司二层办公楼
连江县宏丰纸品有限公司	总经理：程平强	地址：福建省福州市连江县东湖镇祠台村（宏飞造纸厂内）
连江县可门港乐逍遥娱乐中心	联系人：肖良锦	地址：连江县坑园镇颜岐村大兴东路可门港宾馆一至三层
连江县丹阳镇国川沙石场	联系人：陈树立	地址：连江县丹阳镇东平村
连江县蓝色海洋科技发展有限公司	总经理：郑德莺	地址：福建省福州市连江县坑园镇下屿村
连江县艺林演出经纪有限公司	总经理：周木兴	地址：福建省福州市连江县?头镇和平路４５号宏源新苑１＃楼７号
连江县伟鑫水产加工有限公司	总经理：孙本伟	地址：连江县东岱镇北门工业区
连江县海源水产有限公司	总经理：林加明	地址：福建省连江县筱埕镇大埕村北平路
连江县兴达汽车培训有限公司	总经理：李章皋	地址：福建省福州市连江县敖江镇小湾村
连江县三国友高科建材装璜有限公司	总经理：金国财	地址：福建省连江县?头镇（３６Ｍ大道边侧）三友楼一层
连江县苔?镇聚福骨灰楼	联系人：郑尚樵	地址：福建省福州市连江县苔?镇后湾半山顶
连江皇家精博幼稚园	联系人：林秀钦	地址：福建省福州市连江县凤城镇丹凤花园台２７号楼
连江县马鼻供销合作社综合一部	老板：陈建敦	地址：连江县马鼻镇横厝街19号
福建海天外贸实业有限公司	总经理：王小天	地址：福建省连江县福建省福州市连江
连江县家富富侨养生会所	所长：林耿铭	地址：福建省连江县凤城镇816路48号(巨林商厦)二层
连江县安凯海港充氧站	站长：林道勋	地址：连江县安凯乡高塘村沙坂马尾港西侧
连江县青芝山橄榄厂	厂长：李依珠	地址：福建省福州市连江县?头镇上坪村连港路８号
连江县连合水产有限公司	总经理：刘文献	地址：连江县苔?镇茭南面（镇政府旁）
连江县瑞峰电子科技发展有限公司	总经理：陈丽芳	地址：福建省福州市连江县玉荷东路８１６北路交叉路口安盛大厦永福大酒店一楼
连江县瑞丰石材厂（普通合伙）	联系人：汤水官	地址：连江县蓼沿乡赤南岗工业区
连江县新宏东船舶服务有限公司	总经理：滕美珍	地址：福建省连江县敖江开发区１０４国道西侧青塘口（福州宏利食品有限公司内）
连江县宏鑫石业有限公司	总经理：丁金嫩	地址：连江县蓼沿乡林场村
连江县下宫恒盛泡沫厂	厂长：黄太暖	地址：连江县下宫乡下宫村彭铁头湾
连江县丹阳镇福康棕床垫加工厂	厂长：郑东升	地址：福建省连江县丹阳镇朱山村(丹阳粮站朱山粮点)
连江县得利商贸有限公司	总经理：马其康	地址：福建省福州市连江县凤城镇８１６西路１号金凤西城二层商场
连江县宇翔电气成套设备有限公司	总经理：余孝良	地址：福建省福州市连江县凤城镇丹凤东路１５号丹凤花园１９－２１＃楼１层３号店
连江县台海高新农业有限公司	总经理：颜嘉宇	地址：福建省连江县坑园镇红下村三叉路１号
连江县黄岐好想唱KTV	联系人：邹丽玉	地址：连江县黄岐镇新城海滨路西侧
连江县海旺水产品经营部	老板：吴增官	地址：连江县凤城镇丹凤东路15号丹凤花园39#楼11店面
连江县信和废品收购站	站长：颜台木臭	地址：连江县坑园镇颜岐村埭头原灰厂厂址
福建伊莱特灯具制造有限公司	总经理：贾冬巍	地址：福建省连江县经济开发区管委会（办公楼）三楼
福建海晟连锁营销发展有限公司连江文山店	老板：张晋闽	地址：福建省福州市连江县凤城镇莲荷东路１８＃Ｂ座
福州市连江县苔录镇秀邦造船厂	厂长：陈宗生	地址：福建省福州市连江县苔录镇白沙湾
福建高龙海洋生物工程有限公司	总经理：黄进	地址：连江县晓澳镇水产品加工基地
福建省连江县盛达石材有限责任公司	总经理：陈传新	地址：连江县晓沃镇晓江街和平路399号
福建省连江县天兴茶叶分装厂	厂长：谢承耀	地址：连江县凤城镇816北路新车站对面
福建省连江县安凯海水养殖场	联系人：杨昌光	地址：福建省福州市连江县安凯乡沙沃路１６号
福建省连江县道沃文蛤养殖场	联系人：林澄坚	地址：福建省福州市连江县晓沃镇道沃村
福建省连江县苔录秀邦海洋捕捞第一联合社	null	地址：福建省福州市连江县苔录镇秀邦村
福建省连江县苔录北茭海洋渔业联合社	null	地址：福建省福州市连江县苔录乡北茭村
福建省连江县丹阳茂祥茶厂	厂长：林秀灯	地址：福建省福州市连江县丹阳镇虎山村
福建省连江县北茭捕捞渔业有限公司	null	地址：福建省福州市连江县苔录镇北茭村
福建省连江水产远洋渔业有限公司	null	地址：福建省福州市连江县凤城镇新民路１４号
福建省连江富鑫鲍鱼养殖有限公司	总经理：张其富	地址：福建省福州市连江县黄岐镇海建街
福建省连江县苔录海洋渔业第一联合社	null	地址：福建省福州市连江县苔录镇苔录村
福建省连江县北茭海洋渔业有限公司	null	地址：福建省福州市连江县苔录镇北茭村牛埠９３号
连江县浦东农场	联系人：陈如强	地址：福建省福州市连江县浦口书坪山
福建省连江县农垦茶厂	null	地址：福建省福州市连江县丹阳镇朱山
福建省连江县华毅远洋渔业有限公司	总经理：陈沂	地址：福建省福州市连江县凤城镇凤园街凤田巷６３号
中国人民解放军３２３６０部队农场场部	null	地址：福建省福州市连江县宫坂镇
中国人民解放军３２３６０部队农场	null	地址：福建省福州市连江县宫坂镇
福建连江健生鲍鱼养殖有限公司	总经理：陈长钊	地址：福建省福州市连江县苔录镇后湾村
连江县坑园下与海水养殖场	null	地址：福建省福州市连江县坑园乡下与村
福建省连江县浦口淡水养鳗场	null	地址：福建省福州市连江县浦口镇柘尾村
福建省连江县福江养鳗场水产养殖咨询服务部	null	地址：福建省福州市连江县敖江镇己古村
福建省连江县道沃海水养殖场	联系人：林培宏	地址：福建省福州市连江县晓沃镇道沃村
福建省连江县颜岐海水养殖场	null	地址：福建省福州市连江县坑园乡颜岐村
福建省连江县恒兴淡海水养殖有限公司	总经理：曾政 铁	地址：福建省福州市连江县坑园乡
连江县坑园下屿海水养殖场	联系人：蔡诗棠	地址：福建省福州市连江县坑园乡下屿村
福建省连江县浦口富民养鳗场	null	地址：福建省福州市连江县浦口镇益砌村
凤城宏华家具店	null	地址：福建省福州市连江县凤城莲荷西路北侧壹店
凤城光明家具店	null	地址：福建省福州市连江县凤城八一六北路１５４号
凤城庆锋家具店	null	地址：福建省福州市连江县凤城镇八一六北路８号
凤城豪美家具店	null	地址：福建省福州市连江县八一六东路２１号
凤城华春家具店	null	地址：福建省福州市连江县城关旧汽车站门市部
凤城美惠家具店	null	地址：福建省福州市连江县莲荷西路新村第３间
连江县凤城通讯器材经营部	null	地址：福建省福州市连江县凤城镇莲荷东路５号楼
凤城万福家具店	null	地址：福建省福州市连江县莲荷西路４５号楼３号店
敖江庄武家俱店	null	地址：福建省福州市连江县城关北路１３９号
连江县凤城恒昌旧货物资贸易商行	联系人：吴显通	地址：福建省福州市连江县莲荷东路8#楼101#102#
凤城秀平现代家具店	null	地址：福建省福州市连江县凤城八一六西路２１号
连江凤城光达通讯器材经营部	null	地址：福建省福州市连江县凤城广播大楼楼下
凤城豪华家具店	null	地址：福建省福州市连江县凤城旧百货二楼
凤城顺金五交商店	null	地址：福建省福州市连江县交通大楼商店
凤城玉荷燃气炉具商店	null	地址：福建省福州市连江县凤城玉荷西路６号楼
凤城志洪鞋帽商店	null	地址：福建省福州市连江县汽车站门市部
凤城为洲音乐商店	null	地址：福建省福州市连江县玉荷西路一号楼１２间店面
凤城玉荷针织品商店	null	地址：福建省福州市连江县凤城玉荷东路１７号
连江县凤城新潮一族音像商店	null	地址：福建省福州市连江县凤城玉荷东路１号楼第一间
凤城飞燕时装商店	null	地址：福建省福州市连江县凤城玉荷西路３号楼门市部
连江县凤城秀玲百货商店	null	地址：福建省福州市连江县凤城镇八一六北路８号
凤城乐新音响商店	null	地址：福建省福州市连江县凤城玉荷西路５号楼
凤城星星百货店	null	地址：福建省福州市连江县凤城八一六北路５８号
连江县凤城河乾家具店	null	地址：福建省福州市连江县凤城河乾储蓄所门市部
凤城永凤小五金商店	null	地址：福建省福州市连江县凤城镇八一六南路６号
凤城鑫鑫五金水暖店	null	地址：福建省福州市连江县车站东门口７号
凤城半街五金经营部	null	地址：福建省福州市连江县凤城镇八一六北路１９号
凤城冬金五金商店	null	地址：福建省福州市连江县新车站第１７号店面
丽丽百货店	null	地址：福建省福州市连江县八一六北路７９号
凤城福星五金店	null	地址：福建省福州市连江县凤城镇八一六北路８１６号
连江县下宫乡鹏鸿水产经营部	老板：姚朝水350122	地址：连江县下宫乡厦乙村团结路过２７号
福建省连江县晓沃镇水产经销部	老板：陈延明	地址：福建省福州市连江县晓沃镇晓丰街大园路１号
福建省连江县东岱山堂水产经营部	null	地址：福建省福州市连江县东岱镇山堂村
福建省连江县逻回水产经营部	null	地址：福建省福州市连江县筱埕逻回村
福建省连江县坑园颜岐水产站	null	地址：福建省福州市连江县坑园乡颜岐村
凤城翠玉五金店	null	地址：福建省福州市连江县连江县新车站
连江县百胜水产经营部	null	地址：福建省福州市连江县晓沃镇百胜村
凤城通亨五金店	null	地址：福建省福州市连江县凤城八一六北路（新车站对面）
凤城承奖小五金店	null	地址：福建省福州市连江县凤城新市场门口
凤城永兴五金店	null	地址：福建省福州市连江县凤城镇北门市场对面
连江县凤城巨强五金汽配商店	null	地址：福建省福州市连江县北岳才溪水电站新村楼下
凤城西城粮店	null	地址：福建省福州市连江县玉荷西路１０号楼６店
连江县仙塔五金店	null	地址：福建省福州市连江县北门路
凤城凤莺针织店	null	地址：福建省福州市连江县才溪水电门市部
凤城在云针织品商店	null	地址：福建省福州市连江县凤城玉荷西路２号楼１２间
凤城明芳服装商店	null	地址：福建省福州市连江县第二干部招待所楼下
凤城人人服装店	null	地址：福建省福州市连江县副食品六部
福建省连江县下宫华峰水产经销部	null	地址：福建省福州市连江县下宫乡下宫村
凤城镇凤娟服装店	null	地址：福建省福州市连江县凤城镇玉荷东路２号
凤城星美服装店	null	地址：福建省福州市连江县饮服公司门市部
凤城时新时装店	null	地址：福建省福州市连江县凤城玉荷西路粮油工业公司门市部
凤城家辉服装店	null	地址：福建省福州市连江县玉荷东路２号
凤城惠华服装店	null	地址：福建省福州市连江县凤城玉荷西路２号楼
凤城明凤服装商店	null	地址：福建省福州市连江县新百货大楼门市部
凤城雅豪时装店	null	地址：福建省福州市连江县凤城镇新村
凤城玉荷西路汽车玻璃经营部	null	地址：福建省福州市连江县凤城玉荷西路５号楼４店
连江县凤城凤北五交电器商店	null	地址：福建省福州市连江县凤城八一六北路１４７号
福建省连江县奔达摩托车商行	联系人：陈波	地址：福建省福州市连江县凤城镇莲荷西路电力大楼
连江县浦口远光合作商店	null	地址：福建省福州市连江县浦口镇
福建省连江县马鼻综合商店	null	地址：福建省福州市连江县马鼻镇马鼻街
连江县城关百货合作商店	老板：吴娟皋	地址：福建省福州市连江县凤城镇玉荷西路7号
连江县筱埕饮食合作商店	null	地址：福建省福州市连江县筱埕镇筱埕村大街
连江县糖酒副食品公司第六零售综合商店	null	地址：福建省福州市连江县凤城镇八一六北路７９号
连江县筱埕糕饼合作商店	null	地址：福建省福州市连江县筱埕镇筱埕村大街
敖北榕建汽车配件门市部	null	地址：福建省福州市连江县凤城八一六北路
连江县凤城汽车配件门市部	null	地址：福建省福州市连江县凤城北门外
连江县凤城顺达汽车配件经营部	null	地址：福建省福州市连江县新车站对面
连江县凤城镇盛团通讯器材配件商店	老板：余盛团	地址：福建省福州市连江县凤城八一七北路29号
凤城秀妹日杂商店	null	地址：福建省福州市连江县凤城镇玉荷西路３号楼
凤城达声音响商店	null	地址：福建省福州市连江县玉荷西路河乾新村第１０间
连江县浦口糕饼合作商店	null	地址：福建省福州市连江县浦口街浦东路
连江县糖酒副食品公司酒类经营部	老板：黄敏秀	地址：福建省福州市连江县北岳白洋
连江县恒龙摩托车商行	null	地址：福建省福州市连江县凤城镇八一六北路中医院门口
连江县浦口山百货合作商店	null	地址：福建省福州市连江县浦口街浦东路
凤城捷达综合商店	null	地址：福建省福州市连江县凤城玉荷西路防疫站楼商店
连江县凤城副食品联光合作商店	null	地址：福建省福州市连江县凤城镇集贸市场五号楼
连江县敖江凤梅公路养路班	联系人：刘细弟	地址：福建省福州市连江县江南乡梅洋村
连江县苔录镇后湾闽连运０５６６加油船	联系人：陈国好	地址：福建省福州市连江县苔录镇后湾村
福建省连江县粮食收储公司	总经理：陈世泽	地址：福建省福州市连江县凤城镇８１６西路３号
福建省连江县邮政局	局长：余祥添	地址：福建省福州市连江县凤城镇８１６北路８８号
福建省连江县筱埕建筑工程公司凤城工程处	联系人：郑庆成	地址：福建省福州市连江县凤城镇凤尾花园６４座
福建省连江县黄岐避风港工程建设指挥部	null	地址：福建省福州市连江县黄岐镇政府院内
福建省连江红格装璜工程有限公司	null	地址：福建省福州市连江县金凤酒店
福建省连江县透堡建筑工程公司黄歧分公司	null	地址：福建省福州市连江县黄歧镇政府内
福建省连江县透堡建筑工程公司驻凤工程处	联系人：黄文光	地址：福建省福州市连江县凤城镇莲荷东路６号楼３０５室
福建省连江县敖江南岸供水工程建设指挥部	null	地址：福建省福州市连江县东岱镇政府
闽东永通路港工程有限公司连江办事处	联系人：林孝淑	地址：福建省福州市连江县城关北门路２号
连江县凤城建筑装璜商店	null	地址：福建省福州市连江县凤城镇
凤城长顺建筑装璜材料	null	地址：福建省福州市连江县凤城八一六北路旧车站门市部
凤城北门建筑装璜店	null	地址：福建省福州市连江县凤城北门市场
连江县晓福建筑装璜材料经营部	老板：邱和福	地址：福建省福州市连江县莲荷西路
凤城上明建筑装修商店	null	地址：福建省福州市连江县电视广播局门市部
凤城建新建筑装璜材料经营部	null	地址：福建省福州市连江县凤城镇八一六北路新江综合楼
福建省连江县蓼沿建筑工程公司	null	地址：福建省福州市连江县蓼沿乡政府院内
东湖镇湖东路工程建设指挥部	null	地址：福建省福州市连江县东湖镇政府院内
福建泰坤建设发展有限公司连江分公司	总经理：郭洪志	地址：福建省福州市连江县玉荷西路购物中心１１８号
连江县长龙建筑工程公司苔录分公司	总经理：阮孝星	地址：福建省福州市连江县苔录镇镇政府大院内
福建省连江县晓沃建筑公司驻凤城工程处	null	地址：福建省福州市连江县凤城西渠路１９２号
福建省连江县官头建筑工程公司凤城工程处	null	地址：福建省福州市连江县凤城镇莲荷西路康耀公寓
福建省连江县下宫建筑工程公司	null	地址：福建省福州市连江县下宫乡下宫村
福建省连江县浦口建筑工程公司凤城分公司	总经理：孙长江	地址：福建省福州市连江县凤城镇莲荷东路１号楼南侧附属楼
福建省连江县敖江建筑工程公司建材经营部	null	地址：福建省福州市连江县凤城镇八一六北路才溪水电站新村楼
福建省连江县东湖建筑工程公司	总经理：倪汉新	地址：福建省福州市连江县凤城８１６北路新江楼４０２房
福建省敖江建筑工程公司凤城办事处	联系人：徐贞富	地址：福建省福州市连江县凤城镇８１６北路１１号楼
连江县东岱建筑工程公司凤城工程处	null	地址：福建省福州市连江县凤城镇北门新区文明西路２０号４０
福建省连江县黄岐建筑社	null	地址：福建省福州市连江县黄岐镇
福建省连江县丹阳自来水有限公司	null	地址：福建省福州市连江县丹阳镇新洋村
连江县燃气管理站	站长：陈辉文	地址：福建省福州市连江县文明东路３３号
福建省连江县凤城液化气供应站	站长：王昭鹭	地址：福建省福州市连江县敖江镇小湾村
连江县敖江镇敖北自来水工程指挥部	null	地址：福建省福州市连江县凤城镇经济巷３１号
福建省连江县自来水公司	总经理：邱成光	地址：福建省福州市连江县凤城镇玉荷东路１１２号
福建省连江县塘坂水库电站建设指挥部	老板：俞风云	地址：福建省福州市连江县凤城镇西渠西路３９号
福建省连江百胜供电站	站长：池和峰	地址：福建省福州市连江县晓沃镇百胜村
福建省连江县贵安自来水厂	厂长：李本华	地址：福建省福州市连江县潘渡乡贵安村
福建省连江县地热综合开发公司	null	地址：福建省福州市连江县政府四楼
福建省连江县敖江液化气供应站	站长：魏厥强	地址：福建省福州市连江县敖江镇财溪村
福建省连江县马鼻水电站	站长：苏松华	地址：福建省福州市连江县马鼻镇
福建省连江县马鼻自来水厂	厂长：陈学明	地址：福建省福州市连江县马鼻镇
凤城成合家用电器维修店	null	地址：福建省福州市连江县凤城八一六北路１００号
连江县蓼沿乡电力管理站	null	地址：福建省福州市连江县蓼沿乡横街路１９号
电器钟表维修店	null	地址：福建省福州市连江县丹阳镇新街
连江县城关理发社	null	地址：福建省福州市连江县城关八一六北路５７号
连江县凤城天姿婚纱影楼	null	地址：福建省福州市连江县北路新江楼２６号
连江县饮食服务公司照相馆	联系人：吴明乐350122	地址：福建省福州市连江县凤城镇八一六南路２号
连江县凤城玉山景峰洗车场	联系人：钟景峰	地址：连江县玉荷西路南侧玉山村
福建省连江县凌锋金刚石经营部	null	地址：福建省福州市连江县丹阳街连罗路５３号
连江县马鼻镇闽丰采石场	联系人：邱如丁	地址：福建省福州市连江县马鼻镇合丰村
凤城水强金银首布石膏模具店	null	地址：福建省福州市连江县敖江北岳新车站对面
福建省连江县凤城成达花岗岩厂	null	地址：福建省福州市连江县凤城镇绿茵村
中国人民解放军３２３６６部队生活服务中心	null	地址：福建省福州市连江县丹阳镇３２３６６部队
连江县敖江镇电力管理站	站长：陈祥官	地址：福建省福州市连江县凤尾花园２６座
连江县燃料公司下屿石油液化气经营部	null	地址：福建省福州市连江县坑园乡下屿村建利路２７号
福建省连江县石油液化气站	null	地址：福建省福州市连江县凤城镇八一六中路４４号
连江县东岱镇电力管理站	站长：郑香斌	地址：福建省福州市连江县东岱镇供电所
福建省连江县电力公司城关供电所	所长：滕用王	地址：福建省福州市连江县凤城镇爱国路１号
连江县马鼻镇电力管理站	站长：陈崇伙	地址：福建省福州市连江县马鼻横厝新村
连江县长龙供电所	null	地址：福建省福州市连江县长龙乡
连江县小沧畲族乡电力管理站	站长：周邦长	地址：福建省福州市连江县小沧乡小沧村湖滨路１５号
连江县透堡镇电力管理站	站长：黄榕元	地址：福建省福州市连江县透堡镇
连江县坑园乡电力管理站	站长：曾政建	地址：福建省福州市连江县坑园乡坑园村
连江县潘渡乡电力管理站	站长：王盛旺	地址：福建省福州市连江县潘渡乡潘渡村
连江县敖江液化气供应站十字街经营部	null	地址：福建省福州市连江县凤城十字街
福州龙事达房地产开发有限公司连江分公司	总经理：陈兆在	地址：福建省福州市连江县凤城镇莲荷东路２１号楼
福建省连江县北门房地产综合开发公司	null	地址：福建省福州市连江县凤城镇北门农贸市场内
福建省迪鑫房地产开发公司连江办事处	联系人：林孝建	地址：福建省福州市连江县凤城八一六西路６３号
连江县筱埕镇电力管理站	站长：谢金鹏	地址：福建省福州市连江县筱埕镇筱埕村樟湾路
连江县凤城物业管理站	站长：郑喜金	地址：福建省福州市连江县凤城镇玉荷东路农贸市场内
连江县广厦物业管理有限公司	总经理：吴振奇	地址：福建省福州市连江县莲荷东路１＃楼南侧
福州市华谷房地产开发公司福来开发部	null	地址：福建省福州市连江县凤城镇文明西路
连江县房地产价格评估事务所	所长：林则快	地址：福建省福州市连江县莲荷东路６号楼二层
福建省连江县凤城房地产开发有限公司	总经理：苏斌	地址：连江县凤城镇经济巷３１号
连江县住房公积金管理中心	联系人：黄兆锋	地址：福建省福州市连江县凤城镇文山路113号
连江县房地产交易管理所	所长：林则快	地址：福建省福州市连江县莲荷东路６号楼二层
福建省连江顶丰置业有限公司	总经理：黄乃元	地址：福建省福州市连江县苔录后湾半山顶
连江县永得利房地产开发有限公司	总经理：陈兆在	地址：连江县凤城镇莲荷东路过２１＃楼２号店
连江县鼎鑫物业管理有限公司	总经理：许鼎兴	地址：福建省福州市连江县凤城８１６南路１号
连江县丹阳中心小学	校长：叶万鹏	地址：福建省福州市连江县丹阳镇新街２号
连江县实验小学	null	地址：福建省福州市连江县凤城镇玉荷西路
连江县道沃中学	null	地址：福建省福州市连江县晓沃镇道沃村
连江县蓼沿中学	校长：林学英	地址：福建省福州市连江县蓼沿乡蓼沿村
连江县江南中学	校长：陈昌文	地址：福建省福州市连江县江南乡南塘村
连江县颜岐中学工会委员会	null	地址：福建省福州市连江县坑园乡颜岐村
连江县第三中学工会委员会	null	地址：福建省福州市连江县丹阳镇坑口巷１４号
连江县下与中学	校长：蔡诗光	地址：福建省福州市连江县坑园乡下与村
连江县马鼻中心小学	校长：陈学土	地址：福建省福州市连江县马鼻镇横厝新村56号
连江县百胜中学	null	地址：福建省福州市连江县晓沃镇百胜村
连江县凤城第二小学	校长：林昌龙	地址：福建省福州市连江县凤城镇凤园街１７２号
连江县第二实验小学	null	地址：福建省福州市连江县凤城莲荷西路
连江县岱江中学工会委员会	null	地址：福建省福州市连江县岱江中学
连江县颜岐中学	null	地址：福建省福州市连江县坑园颜岐村
连江县第三中学总务处	null	地址：福建省福州市连江县丹阳镇坑口巷１４号
福建省连江第二中学	null	地址：福建省福州市连江县?头镇
连江私立启明中学	null	地址：福建省福州市连江县八一六东路１６９号
连江县敖江中学	校长：郑家梁	地址：福建省福州市连江县敖江镇下山村
连江县马鼻中学	校长：郑仕修	地址：福建省福州市连江县马鼻镇
连江县岱江中学	null	地址：福建省福州市连江县东岱镇单步
福建省连江县筱埕明光石材厂	厂长：陈明浩	地址：福建省福州市连江县筱埕镇定海村
福建省连江县丹阳伟盛石材厂	厂长：江朝伟	地址：福建省福州市连江县丹阳镇桂林村贤义桥头
连江县蓼沿乡杏林石料厂	null	地址：福建省福州市连江县蓼沿乡杏林村杏林石料厂
福建省连江县建盛石材有限公司	null	地址：中国 福建 福州市 连江县浦口镇益砌村公园新村3号
福建省连江县华丽服装厂	null	地址：福建省福州市连江县马鼻镇横厝街１２２号
福建省连江县敖江花坞砖厂	null	地址：福建省福州市连江县敖江乡花坞村
连江县浦口顺发花岗石加工厂	null	地址：福建省福州市连江县浦口镇新街
福建省连江县敖江建筑水泥制品厂	null	地址：福建省福州市连江县敖江乡己古村
福建省连江县白莲石板材厂	厂长：陈水仁	地址：福建省福州市连江县潘渡乡白莲
连江县蓼沿溪东石料厂	null	地址：福建省福州市连江县蓼沿乡溪东村
福建省连江县丹阳良星制衣厂	厂长：兰万星	地址：福建省福州市连江县丹阳镇新街
福建省连江县丹阳纺织厂	null	地址：福建省福州市连江县丹阳镇上周
连江县鸿达花岗石制品厂	null	地址：福建省福州市连江县东岱镇龙山村
福建省连江县如意工艺厂	null	地址：福建省福州市连江县敖江镇浦下村
连江县浦口镇兴达石材厂	厂长：陈增芳	地址：福建省福州市连江县浦口镇益砌村
福建省连江县纺织助剂厂	null	地址：福建省福州市连江县透堡镇龙头公路口
福建省连江县龙山花岗岩制品厂	厂长：谢国坤	地址：福建省福州市连江县东岱镇龙山村
福建省连江县水产造船厂	厂长：郑星长	地址：福建省福州市连江县浦口镇塔头南当1号
福建省连江县锦山花岗岩制品厂	null	地址：福建省福州市连江县浦口镇浦仔头路７８号
福建省连江县首兴石材厂	厂长：王增增	地址：福建省福州市连江县蓼沿乡赤南岗工业小区
连江国重照明电器有限公司	null	地址：福建省福州市连江县风城镇
连江县黄岐造船厂搬迁工程指挥部	老板：黄世国	地址：福建省福州市连江县黄岐青岛海边
福建省连江县广化石料厂	null	地址：福建省福州市连江县蓼沿乡溪东
福建省连江县蓼沿杏林合兴石材厂	null	地址：福建省福州市连江县蓼沿乡杏林村
福建省连江县晓沃石材厂	null	地址：福建省福州市连江县晓沃镇晓丰街光大路５１号
福建省连江县惠福石材有限公司	null	地址：福建省福州市连江县敖江镇魁岐东路２２号
福建省连江县湖里花岗岩制品厂	null	地址：福建省福州市连江县东岱镇湖里村
福建省连江合成氨厂	厂长：刘永柱	地址：福建省福州市连江县凤城镇玉山村
福建省连江县敖江上山新兴机砖厂	null	地址：福建省福州市连江县敖江镇上山村
福建省连江县敖江花岗岩制品厂	厂长：林柏通	地址：福建省福州市连江县凤城镇八一六北路敖江建筑公司三层
福建省连江县敖江石料厂	null	地址：福建省福州市连江县江南南宫水库里
福建省连江县花岗石开发公司	总经理：杨建康	地址：福建省福州市连江县凤城镇八一六北路８１号
连江县晓沃空心砖厂	厂长：陈康栋	地址：福建省福州市连江县晓沃镇山坪
连江县安凯乡高塘蓄电池厂	厂长：李登奉	地址：福建省福州市连江县安凯乡高塘村
福建省连江永旺化工有限公司	总经理：熊云仙	地址：福建省福州市连江县凤城镇玉荷东路杭下
福建省连江县嘉磊石业有限公司	总经理：郑家顺	地址：福建省福州市连江县潘渡乡白莲
福建省连江县敖江鞋帽服装厂	厂长：余端高	地址：福建省福州市连江县凤城镇渠路2号敖江工业小区
福建省连江县潘渡鑫磊石材有限公司	null	地址：福建省福州市连江县潘渡乡
福建省连江县聚鑫福利制氧厂	厂长：陈水贞	地址：福建省福州市连江县敖江镇上山村
连江县税务局印刷厂	null	地址：福建省福州市连江县凤城镇万福巷７号
连江县第六中学印刷厂	null	地址：福建省福州市连江县敖江镇江南村
凤城上海周浦汽车蓄电池厂代售部	null	地址：福建省福州市连江县凤城镇八一六北路敖建门市部
连江县凤城镇绿茵印刷厂	null	地址：福建省福州市连江县凤城镇八一六东路２８号
连江县凤城镇建凤印刷厂	null	地址：福建省福州市连江县凤城镇八一六东路６１号
福建省连江县安凯兴达船舶修理厂	厂长：李江	地址：福建省福州市连江县安凯乡高塘村
福建省连江县船运公司船舶修造厂	null	地址：福建省福州市连江县东岱演宫
福建省连江县岱江皮草制衣厂	null	地址：福建省福州市连江县东岱镇粮站
福建省连江县日达制衣厂	null	地址：福建省福州市连江县凤城杭下五交化仓库
福建省连江县黄岐庆丰水产冷冻厂	null	地址：福建省福州市连江县黄岐镇赤沃村
福建省连江县盛辉食品冷冻厂	null	地址：福建省福州市连江县凤城工业小区
福州久盛达石业有限公司（工商已吊销）	联系人：林长发	地址：福建省福州市连江县蓼沿乡蓼沿村
连江县凤城友谊印刷厂	null	地址：福建省福州市连江县北岳村二路１１７号
福建省连江县水产供销公司?头冷冻厂	null	地址：福建省福州市连江县?头镇联合路２１号
福建省连江县中林环保设备厂	null	地址：福建省福州市连江县晓沃镇道沃村
福建省连江县晓沃环保设备厂	null	地址：福建省福州市连江县晓沃镇道沃
福建省连江县苔录闽海冷冻厂	厂长：何进群	地址：福建省福州市连江县苔录镇秀邦村
福建省连江县石材除尘设备厂	null	地址：福建省福州市连江县晓沃镇道沃村
连江定海福顺兴水产食品加工厂	null	地址：福建省福州市连江县筱埕镇定海村长沃
福建省连江县长龙塑料厂	null	地址：福建省福州市连江县长龙乡宫板村
连江定海南轩水产食品加工厂	厂长：许福安	地址：福建省福州市连江县筱埕镇定海村长沃
福建省连江县敖江林产品加工厂	厂长：胡利光	地址：福建省福州市连江县江南乡已古村
罗源华铭电器有限公司连江分公司	总经理：林振华	地址：福建省福州市连江县凤城镇８１６北路大官坂垦区新村４－５店
连江县凤城雪珍服装加工场	联系人：吴雪珍	地址：福建省福州市连江县凤城西渠路３０号
福建省连江县道沃花岗岩除尘设备厂	null	地址：福建省福州市连江县晓沃镇道沃村
福建省连江县东湖环保设备厂	null	地址：福建省福州市连江县东湖镇
福建省连江县科技环保设备厂	null	地址：福建省福州市连江县晓沃镇道沃村
福建省连江长龙神工首饰模具厂	厂长：陈元庆	地址：福建省福州市连江县长龙镇岚下村１５号
福建省连江县晓沃环境保护设备厂	厂长：李德彬	地址：福建省福州市连江县晓沃和平路399号
连江县敖江丰恒纸品厂	null	地址：福建省福州市连江县敖江镇下山村
连江县东岱镇山堂洋边空心砖厂	null	地址：福建省福州市连江县东岱山堂洋边空心砖厂
福建省连江圣力印刷厂	厂长：邱劲	地址：福建省福州市连江县凤城镇玉荷西路
连江县敖江东正汽车维修站	null	地址：福建省福州市连江县敖江镇正古村１０４国道路４号
福建省连江县浮希机砖厂	null	地址：福建省福州市连江县马鼻镇浮希村
连江县凤城伽华印刷厂	null	地址：福建省福州市连江县凤城镇连理路１３号
福建省连江县晓沃镇水产品加工厂	厂长：邱德标	地址：福建省福州市连江县晓沃镇福兴北路２７１号
福建省连江恒昌水产有限公司	总经理：林通利	地址：福建省福州市连江县安凯乡奇达村
福建省连江县利成胶合板厂	null	地址：福建省福州市连江县小沧乡利洋村
福建省连江县坑园乡对虾冷冻厂	null	地址：福建省福州市连江县坑园乡坑园村
连江县长龙机砖厂	null	地址：福建省福州市连江县长龙乡宫村
福建省连江县安凯高塘船舶修造厂	厂长：邱文章	地址：福建省福州市连江县安凯乡高塘村
连江县蓼沿航利石料厂	null	地址：福建省福州市连江县蓼沿兰水村
福建省连江金堡木业有限公司	总经理：蔡金灿	地址：福建省福州市连江县透堡镇塘里口２９号
福建省连江县丹阳镇山边草竹制品厂	null	地址：福建省福州市连江县丹阳镇山边村
福建省连江县顺达水产有限公司	null	地址：福建省福州市连江县台录镇北交村
福建省连江县城关东北街家具厂	null	地址：福建省福州市连江县城关彩云巷１号
连江县晓沃兴峰印刷厂	null	地址：福建省福州市连江县晓沃镇晓兴街
福建省连江县东岱山堂空心砖厂	null	地址：福建省福州市连江县东岱镇山堂村
福建省连江县振华水产有限公司	总经理：黄增新	地址：福建省福州市连江县苔录镇后湾村
福州彤辉石材有限公司	总经理：林培标	地址：福建省福州市连江县丹阳镇山边村　　　　法定代表人：林培标
福建省连江县海鸠雨衣厂	null	地址：福建省福州市连江县晓沃镇百胜村
连江县第二建筑工程公司木制品加工厂	厂长：滕国钦	地址：福建省福州市连江县凤城镇坂尾堤外
福建省连江县筱埕乡定海水产冷冻厂	null	地址：福建省福州市连江县筱埕乡定海村
福建省连江县敖江乡山亭机砖厂	厂长：林家栋	地址：福建省福州市连江县敖江乡官巷村
福建省连江县浦口机砖厂	null	地址：福建省福州市连江县浦口镇安浦宫
福建省连江县航连金属制品有限公司	总经理：林传祯	地址：福建省福州市连江县潘渡乡坡西村
连江县凤城兴发雨衣厂	null	地址：福建省福州市连江县凤城莲荷路５号楼
福建省连江县复兴水产有限公司	null	地址：福建省福州市连江县莲荷西路康耀公寓２号楼２０３室
福建省连江顺记粮油有限公司	null	地址：福建省福州市连江县凤城镇东城路３９号
福建省连江县华龙百胜塑胶雨具厂	null	地址：福建省福州市连江县晓沃镇百胜下羊工业小区２号
福建省连江县如意工艺品厂	厂长：谢运光	地址：福建省福州市连江县敖江镇浦下村中巷８号
