福建诚付天下金融技术服务有限公司福州连江分公司	总经理：林	地址：连江县凤城镇玉山小区104国道西侧1#楼101单元
福建省京舜建设工程有限公司连江分公司	总经理：陈	地址：连江县凤城镇816中路安盛大厦2#楼605
连江县菊红农业综合场	联系人：陈	地址：福建省福州市连江县长龙镇下洋村新建路115号
福州市闽诚家政服务有限公司连江分公司	总经理：范	地址：连江县凤城镇龙华花园二期19号楼4号店面
连江县丹阳镇法增铝合金铁门加工厂	厂长：陈	地址：福州市连江县丹阳镇山兜村长园坪
连江县蓼沿乡宝磊石料场	联系人：黄	地址：福州市连江县蓼沿乡溪东村单兜岗
连江县诚信天商务咨询服务有限公司	总经理：罗	地址：福建省福州市连江县凤城镇丹凤西路2号宏宇花园14#-16#14号店
连江县丹阳镇荣盛石材厂	厂长：黄	地址：福建省福州市连江县丹阳镇花园村
连江县旺居房产代理有限公司	总经理：黄	地址：福建省福州市连江县凤城镇北门街凤园路凤尾花园3#楼11店
福建佳创置业有限公司	总经理：林	地址：福建省福州市连江县凤城镇江滨西路3号江夏苑1#－4#楼二层33店面
福州财缘城投资有限公司	总经理：邵	地址：福建省福州市连江县凤城镇文山北路5号太一新天地1#楼7店面
福建华兰里农业综合开发有限公司	总经理：邱	地址：福建省福州市连江县马鼻镇贵峰村渔池墩路1号
福建瑞玻玻璃有限公司	总经理：陈	地址：福建省福州市连江县可门经济开发区坑园村溪尾路58号
福建省万坤建设工程有限公司	总经理：黄	地址：连江县凤城镇丹凤东路14号绿茵花园5#楼4层401单元
福州励志房地产开发有限公司	总经理：邱	地址：福建省福州市连江县安凯乡高塘村高塘路102号
连江县创宏建材有限公司	总经理：王	地址：福建省福州市连江县凤城镇国优路8号鲤鱼港湾5#楼11层1102单元
连江众安投资有限公司	总经理：王	地址：福建省福州市连江县马鼻镇横厝村红石12-2号
连江县泓帆渔业有限公司	总经理：刘	地址：连江县苔?镇茭南村宏图路43号
连江县兴丰服饰有限公司	总经理：庄	地址：连江县凤城镇丹凤东路15号丹凤花园44#楼13店面
连江县浦口镇山海经农业专业合作社	联系人：林	地址：连江县浦口镇中麻村里澳269号
福建省上善星电缆有限公司	总经理：林	地址：连江县经济开发区敖江工业园区1#楼福建世纪电缆有限公司内
福州市金汇通投资咨询有限公司	总经理：林	地址：连江县凤城镇丹凤东路7号迪鑫花园6#1号店
福州市日志环保科技有限公司	总经理：林	地址：福建省福州市连江县凤城镇莲荷东路25#楼B座3车库
福州市恩佑再生资源有限公司	总经理：王	地址：福建省福州市连江县坑园镇下元村前进路29号
连江县黄岐镇郑秀敏渔需制品厂	厂长：郑	地址：福建省福州市连江县黄岐镇大建村建强路码头边
连江县金莎水产养殖有限公司	总经理：汪	地址：福建省福州市连江县黄岐镇后仑村西路23号
福建泰龙源农业开发有限公司	总经理：黄	地址：福州市连江县透堡镇馆读村门前埕D9号2户
福建省鸿翔广告工程有限公司	总经理：林	地址：连江县凤城镇莲荷东路18#A2号店
连江县庆源燃料油贸易有限公司	总经理：占	地址：福建省福州市连江县浦口镇中麻村
福州源鑫盛源实业有限公司	总经理：林	地址：福建省福州市连江县可门开发区管委会坑园镇坑园村溪尾路58号
福建省连江县西山顶综合农场（普通合伙）	联系人：林	地址：福建省福州市连江县蓼沿乡利畲村西山自然村
中国移动通信集团福建有限公司连江商专营业厅	联系人：陈	地址：连江县潘渡村福建商业高等专科学校新校区商业街
福州盛龙塑胶有限公司牡丹洋分公司	总经理：潘	地址：连江县蓼沿乡定田村牡丹洋垅头厝山地
连江县丹阳镇顶尚丽盾工艺石加工厂	厂长：雷	地址：福州市连江县丹阳镇新洋村
连江县玉平养兔场	联系人：刘	地址：福建省福州市连江县江南乡澄岩村
连江县苔?旺角酒厂	厂长：林	地址：福建省福州市连江县苔?镇苔?村后港1#、2#、3#D6#
福建省假日国际旅行社有限公司连江?头营业部	老板：倪	地址：福建省福州市连江县?头镇街道团结路11号
福建省鑫恒投资有限公司	总经理：韩	地址：连江县凤城镇金安西路2号龙芝国际商业广场1层5店面
福建省生久担保有限公司	总经理：陈	地址：福建省福州市连江县凤城镇丹凤西路2号宏宇花园14-16#14号店
连江县鑫瑞咨询服务有限公司	总经理：谢	地址：连江县凤城镇丹凤东路15号丹凤花园43#楼14店面
福州良特贸易有限公司	总经理：吴	地址：福建省福州市连江县?头镇开放路东侧宏源新苑4#楼503室
福州市超浪养殖有限公司	总经理：林	地址：福建省福州市连江县坑园镇屿头村富新路4号
连江县凤城镇依宝药店	老板：谢	地址：福建省福州市连江县凤城镇丹凤东路15号丹凤花园2#楼6-9号店
福建省新马会旅游开发有限公司	总经理：李	地址：福建省福州市连江县潘渡乡贵安村科技大楼305室
连江县坑园镇颜岐富珍水产品经营部	老板：颜	地址：福建省福州市连江县坑园镇颜岐村新民南路94号
福建连江宏大建筑工程有限公司	总经理：姚	地址：连江县下宫乡厦一村一条山脚
连江县九源燃料油有限公司	总经理：林	地址：福建省福州市连江县?头镇下岐村113号
福建宜联管业有限公司	总经理：林	地址：连江县敖江镇青塘村工业园区1#厂房
福州市宏日建筑劳务有限公司	总经理：杨	地址：福建省福州市连江县凤城镇江滨路景江花园二期D型E12一层
连江县坑园镇光辉海产品厂	厂长：颜	地址：福建省福州市连江县坑园镇颜岐村新民南路礼堂边
福州盛运物流有限公司	总经理：赵	地址：连江县沈海高速公路与文笔东路交叉口东北角
连江县长龙镇龙发农民专业合作社	联系人：陈	地址：福建省福州市连江县长龙镇建庄村后门洋
连江县凤城镇我家聚餐园玉荷分店	老板：林	地址：福建省福州市连江县凤城镇玉荷西路（原西餐厅）2#楼9号店、10号店
神州坤元（福建）建设工程有限公司	总经理：郑	地址：福建省福州市连江县凤城镇816东路109号六层
连江县坑园镇颜岐村广隆超市	联系人：颜	地址：福建省福州市连江县坑园镇颜岐村大兴东路310号
福州市金石馆工艺品有限公司	总经理：王	地址：福建省福州市连江县凤城镇丹凤东路3-460号9#楼1层112号店
兴锋盈（福建）集团有限公司连江分公司	总经理：官	地址：连江县潘渡乡贵安村后垄仔责任田
福建康佰家大药房连锁有限公司一二二店	老板：严	地址：连江县?头镇上坪路18号鑫立大厦第一层店面
连江县渔港旅游开发有限公司	总经理：谢	地址：福建省福州市连江县苔?镇秀邦村北沃五路二扇一直
连江县好帮手家庭服务有限公司	总经理：范	地址：连江县凤城镇金凤名都10#楼1层7号店面
连江县华商翼企业管理有限公司	总经理：林	地址：福建省福州市连江县凤城镇816南路巨林商厦1#楼1-19号店面
福建省得力宝五金工具有限公司	总经理：王	地址：连江县?头镇东边村连港路北侧3#1层
连江县马鼻镇金石石材加工厂	厂长：陈	地址：福建省福州市连江县马鼻镇车站西侧
福建金沙岛投资有限公司	总经理：林	地址：连江县凤城镇华光西路2号凤凰城10#楼1店面
福建中汇典当有限公司	总经理：高	地址：福建省福州市连江县贵安新天地贵锦苑商业1号楼21店
连江县晓澳镇金山禽畜养殖场	联系人：林	地址：连江县晓澳镇道澳村二坪山南面
福州千穗农业开发有限公司	总经理：陈	地址：福建省福州市连江县透堡镇西门村西门街14号3户
福建晟鑫建设工程有限公司连江分公司	总经理：陈	地址：福建省福州市连江县凤城镇东北街816东路109号二层
连江县鱼奇海产品有限公司	总经理：王	地址：福建省福州市连江县凤城镇丹凤东路2号丹凤广场1#楼B座801
福州兴鑫旺贸易有限公司	总经理：陈	地址：连江县马鼻镇半田下村溪边区50号
福州百味食品有限公司连江分公司	总经理：陈	地址：连江县经济开发区东湖园区3#厂房一楼
承洁环保有限公司	总经理：陈	地址：连江县江南乡江南社区居委会307房
福州群龙兴贸易有限公司	总经理：欧	地址：连江县?头镇天麟明珠城7座404号
连江县顺鑫汽车租赁有限公司	总经理：李	地址：连江县凤城镇江滨东路18号景江花园二期D型23号店面
迪凯塑料制品有限公司	总经理：陈	地址：连江县丹阳镇虎山村连江县丹阳造纸厂一层
连江县华源建材贸易有限公司	总经理：陈	地址：福州市连江县凤城镇文山北路5号太一新天地12#楼8层811单元
福州市旺林升汽车租赁有限公司	总经理：林	地址：福州市连江县丹阳镇104国道右侧12号住宅楼4号店面
福州市车迷城汽车服务有限责任公司	总经理：陈	地址：福州市连江县敖江投资区上高速路北侧、敖江路东侧8#标准厂房
福州海中水产有限公司	总经理：陈	地址：连江县马鼻镇玉井村二房里112号
福州创域装饰工程有限公司	总经理：林	地址：福建省福州市连江县凤城镇文山北路5号太一新天地1#楼14店面
福州丰畅购物中心有限公司	总经理：张	地址：连江县潘渡乡贵安村科技大楼
高明实业（福建）有限公司	总经理：赖	地址：连江县凤城镇文明东路1号
连江县卓创企业管理咨询有限公司	总经理：林	地址：福建省福州市连江县凤城镇文笔路6号凤翔国际二区17#楼1层20店面
连江县盛平企业管理咨询有限公司	总经理：张	地址：连江县凤城镇玉荷东路（台资大楼边）1#104
连江县雅顺广告工程有限公司凤城分公司	总经理：陈	地址：福建省福州市连江县凤城镇文山北路6号龙华花园3#楼1层3店面
福建省连江县世长水产养殖场	联系人：赵	地址：福建省福州市连江县筱埕镇定海村鲍鱼海区第一区
福建省连江县乾元水产品贸易有限公司	总经理：刘	地址：福建省福州市连江县苔?镇后湾村海滨路5号
福建连江恒欣村镇银行股份有限公司?头支行	联系人：陈	地址：福建省福州市连江县?头镇拱屿村开放路东川花园B#B单元
福建中永建设工程有限公司连江分公司	总经理：陈	地址：福建省福州市连江县凤城镇文山北路6号龙华花园16#楼2层202单元
福建兴坤达钢结构工程有限公司	总经理：陈	地址：福建省福州市连江县敖江镇浦下村原荷山造纸厂
福建永恒兴投资有限公司	总经理：陈	地址：福建省福州市连江县凤城镇文山北路6号龙华花园商业用房1层4店面
福建省连江县黄岐枝达海洋渔具制造厂	厂长：林	地址：福建省福州市连江县黄岐镇海建街畚箕山
福建省大众农业综合开发有限公司	总经理：黄	地址：福建省福州市连江县蓼沿乡定田村下岩路92号
福建省同友房地产开发有限公司	总经理：唐	地址：福建省福州市连江县凤城镇丹凤西路2号宏宇花园14-16#楼14号店
中国人寿保险股份有限公司连江县支公司第十营销服务部	老板：李	地址：福建省福州市连江县?头镇劳动路100号二层
福建聚磊建材有限公司	总经理：袁	地址：福建省福州市连江县江南乡境路村垅里工业区3号
福建宫福水产进出口有限公司	总经理：卓	地址：连江县晓沃镇道沃村1#楼
连江县东岱镇靓装建材店	老板：林	地址：连江县东岱镇东岱街邮电局对面
连江县北茭富源渔业有限公司	总经理：林	地址：福建省福州市连江县苔?镇北茭村吴城面14号
连江县大宇贸易有限公司	总经理：周	地址：福建省福州市连江县?头镇兰田村1#1层101室
连江县苔?镇茭南兴隆水产品经营部	老板：刘	地址：福建省福州市连江县苔?镇茭南村双门角
连江县苔?镇茭南村海威水产品经营部（普通合伙）	联系人：林	地址：福建省福州市连江县苔?镇茭南村一岗山
连江县苔?镇茭南朝池水产品经营部	老板：陈	地址：福建省福州市连江县苔?镇茭南村后弄尾
连江县日月顺汽车运输有限公司	总经理：王	地址：连江县经济开发区敖江园区丛一路南端办公楼五楼
连江县蓼沿乡首兴石材厂（普通合伙）	联系人：旁	地址：福州市连江县蓼沿乡赤南岗工业区
连江县八闽纸品印刷厂	厂长：陈	地址：连江县凤城镇玉荷西路266号（沿街店面272号）
福州聚瑞企业服务有限公司	总经理：黄	地址：福建省福州市连江县凤城镇华光西路2号凤凰城12#楼1507单元
福州市靓威洗涤有限公司	总经理：邱	地址：连江县敖江镇敖江投资区青龙路12#（福州港发机电工业有限公司内）
福建省连江县半岛农业开发有限公司	总经理：杨良金	地址：中国 福建 福州 连江县 江南乡华坞村里山
福建尚品茶业有限公司连江分公司	总经理：刘先生	地址：连江县潘渡乡仁山村科技园
连江县森泽房地产中介服务有限责任公司	总经理：王先生	地址：连江县凤城镇江滨东路18号景江花园二期沿街D型20店面
连江县海盛建材有限公司	总经理：蒋先生	地址：连江县凤城镇文山南路212号凤贵新村1#-5#楼37店面
连江县苔?镇后湾村冠豪渔需加工制品厂	厂长：何先生	地址：连江县苔?镇后湾村“地笼里”风电公路内侧
福州浩威金属制品有限公司连江分公司	总经理：许先生	地址：连江县江南乡南塘口1号
福建春晖伟业投资有限公司	总经理：柯先生	地址：连江县县城区敖江路与丹凤路交叉口东南角玉沙综合商场
福建多多罐头有限公司连江分公司	总经理：杨先生	地址：连江县经济开发区敖江园区（104国道西侧）
福建省邮政速递物流有限公司连江县分公司?头揽投站	站长：吴先生	地址：连江县?头镇开放西路64、66号店面
连江县浦口镇农峰船舶配件加工场	联系人：吴先生	地址：连江县浦口镇官岭村建新路58号
福州曜阳胜杰实业有限公司	总经理：王先生	地址：连江县潘渡乡贵安村科技大楼
福建省富琦消防检测有限公司连江分公司	总经理：林先生	地址：连江县凤城镇丹凤东路15号丹凤花园36#楼204单元
连江县坑园镇下屿永隆水产综合场	联系人：许先生	地址：连江县坑园镇下屿村湾里
福建龙芝混凝土有限公司	总经理：陈先生	地址：连江县东湖镇人民政府4楼
福建半岛水产品有限公司连江分公司	总经理：张先生	地址：连江县凤城镇文山北路金凤名都6号楼1层03D04店面
连江县鑫艺广告有限公司	总经理：林先生	地址：连江县凤城镇玉荷西路231号美林苑1#楼D3#楼1层18号店
福建广电网络集团股份有限公司连江分公司	总经理：郑先生	地址：连江县凤城镇816北路4号705单元房
福建省连江县黄岐镇建扬船舶管理服务站（普通合伙）	联系人：魏先生	地址：连江县黄岐镇新城东区12号楼92-96号
福州茂益旅游开发有限公司	总经理：黄存财	地址：连江县凤城镇江滨路景江花园7#603
连江县丹阳镇利农农业综合开发试验场	联系人：林本乐	地址：连江县丹阳镇东平村宝林
福州榕参医药连锁有限公司连江店	老板：杨伙祯	地址：连江县凤城镇816北路西侧2#3、4店和201房二层
连江县坑园镇可门永新超市	联系人：郑先生	地址：连江县坑园镇下屿村建华路12-2号
福建汇煌建材有限公司	总经理：陈先生	地址：连江县凤城镇816南路巨林商厦2#楼7层701单元
福州市鼓楼区汉派黄鹤楼美食园连江龙芝分店	老板：陈先生	地址：连江县凤城镇金安西路2号龙芝国际商业广场2层3店面（3-1至3-5号商铺）
福建省连江县黄岐达鑫水产养殖场	联系人：张先生	地址：连江县黄岐镇海建村
连江县马鼻镇铮隆海产品经营部	老板：许先生	地址：福建省连江县马鼻镇合丰村五甲街35-2号
连江县茗品香种植专业合作社	联系人：林先生	地址：连江县东湖镇牛栏坪村里厝7号
连江?头镇县青芝永光游泳馆	联系人：李先生	地址：连江县?头镇青芝山景区东南角斗城
连江县定海大自然水产育苗基地	联系人：何先生	地址：连江县筱埕镇定海村乌猪路（海潮寺东面）
连江县礼乾果蔬种植专业合作社	联系人：吴先生	地址：连江县东湖镇岩下村中心路38号
中国移动通信集团福建有限公司连江坑园营业厅	联系人：王先生	地址：连江县坑园镇聚鑫楼一层
连江县马鼻镇远锋农业综合开发场	联系人：陈先生	地址：连江县马鼻镇墙兜村三叉路口（车站对面）
福建省邮政速递物流有限公司连江县分公司玉荷西揽投站	站长：周先生	地址：连江县凤城镇玉荷西路10#5店面
中国移动通信集团福建有限公司连江潘渡营业厅	联系人：吴先生	地址：连江县潘渡乡潘渡村潘渡街8号楼一层
连江县黄岐湾旅游开发有限公司	总经理：林先生	地址：连江县黄岐镇海建街避风港东侧
福建省连江县苔?福利渔资索网厂	厂长：刘国光	地址：连江县苔?镇??新村2号
福建航泰贸易有限公司	总经理：林宗晃	地址：连江县江南乡南塘口海峡钢贸城C2区9#楼11号店
连江县绿忆岛海产品养殖有限公司	总经理：林建荣	地址：连江县苔?镇东洛村北旺弄33号
连江县信林养殖专业合作社	联系人：林积惠	地址：连江县坑园镇屿头村富新路13-1号
连江县皇兴农业综合开发有限公司	总经理：黄中庭	地址：连江县蓼沿乡杏林村村委会
连江县东建种植专业合作社	联系人：吴传建	地址：连江县东湖镇东塘村东边路2号
福建省连江天都实业有限公司坑园分公司	总经理：颜先生	地址：连江县坑园镇坑园村宏达路69-1号
福建省连江县岚园茶业有限公司	总经理：陈先生	地址：连江县凤城镇文笔路6号凤翔国际二区20#1层13车库
福建大众健康海洋生物科技有限公司	总经理：江铭福	地址：连江县筱埕镇大埕村
连江县浦口任光气体供应站	站长：陈碧娇	地址：连江县浦口镇公路边（星辉新村40号）
连江县恒顺安运输有限责任公司	总经理：孙基敏	地址：连江县凤城镇文山北路6号龙华花园13#楼2层206单元
连江县潘渡乡祥春医药商店	老板：赵晓君	地址：连江县潘渡乡贵安新天地海峡传统文化街27栋12号店
福建定海湾实业有限公司	总经理：陈智和	地址：连江县筱埕镇蛤沙村滨海路6号
福建省连江县泰丰酒店	老板：蒋碧峰	地址：连江县凤城镇马祖西路19号凤锦天成1#楼2层1、2号服务用房
晨洛（福州）食品有限公司	总经理：颜先生	地址：连江县敖江开发区104国道西侧青塘路口（福州宏利食品有限公司院内5号楼二层）
福建官坞旅游开发有限公司	总经理：林先生	地址：福州市连江县筱埕镇官坞村连黄公路北侧官坞村委会办公楼第四层
连江县富春爆破服务有限公司	总经理：孙先生	地址：连江县东湖镇湖坪村胡东路49号
福州市辉庄投资有限责任公司	总经理：陈先生	地址：连江县潘渡乡东雁村贵安新天地贵荣苑商业街5#-9#楼20店面
福州新意豪家俱有限公司	总经理：颜晨浪	地址：连江县敖江镇敖江投资区富兴北路1#1层
连江县网纵计算机有限公司	总经理：叶明森	地址：连江县凤城镇西渠路2号
连江县定海湾渔港建设有限公司	总经理：林先生	地址：连江县筱埕镇筱埕村龙舟路76号（镇政府大楼二层）
连江县亮丽洁保洁有限公司	总经理：刘宇恩	地址：连江县凤城镇丹凤东路2号丹凤广场1#楼B座802单元
连江县蓼沿乡博鑫制沙场	联系人：郑先生	地址：连江县蓼沿乡后坂村定头自然村青青坑山地
连江县山水洗涤有限公司	总经理：罗发扬	地址：连江县潘渡乡陀市村安山边自然村
连江县添亮企业管理有限公司	总经理：林文添	地址：连江县凤城镇玉山村工业小区104道西侧19幢2号三层
连江县下宫乡下宫村奋殿电信服务部	老板：姚先生	地址：连江县下宫乡下宫村新村1号
连江县苔?镇展新日用品咨询服务部	老板：吴先生	地址：连江县苔?镇后湾村朝阳路135号之402号
连江县苔?镇后港进铿铝合金店	老板：何先生	地址：连江县苔?镇后港新村
连江县苔?镇东洛建荣电信代办点	联系人：林先生	地址：连江县苔?镇东洛村北旺弄33号
连江县马鼻镇邱开清电信专营店	老板：邱先生	地址：连江县马鼻镇合丰村菜市场南面
连江县蓼沿乡远忠铝合金加工店	老板：郑先生	地址：连江县蓼沿乡坪岗顶
连江县蓼沿乡太阳花文具店	老板：阮先生	地址：连江县蓼沿乡蓼沿村平岗顶街
连江县?头镇余延丹电信代办点	联系人：余先生	地址：连江县?头镇拱屿村青芝路50号
连江县?头镇叶增雄电信代办点	联系人：叶先生	地址：连江县?头镇拱屿村青芝路50号
连江县?头镇叶清华电信代办点	联系人：叶先生	地址：连江县?头镇拱屿村青芝路50号
连江县?头镇吴香灿电信代办点	联系人：吴先生	地址：连江县?头镇拱屿村青芝路50号
连江县?头镇孙法展电信代办点	联系人：孙先生	地址：连江县?头镇拱屿村青芝路50号
连江县?头镇水良超市	联系人：王先生	地址：连江县?头镇定岐村黄朱前109号
连江县?头镇卢新标电信代办点	联系人：卢先生	地址：连江县?头镇拱屿村青芝路50号
连江县?头镇林莉电信代办营业厅	联系人：林先生	地址：连江县?头镇拱屿村青芝路50号
连江县?头镇胡力娟卤味店	老板：胡先生	地址：连江县?头镇大众路105号
连江县凤城镇依忠涂料店	老板：林先生	地址：连江县凤城镇马祖西路17号颐和家园1#楼-2#楼1层6号店面
连江县凤城镇尼尔森酒庄	联系人：林先生	地址：连江县凤城镇文山北路温麻公园大门南侧1#楼6店面
连江县凤城镇妮当家休闲食品店	老板：姚先生	地址：连江县凤城镇北门新区凤尾花园文山北路11#楼6店
连江县凤城镇米多多日用品店	老板：王先生	地址：连江县凤城镇凤尾村城边路11号2户
连江县凤城镇凯越大酒楼	联系人：倪先生	地址：连江县凤城镇丹凤东路凤翔名仕6号楼2层
连江县凤城镇景江瑞芳茶行	联系人：邱先生	地址：连江县凤城镇江滨东路18号景江花园二期D型一层32店面
连江县凤城镇海柳烟斗店	老板：张先生	地址：连江县凤城镇凤尾花园76#11号杂物间
连江县凤城镇海精灵淘帝服装店	老板：林先生	地址：连江县凤城镇玉荷西路6#楼第5店
连江县凤城镇潮流尚品服装店	老板：危先生	地址：连江县凤城镇金安西路2号龙芝国际商业广场1层7店面（1-7-6、1-7-7号商铺）
连江县东岱镇孝颐电信服务站	站长：郑先生	地址：连江县东岱镇东兴中路103号
连江县东岱镇晓末电信服务站	站长：林先生	地址：连江县东岱镇东兴中路103号
连江县敖江镇锐锋电脑店	老板：刘先生	地址：连江县敖江镇青塘村青红路21号101#
连江县下宫乡东盛鲍鱼养殖场	联系人：吴而东	地址：连江县下宫乡初芦村初芦海区（鲍鱼海区12区）
连江县下宫乡民杰鲍鱼养殖场	联系人：郑丁福	地址：连江县下宫乡初芦村初芦海区（鲍鱼海区15区）
连江县下宫乡兴顺鲍鱼养殖场	联系人：郑丁顺	地址：连江县下宫乡初芦村初芦海区（鲍鱼海区12区）
连江县新光源机电有限公司	总经理：陈孔其	地址：连江县凤城镇丹凤东路15号丹凤花园45号楼2店面
连江县?头镇温馨推拿中心	联系人：吴先生	地址：连江县?头镇东升村小区第六栋第六号店
连江县?头镇塘头包子店	老板：尤先生	地址：连江县?头镇塘头农贸市场内
连江县?头镇顺心电动车行	联系人：许先生	地址：连江县?头镇塘头村市场旁
连江县?头镇建清工艺品店	老板：方先生	地址：连江县?头镇开放路西路118号金山御景C区4#商业楼1层16、17店面
连江县凤城镇一房公舍服装店	老板：吴先生	地址：连江县凤城镇金安西路2号龙芝国际商业广场2层5店面（2-5-3/2-5-4号商铺）
连江县凤城镇星月造型理发店	老板：余先生	地址：连江县凤城镇凤尾花园2#楼第3店
连江县凤城镇新风尚都市丽人服装店	老板：肖先生	地址：连江县凤城镇莲荷东路1#楼第一间店
连江县凤城镇欣欣日用品咨询服务中心	联系人：刘先生	地址：连江县凤城镇文山北路6号龙华花园12#902单元
连江县凤城镇榕城冷冻食品店	老板：方先生	地址：连江县凤城镇玉荷东路侨隆花园A区A-9店
连江县凤城镇美丽坊化妆品店	老板：郑先生	地址：连江县凤城镇莲荷东路百凤花园4-6#14号店
连江县凤城镇梅萍冷冻食品店	老板：林先生	地址：连江县凤城镇莲荷西路7#楼23号店
连江县凤城镇丽氏美容店	老板：陈先生	地址：连江县凤城镇玉荷西路231号美林苑1#-3#楼22店面
连江县凤城镇酷淑轩服装店	老板：林先生	地址：连江县凤城镇安盛大厦二层90店
连江县凤城镇酷酷小童星服装店	老板：邱先生	地址：连江县凤城镇玉荷东路金星综合楼一层内13A店
连江县凤城镇峻杰舞蹈健身馆	联系人：张先生	地址：连江县凤城镇文山北路凤尾农贸市场303
连江县凤城镇居馨建材店	老板：高先生	地址：连江县凤城镇文山北路6号龙华花园16#1层7-8店
连江县凤城镇非主流鞋店	老板：卢先生	地址：连江县凤城镇安盛大厦一层47、51号店
连江县凤城镇爱家生活日用品店	老板：陈先生	地址：连江县凤城镇凤凰城1#26号店
连江县凤城镇爱宝乐婴幼儿用品店	老板：吴先生	地址：连江县凤城镇金安西路2号龙芝国际商业广场1层9店面（1-9-9/1-9-10号商铺）
连江县东湖镇祥韵茶叶店	老板：曾先生	地址：连江县东湖镇东湖中路156-2号
连江县安凯乡文湾村昌松棋牌室	联系人：刘先生	地址：连江县安凯乡文湾村文湾路27号
连江县安凯乡沙沃村明在棋牌室	联系人：杨先生	地址：连江县安凯乡沙沃村沙沃路6号
连江县安凯乡高塘村秀云棋牌室	联系人：陈先生	地址：连江县安凯乡高塘村高塘路70号
福建省连江县龙隆鞋贸经营部	老板：陈先生	地址：连江县敖江投资区青龙路鸿昌工业区南侧4号厂房
连江县悦豪商务酒店	老板：董先生	地址：连江县凤城镇金凤名都8#楼6、7店及二层
连江县航永贸易有限公司	总经理：高先生	地址：连江县凤城镇丹凤东路15号丹凤花园22#15室
连江县佳茗农业综合开发场	联系人：陈先生	地址：连江县凤城镇文明东路281号
连江县凤城镇杜康酒业商行	联系人：叶先生	地址：连江县凤城镇文汇路3号凤翔名仕6#楼1层11店面
连江县黄岐镇高丹食杂店	老板：高先生	地址：连江县黄岐镇海滨路1号
连江县潘渡乡尚茶茶叶店	老板：陈先生	地址：连江县潘渡乡贵安村贵洋路贵安温泉会议中心有限公司一层大堂
连江县潘渡乡赵国登食杂店	老板：赵先生	地址：连江县潘渡乡仁山村南峰山6号-1
连江县凤城镇林韩国服装店	老板：林先生	地址：连江县凤城镇莲荷东路19#楼第112店
连江县凤城镇鑫杰小吃店	老板：林先生	地址：连江县凤城镇玉荷东路（文山路142号）5#楼15号店
连江县凤城镇陈小娴水果店	老板：陈先生	地址：连江县凤城镇104国道西侧玉泉小区B#楼5号店
连江县蓼沿乡孝光烟花爆竹店	老板：王先生	地址：连江县蓼沿乡杏林村新华路38号
连江县苔?镇明娟日用品店	老板：谢先生	地址：连江县苔?镇??村新村一路一号
连江县?头镇时尚鞋店	老板：吴先生	地址：连江县?头镇?头供电所临街第一排第二间
连江县?头镇恒通日用品店	老板：杨先生	地址：连江县?头镇大众中路202号拱屿村委会73号店面
连江县东岱镇陈其水果店	老板：林先生	地址：连江县东岱镇东旺路市场旁1号店
连江县凤城镇海源星水产干鲜礼品商行	联系人：尹先生	地址：连江县凤城镇丹凤路北侧5号丹凤朝阳花园1#楼113店
连江县凤城镇佳惠达食杂店	老板：滕先生	地址：连江县凤城镇丹凤东路丹凤广场1#楼C座1层2店
连江县?头镇林涛服装店	老板：林先生	地址：连江县?头镇拱屿村?福大道南侧红星花园1#602房
连江县东岱镇吉彩香烛店	老板：张先生	地址：连江县东岱镇北门公园兴学路东面第五栋1号店
连江县丹阳镇骏名家具店	老板：黄先生	地址：连江县丹阳镇虎山村海窑园7号
连江县凤城镇卡拉布贝妈良品鞋店	老板：吴先生	地址：连江县凤城镇金安西路2号龙芝国际商业广场2层3店面（2-3-12号专柜）
连江县凤城镇晓静服装店	老板：陈先生	地址：连江县凤城镇安盛大厦二层65号店
连江县丹阳镇木玉电器店	老板：黄先生	地址：连江县丹阳镇丹蓼路口
连江县黄岐镇林东酸辣粉小吃店	老板：林先生	地址：连江县黄岐镇市场D座20号（现新城中路195号）
连江县丹阳镇林宝英小家电店	老板：林先生	地址：连江县丹阳镇丹蓼路口
连江县潘渡乡爱玉食杂店	老板：雷先生	地址：连江县潘渡乡溪利村溪利54号
连江县丹阳镇三中服务部	老板：曾先生	地址：连江县丹阳镇丹阳街坑口巷14号
连江县黄岐镇好滋味干果店	老板：胡先生	地址：连江县黄岐镇新城中路251号
连江县透堡镇廖礼娟服装店	老板：廖先生	地址：连江县透堡镇西门村下新村116号
连江县马鼻镇陈维凯铝合金加工店	老板：陈先生	地址：连江县马鼻镇横厝新村116号
连江县筱埕镇埕口村林国水食杂店	老板：林先生	地址：连江县筱埕镇埕口村西盛路30号
连江县马鼻镇滋味卤味店	老板：陈先生	地址：连江县马鼻镇横厝街194-1（马鼻市场旁）
连江县凤城镇旺佳兴建材店	老板：余先生	地址：连江县凤城镇文山北路7号金凤名都7#楼1、2店面
连江县凤城镇康亿家建材店	老板：余先生	地址：连江县凤城镇丹凤花园23座楼30号店
连江县?头镇惠好百姓医药?头店	老板：游先生	地址：连江县?头镇大众中路28号（金牛山广场）一期店
连江县坑园镇颜岐村忠喜农机配件店	老板：颜先生	地址：连江县坑园镇颜岐村灰厂旁
连江县凤城镇名品屋鞋店	老板：谢先生	地址：连江县凤城镇丹凤东路绿茵花园4#楼1号店面
连江县凤城镇瑞普钢材店	老板：吴先生	地址：连江县凤城镇玉山村工业小区104国道边拉丝厂1#楼102
连江县?头镇小雪日用品经营部	老板：吴先生	地址：连江县?头镇福星花园AB座103室
连江县东岱镇美丽佳芬美甲店	老板：林先生	地址：连江县东岱镇岱江中路112号
连江县马鼻镇学模家具城	联系人：陈先生	地址：连江县马鼻镇墙兜村林厝前（尚德中学下600米）
连江县凤城镇夫妻饭店	老板：林先生	地址：连江县凤城镇丹凤西路宏宇花园7#楼2号店
连江县马鼻镇银邃旅社	联系人：陈先生	地址：连江县马鼻镇横厝村横厝街228号
连江县东湖镇善武日用品咨询服务部	老板：黄先生	地址：连江县东湖镇祠台村宫兜35号
连江县马鼻镇裕隆吃鲜小吃店	老板：孙先生	地址：连江县马鼻镇合丰村下底厝12-1号
连江县凤城镇心缘花艺店	老板：刘先生	地址：连江县凤城镇凤翔帝景1#-3#楼32号店面
连江县丹阳镇陈记面馆	联系人：陈先生	地址：连江县丹阳镇丹枫路
连江县凤城镇喜蒂亚移门店	老板：黄先生	地址：连江县凤城镇龙华花园二期30#3号店
连江县凤城镇茶人之家茶庄	联系人：李先生	地址：连江县凤城镇816北路97号华星苑二层商场
连江县凤城镇三友新酒楼	联系人：刘先生	地址：连江县凤城镇文山北路8号龙华花园二期19#楼8号、9号店面
连江县凤城镇恩典自行车修理店	老板：林先生	地址：连江县凤城镇鲤鱼港湾6号楼4号店
连江县凤城镇彩居建材店	老板：林先生	地址：连江县凤城镇文山北路6号龙华花园13#楼1层7店面
连江县?头镇鑫旺厨具店	老板：朱先生	地址：连江县?头镇拱屿村青芝综合楼26号店面
连江县凤城镇樱爱宝宝乳品店	老板：苏先生	地址：连江县凤城镇玉荷东路金星综合楼一层内65店
连江县浦口镇源嘉小吃店	老板：孙先生	地址：连江县浦口镇锦山新村164号
连江县旭正水产商行	联系人：董先生	地址：连江县苔?镇后湾村滨海路
连江县连庆鲍鱼饵料销售店	老板：林先生	地址：连江县安凯乡同心村同心路18号
福建省亚瑞海洋工程有限公司	总经理：魏怀林	地址：连江县凤城镇马祖西路2号上一.日出东方4#楼406单元
福建南美投资有限公司	总经理：王先生	地址：连江县县城区鳌江路与丹凤路交叉口东南角玉沙综合商场第三层第一间（连江县白沙长冠第三产业服务中心）
福建省连江县久久芬芳饮食有限公司	总经理：邱美芬	地址：连江县县城区敖江路与丹凤路交叉口东南角玉沙综合商场
福州市贵安温泉实业有限公司	总经理：谢忆先生	地址：连江县潘渡乡贵安村贵洋路（福州贵安温泉会议中心有限公司内)
福建吉光贸易有限公司连江钣金加工厂	厂长：邱吉潮	地址：连江县经济开发区敖江园区青啤大道68号3#厂房
福建聿顺建设工程有限公司	总经理：黄燕峰	地址：连江县江南乡己古村文胜路3号
连江县黄岐镇海陆互助农业专业合作社	联系人：林禹先生	地址：连江县黄岐镇新城C座
连江县黄岐镇闽连渔油六一四七六号加油船	联系人：陈能?	地址：连江县黄岐镇长沙村北路53号（长沙村海域）
连江县盛新鲍鱼养殖专业合作社	联系人：陈功?	地址：连江县凤城镇莲荷东路32#楼505室
福建宴如家投资有限公司	总经理：陈露先生	地址：连江县凤城镇金安西路2号龙芝国际商业广场2层3店面
连江县友邦物业管理有限公司	总经理：陈少兵	地址：连江县凤城镇816西路凤江新村2#1前店
福州万星仓储有限公司	总经理：谢先生	地址：连江县江南乡南江滨西路1号华庆花园B区3#楼402单元
连江县地龙水泥管厂（普通合伙）	联系人：徐先生	地址：连江县敖江镇幕浦村西门铁路边
福州路畅洁建设工程有限公司	总经理：黄先生	地址：连江县凤城镇丹凤东路15号丹凤花园41#楼6号店面
连江县?头镇厚一基础设施建设服务中心	联系人：陈先生	地址：连江县?头镇后一村委会办公楼205室
福州筑成投资有限公司	总经理：倪先生	地址：连江县凤城镇文汇路3号凤翔名仕6#楼1层2、3店面
中连农业（福建）有限公司	总经理：黄先生	地址：连江县丹阳镇上周村村民委员会三层
连江县晓澳镇百胜官门岸农场	联系人：陈先生	地址：连江县晓澳镇百胜村关门岸关门山
连江县六九九广告传媒有限公司	总经理：林先生	地址：连江县凤城镇丹凤东路2号丹凤广场1#楼A座1层10店面
连江县凤城镇芳荣食品原料经营部	老板：杨惠芳	地址：中国 福建 福州市 连江县凤城镇北门路47号
刘筱帅（个人）	null	地址：中国 福建 福州市 福建省连江县凤城镇
福建省连江县海通水产有限公司	null	地址：中国 福建 福州市 福州连江县筱埕镇定海815路185号
周根华个体经营	null	地址：中国 福建 福州市 连江县馆头镇壶江村后街3号
陈勋（个体经营）	null	地址：中国 福建 福州市 福建省福州市连江县凤城镇816南路巨林商厦2#701
刘剑芸（个体经营）	null	地址：中国 福建 福州市 福州连江县凤城镇东北街和平路293号
连江县春妮贸易有限公司	null	地址：中国 福建 福州市 连江县莲荷西路9#606
陈风怡（个人）	null	地址：中国 福建 福州市 连江县东岱镇山堂村后街19号
连江光辉公司	null	地址：中国 福建 福州市 福建省连江县
个体营业网吧	null	地址：中国 福建 福州市 连江县江南乡江南村光明路5号
福州京广建筑节能材料有限公司	null	地址：中国 福建 福州市 福建省连江县?头镇东边西兴路88号
黄歧一九老鱼丸店	null	地址：中国 福建 福州市 福州连江县
漳州市水利电力工程公司	null	地址：中国 福建 福州市 连江县
坤宫水泥店	null	地址：福建省福州市连江县八一六北路１４８号
家忠食杂店	null	地址：福建省福州市连江县北门集贸市场
福州市重点工程物资开发总公司连江县分公司	总经理：阮灼太	地址：福建省福州市连江县凤城镇中山路７２号
黄宜祥食杂店	null	地址：福建省福州市连江县凤城八一六东路
福州省连江县建联第二经营部	null	地址：福建省福州市连江县凤城镇玉荷东路７７号
福州三株保健品有限公司连江公司	null	地址：福建省福州市连江县凤城镇（粮油公司综合楼２０４房）
福州琉球造酒有限公司	总经理：仲本盛次	地址：福建省福州市连江县江南乡南塘村
福州鹿鼎芬式房屋建造有限公司（工商已吊销）	联系人：工35	地址：福建省福州市连江县敖江镇青塘村综合场
福州金馨日用品有限公司	总经理：刘官福	地址：福建省福州市连江县敖江投资区
福州市东水企业集团金源高科技有限公司	null	地址：福建省福州市连江县东岱镇东水村
福州市连江县流动人口管理工作协调小组办公室	null	地址：福建省福州市连江县凤城镇西北街八一六北路县委大楼二
福州市连江利达农业综合养殖有限公司	null	地址：福建省福州市连江县潘渡朱步村
福州黄岐农业综合开发有限公司（工商已吊销）	联系人：黄赐贵	地址：福建省福州市连江县黄岐镇
福州贯捷机电有限公司连江分公司	总经理：孙韶涌	地址：福建省福州市连江县凤城镇八一六北路新村２号楼
福州恒顺鱼制品有限公司	null	地址：福建省福州市连江县苔录镇秀邦村
福州河汉路桥建设开发有限公司	总经理：王建斌	地址：福建省福州市连江县凤城镇玉荷西路建行大楼二层　　法定代表人：王建斌
福州港务管理局定海港务站	null	地址：福建省福州市连江县筱埕乡定海村
福州港发机电工业有限公司	成立日期：2003/11/14	地址：中国 福建 福州市 连江县敖江投资区青龙路
福州凤樱水产品开发有限公司（工商已吊销）	联系人：缪仁弟35	地址：福建省福州市连江县东岱镇
福州超浩水产加工有限公司	null	地址：福建省福州市连江县坑园乡下与村
福州搏达实业有限公司	总经理：郑祯佃	地址：福建省福州市连江县晓沃镇福兴北路２９９号
福连针织小百货	null	地址：福建省福州市连江县凤城八一六北路９８号
福江省连江县可门水产综合场	联系人：姚朝英	地址：福建省福州市连江县下宫乡可门村
福建兆亚生物工程有限公司	总经理：方晓丘	地址：福建省福州市连江县潘渡乡贵安村　　　　法定代表人：
福建省石油总公司福州公司苔录经营部	老板：陈永宁	地址：福建省福州市连江县苔录镇政府大院内
福建省筱埕东海渔农经营部	null	地址：福建省福州市连江县筱埕镇东坪村
福建省烟草公司连江县公司	总经理：林平祥	地址：福建省连江县凤城镇文明西路272号
百事食品（中国）有限公司福建连江项目处	联系人：许建飞	地址：福建省福州市连江县莲荷东路百凤小区
敖江玉贞水泥花格加工店	null	地址：福建省福州市连江县敖江魁岐村岐兴路１１号
敖江永新食杂店	null	地址：福建省福州市连江县敖江镇江南新村１６１号
敖江香珠食杂店	null	地址：福建省福州市连江县敖江乡南塘村
敖江文钦农机修配店	null	地址：福建省福州市连江县良种场门口
敖江静芳首布加工店	null	地址：福建省福州市连江县敖江镇凤尾村
敖江凤尾花园酒廊	null	地址：福建省福州市连江县环保局
敖江冬金水泥花格店	null	地址：福建省福州市连江县敖江已古文进路１５号
永盛电焊店	null	地址：福建省福州市连江县凤城镇文山路３９号
中华人民共和国黄岐渔港监督	null	地址：福建省福州市连江县黄岐镇
中华会计函授学校福州分校连江函授站	null	地址：福建省福州市连江县玉荷东路４７号财政局六层
中国人民解放军３２３６６部队司令部军务装备股	null	地址：福建省福州市连江县丹阳３２３６６部队
中国人民解放军３２３６６部队军人服务社	null	地址：福建省福州市连江县丹阳镇３２３６６部队
中国人民解放军３２３６６部队	null	地址：福建省福州市连江县丹阳镇３２３６６部队
中国人民解放军３２３６２部队军务装备股	null	地址：福建省福州市连江县东湖乡官地村
中国人民解放军３２３６２部队军人服务社	null	地址：福建省福州市连江县东湖镇官地
中国人民解放军３２３６２部队	null	地址：福建省福州市连江县东湖镇官地
中国人民解放军３２３６０部队一８２分队	null	地址：福建省福州市连江县丹阳镇山边村
中国人民解放军３２１６０部队８５分队	null	地址：福建省福州市连江县丹阳镇３２１６０部队８５分队
中国人民解放军３２８７７部队９９分队	null	地址：福建省福州市连江县丹阳镇朱山
中国人民解放军３２８７７部队９８分队	null	地址：福建省福州市连江县丹阳镇朱山
中国人民解放军３２８７７部队５７分队	null	地址：福建省福州市连江县丹阳镇朱山村
中国人民解放军３２８７７部队１１０分队	null	地址：福建省福州市连江县丹阳镇朱山
中国人民解放军３２８７７部队１００分队	null	地址：福建省福州市连江县丹阳镇朱山
中国人民解放军３７５０３部队９２分队	null	地址：福建省福州市连江县亭江长安
中国人民解放军３７８８部队３１分队	null	地址：福建省福州市连江县大帽山站
中国人民解放军３７８４５部队	null	地址：福建省福州市连江县苔录镇苔录村
中国人民解放军８７０７４部队６６分队	null	地址：福建省福州市连江县安海８７０７４部队６６分队
中国人民武装警察部队连江县中队	null	地址：福建省福州市连江县敖江镇小湾村
中国人民武装警察部队连江县边防大队	null	地址：福建省福州市连江县凤城镇东北街和平路１７号
中国人民解放军三二三六二部队服务中心	null	地址：福建省福州市连江县东湖官地
中国人民解放军三二三六０部队汽车营汽车二连	null	地址：福建省福州市连江县丹阳山边村
中国人民解放军三二三六０部队教导队	null	地址：福建省福州市连江县潘渡乡白莲
中国人民解放军三二八七七部队军人服务社	null	地址：福建省福州市连江县玉荷西路
中国人民解放军三二八七七部队	null	地址：福建省福州市连江县城关玉荷西路
中国人民保险公司连江县支公司筱埕乡保险站	null	地址：福建省福州市连江县筱埕镇
中国人民保险公司连江县支公司坑园乡保险站	null	地址：福建省福州市连江县坑园乡
中国人民保险公司连江县支公司黄岐镇代理站	null	地址：福建省福州市连江县黄岐镇
中国人民保险公司连江县支公司东岱镇保险站	null	地址：福建省福州市连江县东岱镇
中国人民保险公司连江县支公司	总经理：孙孝华	地址：福建省福州市连江县凤城镇八一六北路五十八号
中国福建省连江县国际经济技术合作公司	null	地址：福建省福州市连江县凤城镇金凤酒店一楼
郑香国食杂店	null	地址：福建省福州市连江县北岳停车场边
罗长高速公路连江段工作领导小组	联系人：滕忠华	地址：福建省福州市连江县城关816北路103号
罗长高速公路东湖段建设指挥部	老板：林贤清	地址：福建省福州市连江县东湖镇
美仙粮食复制品店	null	地址：福建省福州市连江县三建楼下１０２号
乃勇小百货帽店	null	地址：福建省福州市连江县凤城八一六北路７９号
凤尾秀月食杂店	null	地址：福建省福州市连江县凤尾停车场
凤城子宵面包加工店	null	地址：福建省福州市连江县粮油食品公司内
凤城忠义小吃店	null	地址：福建省福州市连江县北门市场
凤城珍珠小百店	null	地址：福建省福州市连江县凤城玉荷东路
凤城招奇食杂店	null	地址：福建省福州市连江县旧车站大楼门市部
凤城泽彭农机配件店	null	地址：福建省福州市连江县风城北岳综合楼北侧
凤城月珠帆布加工店	null	地址：福建省福州市连江县汽车修理厂店面
凤城玉芳日用杂品店	null	地址：福建省福州市连江县凤城台资大楼门市部
凤城永胜塑料管店	null	地址：福建省福州市连江县凤城莲荷西路６４号
凤城永华农机配件店	null	地址：福建省福州市连江县北岳停车场
凤城英英食杂店	null	地址：福建省福州市连江县敖江建筑公司门市部
凤城隐泰店	null	地址：福建省福州市连江县招待所隔壁
凤城益秀牌匾制作店	null	地址：福建省福州市连江县八一六东路２１号
凤城艺华美术工艺店	null	地址：福建省福州市连江县八一六南路３３号
福建省连江县对外经济贸易局	局长：陈继鹏	地址：福建省福州市连江县凤城镇八一六北路县府大楼
福建省连江县东日服务有限公司	null	地址：福建省福州市连江县凤城镇北门垦区综合楼
福建省连江县东洛海珍品养殖场	联系人：张细敢	地址：福建省福州市连江县苔录镇东洛村
福建省连江县东建水产品有限公司	null	地址：福建省福州市连江县筱埕镇筱埕村
福建省连江县东湖镇湖坪石料综合加工场	null	地址：福建省福州市连江县东湖镇湖坪村
福建省连江县东湖石油供应站	null	地址：福建省福州市连江县东湖镇山岗
福建省连江县东湖宏达养鳗公司	null	地址：福建省福州市连江县东湖镇东湖村
福建省连江县东岱鑫鼎养殖场	null	地址：福建省福州市连江县东岱镇
福建省连江县东岱螺旋藻养殖场	联系人：缪峰	地址：福建省福州市连江县东岱镇东岱街南门
福建省连江县东岱花岗岩制品有限公司	总经理：陈康举	地址：福建省福州市连江县东岱镇演宫路１号
福建省连江县东岱关头蒙恩养殖场	null	地址：福建省福州市连江县东岱镇关头村
福建省连江县东岱工业防腐安装有限公司	总经理：郑锦泉	地址：福建省福州市连江县东岱镇演宫路
福建省连江县东昌养殖场	null	地址：福建省福州市连江县东岱镇单步山腰里
福建省连江县定海湾石材开发有限公司	总经理：李依殿	地址：福建省福州市连江县筱埕镇筱埕村樟树湾路
福建省连江县定海海带加工厂	厂长：赵从雄	地址：福建省福州市连江县筱埕镇定海村西大路9号
福建省连江县电影录像发行站	站长：林建健	地址：福建省福州市连江县凤城镇八一六东路３２号
福建省连江县道沃花岗岩制品二厂	厂长：林澄先	地址：福建省福州市连江县晓沃镇道沃村
福建省连江县丹阳运输有限公司	总经理：许在述	地址：福建省福州市连江县丹阳镇经济委员会内
福建省连江县丹山草制品厂	null	地址：福建省福州市连江县丹阳镇山边村
福建省连江县大官坂综合养殖基地	联系人：王纬兴	地址：福建省福州市连江县坑园乡下园村
福建省连江县大官坂垦区总渠管理站	null	地址：福建省福州市连江县大官坂垦区管委会院内
福建省连江县大官坂垦区福州水技站实验场	联系人：余秀英	地址：福建省福州市连江县坑园乡大官坂垦区
福建省连江县初芦水产品经营部	null	地址：福建省福州市连江县下宫乡初芦村
福建省连江县骋安实业有限公司	总经理：吴凯熏	地址：福建省福州市连江县城关莲荷东路２号楼３层
福建省连江县城关西南街机械修配厂	null	地址：福建省福州市连江县城关西南街八一六西路６７号
福建省连江县常发贸易有限公司	null	地址：福建省福州市连江县潘渡乡潘渡街９３号
福建省连江县长汀果木开发有限公司	null	地址：福建省福州市连江县敖江镇长汀村
福建省连江县长龙运输服务有限公司	总经理：陈建荣	地址：福建省福州市连江县凤城镇８１６北路新村２号楼一层
福建省连江县长龙洋真石料场	null	地址：福建省福州市连江县长龙乡苏山村
福建省连江县长堤贸易有限公司	总经理：余秀彬	地址：福建省福州市连江县凤城镇莲荷东路１９号楼２０６室
福建省连江县便民服务公司	null	地址：福建省福州市连江县凤城镇玉荷西路新村１号楼１４号
福建省连江县编制委员会	联系人：郑希	地址：福建省福州市连江县政府大楼三层
福建省连江县北交海滨鱼业有限公司	null	地址：福建省福州市连江县台录镇北交村
福建省连江县百胜制冷配件厂	null	地址：福建省福州市连江县晓沃镇百胜村
福建省连江县百胜水产试验场	null	地址：福建省福州市连江县百胜村
福建省连江县百胜海味供销部	null	地址：福建省福州市连江县晓沃镇百胜村
福建省连江县敖江综合制品厂	null	地址：福建省福州市连江县敖江乡开发小区
福建省连江县敖江综合养殖场	null	地址：福建省福州市连江县敖江镇北岳村
福建省连江县敖江兴隆粮食复制厂	null	地址：福建省福州市连江县敖江镇幕浦村
福建省连江县敖江乡石头村经济合作社	联系人：刘德瑜	地址：福建省福州市连江县敖江镇石头村
福建省连江县敖江投资区经济开发有限公司	总经理：谢延光	地址：福建省福州市连江县凤城八一六北路５号楼202室
福建省连江县敖江投资区管理委员会	联系人：林金平	地址：福建省福州市连江县八一六北路５号楼２０２室
福建省连江县敖江幕浦石材制品厂	null	地址：福建省福州市连江县敖江镇幕浦十字路口
福建省连江县敖江九方艺术品厂	null	地址：福建省福州市连江县敖江镇浦下村
福建省连江县敖江花岗岩材料厂	厂长：林秋生	地址：福建省福州市连江县敖江花岗岩材料厂
福建省连江县敖江福来商行	null	地址：福建省福州市连江县凤城镇八一六北路１４３号
福建省连江县敖江岱云温泉堂	联系人：李美祥	地址：福建省福州市连江县敖江镇岱云村
福建省连江县敖北林产经营部	null	地址：福建省福州市连江县新车站边
福建省连江县安凯鑫海水产品精制厂	厂长：姚英	地址：福建省福州市连江县安凯奇达村
福建省连江县安凯水产品贸易货栈	null	地址：福建省福州市连江县安凯乡同心村
福建省连江县安凯鳗品经营部	null	地址：福建省福州市连江县安凯乡安凯村
福建省连江县安凯供销公司	总经理：高玉银	地址：福建省福州市连江县安凯乡
福建省连江县安凯高塘渔轮修造厂	厂长：林道发	地址：福建省福州市连江县安凯乡高塘村
福建省连江天原太空水厂	厂长：林宾	地址：福建省福州市连江县江南乡魁岐西城
福建省连江天都实业有限公司	总经理：邱同安	地址：福建省福州市连江县城关莲荷东路
福建省连江腾达实业有限公司	总经理：郑祯佃	地址：福建省福州市连江县晓沃镇福兴北路1号
福建省连江四通机电有限责任公司	null	地址：福建省福州市连江县玉荷西路４号楼第四间
福建省连江顺风贸易有限公司	总经理：邱同和	地址：福建省福州市连江县凤城镇８１６北路北岳大厦一层
福建省连江顺成水产制品有限责任公司	总经理：陈成武	地址：福建省福州市连江县晓沃镇新区
福建省连江盛丰贸易有限公司	null	地址：福建省福州市连江县凤城镇和平路１５号
福建省连江三原装饰装修工程有限公司	null	地址：福建省福州市连江县莲荷西路福来楼４０７
福建省连江三友实业有限公司	null	地址：福建省福州市连江县莲荷西路９２号
福建省连江三奇黄金珠宝首饰有限公司	总经理：张春沂	地址：福建省福州市连江县８１６南路４０号
福建省连江榕凤翔娱乐有限公司	null	地址：福建省福州市连江县安凯乡文湾村
福建省连江榕发海珍品养殖场	联系人：陈承财	地址：福建省福州市连江县马鼻镇玉井村扛屿岛
福建省连江平安塑胶工业有限公司	总经理：池平安	地址：福建省福州市连江县百胜下坪工业小区３号
福建省连江南方通信器材商行	null	地址：福建省福州市连江县凤城八一六中路６３号
福建省连江敏锐水产品开发有限公司	总经理：邱章团	地址：福建省福州市连江县筱埕镇筱埕村
福建省连江联威摩托车销售技术服务有限公司	总经理：魏增忠	地址：福建省福州市连江县莲荷东路９＃楼
福建省连江乐丰养殖有限公司	总经理：夏芳乐	地址：福建省福州市连江县坑园乡下屿村
福建省连江凯新海珍品养殖场	联系人：杨明玉	地址：福建省福州市连江县安凯乡同心村
福建省连江京闽菜篮开发有限公司	null	地址：福建省福州市连江县浦口镇松乌
福建省连江捷富贸易有限公司	总经理：林捷	地址：福建省福州市连江县凤城镇莲荷东路21号楼
福建省连江捷丰海　品养殖基地	联系人：黄爱祯	地址：福建省福州市连江县安凯乡奇达村
福建省连江环球石油贸易有限公司	总经理：林勇辉	地址：福建省福州市连江县丹阳镇板顶村
福建省连江宏建通讯工程有限公司	总经理：孙忠辉	地址：福建省福州市连江县侨联大厦７０４室
福建省连江红桃开营销有限公司	null	地址：福建省福州市连江县凤城８１６东路（电影公司五楼）
福建省连江恒龙经贸开发有限公司	总经理：魏增旺	地址：福建省福州市连江县凤城镇８１６北路
福建省连江海鸠塑胶制品有限责任公司	总经理：孙道福	地址：福建省福州市连江县晓沃镇百胜永晖路３号
福建连江县凤城镇昂泰产品专卖店	老板：龚平龙	地址：福建省福州市连江县凤尾村
福建华荣娱乐有限公司	总经理：林岚	地址：福建省福州市连江县凤城镇西郊
福建岱江集团工贸有限公司	null	地址：福建省福州市连江县东岱镇演宫路２号
福建北方贸易公司连江经营部	null	地址：福建省福州市连江县凤城镇玉荷东路台资大楼ＡD３
福建龙昌港口建设开发有限公司	总经理：陈祥霖	地址：可门港区（连江县下宫乡）
福春小百货	null	地址：福建省福州市连江县物资局边
云记首布加工店	null	地址：福建省福州市连江县茶叶公司楼下
下宫乡村主干退休〈离职〉养老基金会	联系人：游忠	地址：福建省福州市连江县下宫乡下宫村
武警福州市边防支队连江坑园副食品基地综合场	联系人：林顺元	地址：福建省福州市连江县坑园乡坑园村
连江县仁山金州柑桔场	null	地址：福建省福州市连江县潘渡乡仁山村
连江县人才服务中心	联系人：郑祖仲	地址：福建省福州市连江县凤城镇816北路政府大楼
连江县求天宝首布加工店	null	地址：福建省福州市连江县玉荷东路８号
连江县青芝乡讯联谊会	null	地址：福建省福州市连江县凤城镇八一六北路中旅社内
连江县勤工俭学管理站	null	地址：福建省福州市连江县教育局办公楼内
连江县前屿山海综合开发场	联系人：黄亨快	地址：福建省福州市连江县坑园乡前屿村
连江县奇达海产品综合加工厂	null	地址：福建省福州市连江县安凯乡奇达村
连江县浦口中心校教学楼筹建组	null	地址：福建省福州市连江县浦口镇中心小学
连江县浦口镇祖存加油店	老板：陈祖存	地址：连江县浦口镇官岭村下井口江边
连江县浦口镇增灿海鲜楼	联系人：叶增灿	地址：连江县浦口镇官岭村新公路边
连江县浦口镇退休干部管理委员会	null	地址：福建省福州市连江县浦口镇人民政府
连江县浦口镇台属联谊会	null	地址：福建省福州市连江县浦口镇政府院内
福建省连江县天一林业发展有限责任公司	总经理：陈福全	地址：福建省福州市连江县凤城镇江滨路景江花园７号楼６０３
福建西方财富酒店有限公司	总经理：吴为光	地址：福建省连江县凤城镇八一六北路１８号四楼
福建省世纪华奥投资有限公司	总经理：庄后崧	地址：福建省连江县潘渡乡贵安科技大楼
福州市海川投资有限公司	总经理：孙峥嵘	地址：连江县凤城镇西南街北门路2号
福建省华宏新型建材有限公司	总经理：陈依华	地址：连江县可门经济开发区（坑园镇坑园村溪尾路58号）
连江县鸿利水产养殖有限公司	总经理：林廷鸿	地址：连江县晓沃镇道澳村沿江路141号
连江县马鼻镇丰顺水产养殖场	联系人：郑锦尧	地址：连江县马鼻镇玉井村马头石
连江县希园绿色农业开发有限公司	总经理：谢丽珠	地址：连江县凤城镇西凤路6号1#一层
连江县?头农贸市场管理服务中心	联系人：杨依城	地址：福建省连江县?头镇８１６路中段北侧
连江县安盛百货有限公司	总经理：江洪涛	地址：连江县816中路安盛大厦三层东半部
福建凯三荣林业发展有限公司	总经理：胡新惠	地址：连江县凤城镇东北街玉荷东路12-158号（台资大楼D-3）
连江县元升房地产开发有限公司	总经理：林孟光	地址：连江县凤城镇莲荷东路30#楼1-3店面
连江县天湖生态农业发展有限公司	总经理：钟宝财	地址：连江县长龙镇真茹村三角洋8号
连江县安信汽车租赁有限公司	总经理：邵依明	地址：福建省连江县凤城镇凤园路３２７号天和城１幢２０１号
连江县长航金属废品回收有限责任公司	总经理：陈其良	地址：福建省福州市连江县潘渡乡坡西村（福建省航城钢铁不锈钢有限公司内）
连江县黄岐后仑养殖专业合作社	联系人：黄秀兰	地址：连江县黄岐镇后仑村西路15号
连江县黄岐山海水产养殖场（普通合伙）	联系人：林淑莺	地址：连江县黄岐镇海建街乌潭谷
连江县光发造纸厂（普通合伙）	联系人：李光发	地址：福州市连江县东岱镇关头村原农中
连江县凤城镇小天才幼儿园	联系人：陈玉华	地址：福建省福州市连江县凤城镇丹凤朝阳６号楼１层
连江县天明农业发展有限公司	总经理：陈坤天	地址：连江县筱埕镇东坪村岭下
连江县芳绿林业综合开发有限公司	总经理：方金渺	地址：连江县凤城镇丹凤西路1号温泉花园3号楼2层第12#间
连江县可门港开锐水泥制品厂	厂长：谢延进	地址：福州市连江县坑园镇象纬村沃仔黄土田
连江县丹阳民爆物品爆破服务队	队长：林铿妹	地址：福建省福州市连江县丹阳镇旺庄宝山
连江县长龙镇恒盛农场	联系人：孙琪清	地址：连江县长龙镇下洋村过岭水库后
连江县诚信物业管理有限公司	总经理：刘增星	地址：福建省连江县凤城镇北岳村白洋路４９号
福建新亨一新型建材有限公司	总经理：郑斌	地址：连江县可门经济开发区（管委会大院内）
福建省连江县兄弟一路发汽车租赁有限公司	总经理：罗善东	地址：连江县凤城镇丹凤路2号宏宇花园7#楼11店
福建省连江县西林林业工程有限责任公司	总经理：郑朝龙	地址：连江县凤城镇凤尾村黄家村34号
福建联圣投资有限公司物流分公司	总经理：肖良锋	地址：连江县坑园镇坑园村溪尾路58号
福建省连江县晓沃安顺水产综合养殖有限公司	总经理：邱吉团	地址：福建省福州市连江县晓澳镇晓锋街大园路５７号
福建省连江县志腾酒店有限公司	总经理：林志腾	地址：连江县凤城镇丹凤西路2号宏宇花园3号楼101室
福州万家有粮油食品有限公司	总经理：刘必雄	地址：连江县经济开发区（江南园区）
福建省连江县万里信息桥文化传播有限公司北门网点	联系人：杨贤新	地址：连江县凤城镇文明东路县工商局大门西侧1店
福州通行天下汽车租赁服务有限公司连江分公司	总经理：林友影	地址：连江县凤城镇丹凤东路丹凤花园4#楼14号店
永诚财产保险股份有限公司福建分公司连江营销服务部	老板：潘启润	地址：连江县凤城镇小湾村口（旧水果市场一楼左起第三、四间店面）
福建新龙芝房地产开发有限公司	总经理：高芝彬	地址：连江县凤城镇丹凤东路15号丹凤花园19-21#7店
深圳市银典物业管理服务有限责任公司连江分公司	总经理：王守坤	地址：福建省福州市连江县文山北路５号新天地会所二层
连江县安力机械工程有限公司	总经理：滕风财	地址：福建省福州市连江县坑园镇颜岐村
福建省连江县顺德海产食品有限公司	总经理：陈德官	地址：福建省福州市连江县敖江上山村前进路１号
连江县黄岐民爆物品爆破服务队	队长：胡尚江	地址：福建省福州市连江县黄岐镇丰明路１号
连江县盛丰农场	联系人：谢首敏	地址：福建省福州市连江县长龙镇?祠村
连江县蓼沿民爆物品爆破服务队	队长：郑香?	地址：福建省福州市连江县蓼沿乡岐山村井里
连江县博林包装有限公司	总经理：许小平	地址：福建省福州市连江县?头镇东边村鲜绿农业综合农场内
福建省连江县晓澳林安蛏蛤养殖有限公司	总经理：陈学林	地址：福建省福州市连江县晓沃镇百胜村澳头２０２号
福州金沙澳旅游开发有限公司	总经理：陈大华	地址：福建省福州市连江县安凯乡沙澳村沙澳路２８号
连江县安凯同心石料场	联系人：陈能锐	地址：福建省福州市连江县安凯乡同心村
连江县坑园民爆物品爆破服务队	队长：林爱茂	地址：福建省福州市连江县坑园红厦村岭里
连江县蓝领职业培训中心	联系人：林统杨	地址：福建省福州市连江县凤城镇西渠路２号
连江县环卫保洁有限公司	总经理：刘华	地址：福建省福州市连江县凤城镇玉荷东路６１号
连江县东湖镇欢欢幼儿园	联系人：吴金瑞	地址：福建省福州市连江县东湖镇东塘村后街
连江县东湖镇东塘村欢欢幼儿园	联系人：吴金瑞	地址：福建省福州市连江县东湖镇东塘村后街
福州台隆雨具制品有限公司	总经理：高增祥	地址：福建省福州市连江县东岱镇关头工业区
福州今日食品有限公司	总经理：陈义方	地址：福建省连江县筱埕镇大埕村
连江县金龙不锈钢制品有限公司	总经理：吴兴崧	地址：福建省福州市连江县透堡镇南街村下新村
连江县良锦食品有限公司	总经理：潘孝典	地址：福建省福州市连江县?头镇１０４国道旁东川花园综合楼９店
连江县天兴网吧	联系人：林坤	地址：福建省福州市连江县浦口镇浦东居浦东路４号
连江县御米食品有限公司	总经理：翁传银	地址：福建省福州市连江县浦口镇外厝粮食仓库
连江成长鞋材有限公司	总经理：杨官玉钗	地址：福建省福州市连江县敖江投资区青龙路南侧１号厂房
福州宏超食品有限公司	总经理：池要超	地址：福建省福州市连江县敖江投资区
连江县昱源食品有限公司	总经理：林积惠	地址：福建省福州市连江县坑园乡屿头村
佳客来（连江）餐厅	联系人：潘小文	地址：福建省福州市连江县凤城镇８１６中路４２号二层
福建省连江县大洋食品有限公司	总经理：黄良钢	地址：福建省福州市连江县下宫乡下宫村新区
福州统大和冷冻食品有限公司	总经理：邱金波	地址：福建省连江县筱埕镇大埕村陈伯公（大埕村避风港上方）
连江富闽房地产开发有限公司	总经理：季欣华	地址：福建省福州市连江县贵安村温泉游泳基地
福建省金星建材有限公司	总经理：叶仁航	地址：福建省福州市连江县经济开发区敖江园区新连黄路南侧（连江官巷变电站对面）
福建省连江县恒利房地产开发有限公司	总经理：肖建平	地址：福建省福州市连江县筱埕镇筱埕村民委员会内
福建省连江县东方文化传媒有限公司	总经理：郑成乐	地址：福建省福州市连江县?头镇拱屿村蓉侨楼１１６号
连江县青芝山房地产开发有限公司	总经理：金秀峰	地址：福建省福州市连江县?头镇上坪村上坪路３４号
福建省龙芝房地产开发有限公司连江分公司	总经理：高芝彬	地址：福建省福州市连江县凤城镇丹凤东路１８号永得利花园１＃楼８＃号店
福建省龙芝建筑工程有限公司连江分公司	总经理：陈信乐	地址：福建省福州市连江县凤城镇丹凤东路１８号永得利花园１＃楼８＃号店
福州百度广告有限公司	总经理：刘景红	地址：福建省福州市连江县丹凤东路２号楼Ｂ座４０２室
福州龙威茶业有限公司	总经理：陈碧林	地址：福建省福州市连江县东湖岭顶青桥头
连江县玉沙建材有限公司	总经理：徐祚桂	地址：福建省福州市连江县敖江镇白沙村西北路６２９号
连江县荣达新型建材有限公司	总经理：刘昌荣	地址：福建省福州市连江县敖江镇下山垄
连江水产品加工基地建设发展有限公司	总经理：张怀潮	地址：福建省福州市连江县晓沃镇赤湾村
连江县道澳鸿发水产养殖场	联系人：林廷鸿	地址：福建省福州市连江县道沃村海滩
凤城文山路木材经营店	null	地址：福建省福州市连江县文山路１４号
福建省石油公司连江支公司青塘油库	null	地址：福建省福州市连江县敖江镇经委办公室
福建移动通信有限责任公司连江分公司	总经理：蔡建扬	地址：福建省福州市连江县凤城镇北门街８１６北路１６号楼１－３店负责人：蔡建扬
连江县凤城文平钢材经营店	null	地址：福建省福州市连江县凤城八一六北路汽车站１０４国道边
福建省尤溪石油支公司北交经营部	null	地址：福建省福州市连江县苔录镇北茭村过屿岛
福建省连江县电视转播台	null	地址：福建省福州市连江县敖江镇兰田村仓尾山
福建省连江县华美石油有限公司	null	地址：福建省福州市连江县苔录镇北交
连江县医药公司马鼻医药批发部	null	地址：福建省福州市连江县马鼻镇横厝村
福建省连江飞达茶叶有限公司	null	地址：福建省福州市连江县丹阳镇丹凤花园小区
福建省连江南方茶叶有限公司	null	地址：福建省福州市连江县敖江镇北岳贰路５３号
福建省连江县凤城腾达烟酒经营部	null	地址：福建省福州市连江县城关镇八一六北路１４７号
福建省连江县农垦茶叶贸易有限公司	null	地址：福建省福州市连江县丹阳镇朱山
连江县物资再生利用公司	null	地址：福建省福州市连江县凤城镇八一六北路９７号
连江县金属材料公司	null	地址：福建省福州市连江县凤城镇８１６北路９７号
福州禾鑫五金有限公司	null	地址：福建省福州市连江县凤城镇８１６西路１９３号
福建省连江县厦宫水产购销站	null	地址：福建省福州市连江县厦宫乡厦宫村
北门瓷砖店	null	地址：福建省福州市连江县凤城镇北门劳动就业培训中心楼第二
凤城学秋瓷砖店	null	地址：福建省福州市连江县八一六北路９３号
连江县马鼻友谊木材经营部	null	地址：福建省福州市连江县马鼻镇浮唏村
凤城莲荷木材经营部	null	地址：福建省福州市连江县凤城镇莲荷西路
连江县凤城文山木材经营店	null	地址：福建省福州市连江县凤城文山路２号
凤城依和木材经营店	null	地址：福建省福州市连江县凤城镇文山路１２号
福建省连江县第一粮食购销有限公司	总经理：陈济成	地址：福建省福州市连江县凤城镇８１６西路３号
福建省连江县东岳镇粮油经营部	null	地址：福建省福州市连江县东岳镇蝉步村
中共连江县蓼沿乡纪律检查委员会	null	地址：福建省福州市连江县蓼沿乡人民政府院内
中国金融工会连江县委员会	联系人：周惠钦	地址：福建省福州市连江县凤城镇莲荷东路白沙桥３号楼
中共连江县委宣传部	老板：邱吉明	地址：福建省福州市连江县中共连江县委机关院内
连江县小沧畲族乡人民政府	联系人：兰章禧	地址：福建省福州市连江县小沧畲族乡
连江县国家税务局丹阳税务所	null	地址：福建省福州市连江县丹阳镇
连江县国家税务局禾查分局	null	地址：福建省福州市连江县八一六北路１５２号
连江县凤城镇人民代表大会主席团	null	地址：福建省福州市连江县凤城镇经济巷３１号
福建省连江县统计局	局长：方钦平	地址：福建省福州市连江县八一六北路81号(县政府大楼)
连江县人民代表大会常务委员会	null	地址：福建省福州市连江县凤城镇八一六北路县委大院
连江县税务局浦口税务所	null	地址：福建省福州市连江县浦口镇
中共连江县浦口镇纪律检查委员会	null	地址：福建省福州市连江县浦口镇人民政府院内
连江县地方税务局晓沃税务所	null	地址：福建省福州市连江县晓沃镇
连江县浦口学区工会委员会	null	地址：福建省福州市连江县浦口街
中国共产党连江县透堡镇委员会	联系人：黄康兴	地址：福建省福州市连江县透堡镇北街村
连江县人事局人才服务中心	null	地址：福建省福州市连江县凤城镇八一六北路政府大楼
连江县土地局机关工会委员会	null	地址：福建省福州市连江县城关凤尾花园凤园路
连江县卫生系统工会委员会	联系人：陈能光	地址：福建省福州市连江县凤城镇八一六北路８１号
连江县浦口镇工会联合会	联系人：刘永土	地址：福建省福州市连江县浦口镇镇政府
连江县地方税务局稽查分局	null	地址：福建省福州市连江县凤城
连江县东水学校工会委员会	null	地址：福建省福州市连江县东岱镇东水村
福建省连江县人事局	null	地址：福建省福州市连江县凤城镇八一六北路政府大院
连江县总工会	null	地址：福建省福州市连江县凤城镇建国路２３号
连江县蓼沿乡机关工会委员会	null	地址：福建省福州市连江县蓼沿乡蓼沿村
连江县丹阳学区工会委员会	null	地址：福建省福州市连江县丹阳镇新街２号
连江县东岱学区工会委员会	null	地址：福建省福州市连江县东岱镇
中共连江县台湾工作部	null	地址：福建省福州市连江县凤城镇八一六北路县委大楼
中共连江县凤城镇纪律检查委员会	null	地址：福建省福州市连江县凤城镇经济巷３１号
中国共产党连江县浦口镇委员会	联系人：郭昌水	地址：福建省福州市连江县浦口镇人民政府院内
中国共产党连江县透堡镇纪律检查	联系人：黄康兴	地址：福建省福州市连江县透堡镇北街村
中共连江县委老干部局	null	地址：福建省福州市连江县县政府大楼
中国共产党连江县蓼沿乡委员会	null	地址：福建省福州市连江县蓼沿乡人民政府院内
连江县税务局东岱税务所	null	地址：福建省福州市连江县东岱镇
连江县司法局	null	地址：福建省福州市连江县凤城八一六北路５６号
连江县敖江镇科学技术委员会	null	地址：福建省福州市连江县敖江县政府大楼
连江县马鼻镇财政所	所长：张金潮	地址：福建省福州市连江县马鼻镇横厝村
连江县马鼻镇计划生育办公室	null	地址：福建省福州市连江县马鼻镇政府院内
连江县透堡镇人民政府	联系人：林伦健	地址：福建省福州市连江县透堡北街村
福建省连江县审计局	局长：林英灯	地址：福建省福州市连江县凤城镇八一六北路81号
连江县国家税务局簧岐税务所	null	地址：福建省福州市连江县簧岐镇
连江县人民政府	联系人：黄连生	地址：福建省福州市连江县凤城镇八一六北路８１号
连江县安凯乡人民政府	联系人：张建国际性	地址：福建省福州市连江县安凯村
连江县税务局丹阳税务所	null	地址：福建省福州市连江县丹阳镇
连江县税务局潘渡税务所	null	地址：福建省福州市连江县潘渡乡
连江县税务局筱埕税务所	null	地址：福建省福州市连江县筱埕镇
连江县税务局晓沃税务所	null	地址：福建省福州市连江县晓沃镇
连江县税务局马鼻税务所	null	地址：福建省福州市连江县马鼻镇
连江县税务局坑园税务所	null	地址：福建省福州市连江县坑园乡
福建省连江县地方税务局	局长：邱吉光	地址：福建省福州市连江县凤城镇八一六北路１１号
连江县马鼻镇人民政府	联系人：邱 峰	地址：福建省福州市连江县马鼻镇横厝街
连江县国家税务局黄岐税务所安凯驻征组	null	地址：福建省福州市连江县安凯镇安海村
连江县税务局苔 税务所	null	地址：福建省福州市连江县苔?镇
连江县地方税务局浦口税务所	null	地址：福建省福州市连江县浦口街
连江县税务局?头税务所	null	地址：福建省福州市连江县?头镇
连江县税务局东湖税务所	null	地址：福建省福州市连江县东湖镇
连江县国家税务局晓沃税务所	null	地址：福建省福州市连江县晓沃镇
连江县国家税务局浦口税务所	null	地址：福建省福州市连江县浦口镇
连江县人民政府防汛抗旱指挥部	null	地址：福建省福州市连江县凤城镇文明东路３７号
连江县透堡镇财政所	所长：林伦健	地址：福建省福州市连江县透堡镇北街村
连江县地方税务局安凯税务所	所长：连善明	地址：福建省福州市连江县安凯乡安海村安峰路６１号
连江县税务局黄岐税务所	null	地址：福建省福州市连江县黄岐镇
连江县地方税务局丹阳税务所	null	地址：福建省福州市连江县丹阳镇
连江县丹阳镇村镇规划建设管理站	站长：陈子杰	地址：福建省福州市连江县丹阳镇政府大院
连江县法院经济庭	null	地址：福建省福州市连江县凤城和平路２１号
连江县江南乡村镇规划建设管理站	站长：李明	地址：福建省福州市连江县江南乡人民政府院内
连江县林业局江南乡林业站	站长：吴剑钊	地址：福建省福州市连江县江南乡林业站
连江县蓼沿乡村镇规划建设管理站	站长：林忠	地址：福建省福州市连江县蓼沿乡政府大院
连江县丹阳镇林业站	站长：周高顺	地址：福建省福州市连江县丹阳镇人民政府
连江县工商行政管理局潘渡工商所	null	地址：福建省福州市连江县潘渡乡
连江县林业局东湖镇林业站	站长：吴剑锋	地址：福建省福州市连江县东湖镇人民政府
连江县林业局	局长：林成竹	地址：福建省福州市连江县新民路２４号
连江县林业局东岱镇林业站	站长：洪为亮	地址：福建省福州市连江县东岱镇政府院内
连江县林业局蓼沿乡林业站	站长：吴少锋	地址：福建省福州市连江县蓼沿乡人民政府
国家海洋局东海分局北交海洋站	null	地址：福建省福州市连江县苔录镇北交村
连江县马鼻镇经济委员会	null	地址：福建省福州市连江县马鼻镇横厝街
连江县筱埕镇村镇规划建设管理站	站长：庄桂武	地址：福建省福州市连江县筱埕镇政府大院
连江县晓沃镇计划生育办公室	null	地址：福建省福州市连江县晓沃镇晓丰街庆丰路６号
连江县透堡镇计划生育办公室	联系人：林伦健	地址：福建省福州市连江县透堡镇北街村
连江县凤城镇计划生育办公室	联系人：薛耿	地址：福建省福州市连江县凤城镇经济巷３１号
连江县丹阳镇计划生育办公室	null	地址：福建省福州市连江县丹阳镇人民政府院内
连江县筱埕镇计划生育办公室	null	地址：福建省福州市连江县筱埕镇筱埕村龙舟路
连江县干部职工教育办公室	null	地址：福建省福州市连江县凤城镇八一六北路８１号政府大楼
连江县浦口镇计划生育办公室	null	地址：福建省福州市连江县浦口镇人民政府院内
中国人民政治协商会议福建省连江县委员会	联系人：张天金	地址：福建省福州市连江县凤城镇八一六北路县委大院
连江县黄岐镇计划生育办公室	null	地址：福建省福州市连江县黄岐镇人民政府院内
连江县长龙镇村镇规划建设管理站	站长：王理宇	地址：福建省福州市连江县长龙镇政府院内
福建省连江县潘渡乡计划生育办公室	联系人：赖森兴	地址：福建省福州市连江县潘渡乡政府内
连江县体育局	局长：黄云平	地址：福建省福州市连江县凤城镇陈第公园内
福建省连江县教育局	局长：张广霖	地址：福建省福州市连江县凤城镇玉荷西路
福建省连江县广播电视局	null	地址：福建省福州市连江县凤城镇八一六北路５２号
连江县　头镇计划生育办公室	null	地址：福建省福州市连江县?头镇连江路１号
连江县教育局机关工会	null	地址：福建省福州市连江县教育局办公室
连江县坑园乡计划生育办公室	联系人：林前利	地址：福建省福州市连江县坑园乡人民政府院内
连江县建设局系统职工技术协会	null	地址：福建省福州市连江县凤城镇文明路１５号
连江县工商行政管理局凤城工商所	所长：邱友诚	地址：福建省福州市连江县北门市场内
连江县苔录镇经济委员会	null	地址：福建省福州市连江县苔录镇人民政府院内
连江县农业局	局长：刘德贵	地址：福建省福州市连江县凤城镇百凤小区
连江县小沧畲族乡财政所	所长：钟民强	地址：福建省福州市连江县小沧畲族乡
连江县东湖镇村镇规划建设管理站	站长：邱章斌	地址：福建省福州市连江县东湖镇政府大院
连江县坑园乡村镇规划建设管理站	站长：陈济发	地址：福建省福州市连江县坑园乡政府院内
连江县科学技术局	局长：陈仁坚	地址：福建省福州市连江县县政府大楼五楼
