福建诚付天下金融技术服务有限公司福州连江分公司	总经理：林	地址：连江县凤城镇玉山小区104国道西侧1#楼101单元
福建省京舜建设工程有限公司连江分公司	总经理：陈	地址：连江县凤城镇816中路安盛大厦2#楼605
连江县菊红农业综合场	联系人：陈	地址：福建省福州市连江县长龙镇下洋村新建路115号
福州市闽诚家政服务有限公司连江分公司	总经理：范	地址：连江县凤城镇龙华花园二期19号楼4号店面
连江县丹阳镇法增铝合金铁门加工厂	厂长：陈	地址：福州市连江县丹阳镇山兜村长园坪
连江县蓼沿乡宝磊石料场	联系人：黄	地址：福州市连江县蓼沿乡溪东村单兜岗
连江县诚信天商务咨询服务有限公司	总经理：罗	地址：福建省福州市连江县凤城镇丹凤西路2号宏宇花园14#-16#14号店
连江县丹阳镇荣盛石材厂	厂长：黄	地址：福建省福州市连江县丹阳镇花园村
连江县旺居房产代理有限公司	总经理：黄	地址：福建省福州市连江县凤城镇北门街凤园路凤尾花园3#楼11店
福建佳创置业有限公司	总经理：林	地址：福建省福州市连江县凤城镇江滨西路3号江夏苑1#－4#楼二层33店面
福州财缘城投资有限公司	总经理：邵	地址：福建省福州市连江县凤城镇文山北路5号太一新天地1#楼7店面
福建华兰里农业综合开发有限公司	总经理：邱	地址：福建省福州市连江县马鼻镇贵峰村渔池墩路1号
福建瑞玻玻璃有限公司	总经理：陈	地址：福建省福州市连江县可门经济开发区坑园村溪尾路58号
福建省万坤建设工程有限公司	总经理：黄	地址：连江县凤城镇丹凤东路14号绿茵花园5#楼4层401单元
福州励志房地产开发有限公司	总经理：邱	地址：福建省福州市连江县安凯乡高塘村高塘路102号
连江县创宏建材有限公司	总经理：王	地址：福建省福州市连江县凤城镇国优路8号鲤鱼港湾5#楼11层1102单元
连江众安投资有限公司	总经理：王	地址：福建省福州市连江县马鼻镇横厝村红石12-2号
连江县泓帆渔业有限公司	总经理：刘	地址：连江县苔?镇茭南村宏图路43号
连江县兴丰服饰有限公司	总经理：庄	地址：连江县凤城镇丹凤东路15号丹凤花园44#楼13店面
连江县浦口镇山海经农业专业合作社	联系人：林	地址：连江县浦口镇中麻村里澳269号
福建省上善星电缆有限公司	总经理：林	地址：连江县经济开发区敖江工业园区1#楼福建世纪电缆有限公司内
福州市金汇通投资咨询有限公司	总经理：林	地址：连江县凤城镇丹凤东路7号迪鑫花园6#1号店
福州市日志环保科技有限公司	总经理：林	地址：福建省福州市连江县凤城镇莲荷东路25#楼B座3车库
福州市恩佑再生资源有限公司	总经理：王	地址：福建省福州市连江县坑园镇下元村前进路29号
连江县黄岐镇郑秀敏渔需制品厂	厂长：郑	地址：福建省福州市连江县黄岐镇大建村建强路码头边
连江县金莎水产养殖有限公司	总经理：汪	地址：福建省福州市连江县黄岐镇后仑村西路23号
福建泰龙源农业开发有限公司	总经理：黄	地址：福州市连江县透堡镇馆读村门前埕D9号2户
福建省鸿翔广告工程有限公司	总经理：林	地址：连江县凤城镇莲荷东路18#A2号店
连江县庆源燃料油贸易有限公司	总经理：占	地址：福建省福州市连江县浦口镇中麻村
福州源鑫盛源实业有限公司	总经理：林	地址：福建省福州市连江县可门开发区管委会坑园镇坑园村溪尾路58号
福建省连江县西山顶综合农场（普通合伙）	联系人：林	地址：福建省福州市连江县蓼沿乡利畲村西山自然村
中国移动通信集团福建有限公司连江商专营业厅	联系人：陈	地址：连江县潘渡村福建商业高等专科学校新校区商业街
福州盛龙塑胶有限公司牡丹洋分公司	总经理：潘	地址：连江县蓼沿乡定田村牡丹洋垅头厝山地
连江县丹阳镇顶尚丽盾工艺石加工厂	厂长：雷	地址：福州市连江县丹阳镇新洋村
连江县玉平养兔场	联系人：刘	地址：福建省福州市连江县江南乡澄岩村
连江县苔?旺角酒厂	厂长：林	地址：福建省福州市连江县苔?镇苔?村后港1#、2#、3#D6#
福建省假日国际旅行社有限公司连江?头营业部	老板：倪	地址：福建省福州市连江县?头镇街道团结路11号
福建省鑫恒投资有限公司	总经理：韩	地址：连江县凤城镇金安西路2号龙芝国际商业广场1层5店面
福建省生久担保有限公司	总经理：陈	地址：福建省福州市连江县凤城镇丹凤西路2号宏宇花园14-16#14号店
连江县鑫瑞咨询服务有限公司	总经理：谢	地址：连江县凤城镇丹凤东路15号丹凤花园43#楼14店面
福州良特贸易有限公司	总经理：吴	地址：福建省福州市连江县?头镇开放路东侧宏源新苑4#楼503室
福州市超浪养殖有限公司	总经理：林	地址：福建省福州市连江县坑园镇屿头村富新路4号
连江县凤城镇依宝药店	老板：谢	地址：福建省福州市连江县凤城镇丹凤东路15号丹凤花园2#楼6-9号店
福建省新马会旅游开发有限公司	总经理：李	地址：福建省福州市连江县潘渡乡贵安村科技大楼305室
连江县坑园镇颜岐富珍水产品经营部	老板：颜	地址：福建省福州市连江县坑园镇颜岐村新民南路94号
福建连江宏大建筑工程有限公司	总经理：姚	地址：连江县下宫乡厦一村一条山脚
连江县九源燃料油有限公司	总经理：林	地址：福建省福州市连江县?头镇下岐村113号
福建宜联管业有限公司	总经理：林	地址：连江县敖江镇青塘村工业园区1#厂房
福州市宏日建筑劳务有限公司	总经理：杨	地址：福建省福州市连江县凤城镇江滨路景江花园二期D型E12一层
连江县坑园镇光辉海产品厂	厂长：颜	地址：福建省福州市连江县坑园镇颜岐村新民南路礼堂边
福州盛运物流有限公司	总经理：赵	地址：连江县沈海高速公路与文笔东路交叉口东北角
连江县长龙镇龙发农民专业合作社	联系人：陈	地址：福建省福州市连江县长龙镇建庄村后门洋
连江县凤城镇我家聚餐园玉荷分店	老板：林	地址：福建省福州市连江县凤城镇玉荷西路（原西餐厅）2#楼9号店、10号店
神州坤元（福建）建设工程有限公司	总经理：郑	地址：福建省福州市连江县凤城镇816东路109号六层
连江县坑园镇颜岐村广隆超市	联系人：颜	地址：福建省福州市连江县坑园镇颜岐村大兴东路310号
福州市金石馆工艺品有限公司	总经理：王	地址：福建省福州市连江县凤城镇丹凤东路3-460号9#楼1层112号店
兴锋盈（福建）集团有限公司连江分公司	总经理：官	地址：连江县潘渡乡贵安村后垄仔责任田
福建康佰家大药房连锁有限公司一二二店	老板：严	地址：连江县?头镇上坪路18号鑫立大厦第一层店面
连江县渔港旅游开发有限公司	总经理：谢	地址：福建省福州市连江县苔?镇秀邦村北沃五路二扇一直
连江县好帮手家庭服务有限公司	总经理：范	地址：连江县凤城镇金凤名都10#楼1层7号店面
连江县华商翼企业管理有限公司	总经理：林	地址：福建省福州市连江县凤城镇816南路巨林商厦1#楼1-19号店面
福建省得力宝五金工具有限公司	总经理：王	地址：连江县?头镇东边村连港路北侧3#1层
连江县马鼻镇金石石材加工厂	厂长：陈	地址：福建省福州市连江县马鼻镇车站西侧
福建金沙岛投资有限公司	总经理：林	地址：连江县凤城镇华光西路2号凤凰城10#楼1店面
福建中汇典当有限公司	总经理：高	地址：福建省福州市连江县贵安新天地贵锦苑商业1号楼21店
连江县晓澳镇金山禽畜养殖场	联系人：林	地址：连江县晓澳镇道澳村二坪山南面
福州千穗农业开发有限公司	总经理：陈	地址：福建省福州市连江县透堡镇西门村西门街14号3户
福建晟鑫建设工程有限公司连江分公司	总经理：陈	地址：福建省福州市连江县凤城镇东北街816东路109号二层
连江县鱼奇海产品有限公司	总经理：王	地址：福建省福州市连江县凤城镇丹凤东路2号丹凤广场1#楼B座801
福州兴鑫旺贸易有限公司	总经理：陈	地址：连江县马鼻镇半田下村溪边区50号
福州百味食品有限公司连江分公司	总经理：陈	地址：连江县经济开发区东湖园区3#厂房一楼
承洁环保有限公司	总经理：陈	地址：连江县江南乡江南社区居委会307房
福州群龙兴贸易有限公司	总经理：欧	地址：连江县?头镇天麟明珠城7座404号
连江县顺鑫汽车租赁有限公司	总经理：李	地址：连江县凤城镇江滨东路18号景江花园二期D型23号店面
迪凯塑料制品有限公司	总经理：陈	地址：连江县丹阳镇虎山村连江县丹阳造纸厂一层
连江县华源建材贸易有限公司	总经理：陈	地址：福州市连江县凤城镇文山北路5号太一新天地12#楼8层811单元
福州市旺林升汽车租赁有限公司	总经理：林	地址：福州市连江县丹阳镇104国道右侧12号住宅楼4号店面
福州市车迷城汽车服务有限责任公司	总经理：陈	地址：福州市连江县敖江投资区上高速路北侧、敖江路东侧8#标准厂房
福州海中水产有限公司	总经理：陈	地址：连江县马鼻镇玉井村二房里112号
福州创域装饰工程有限公司	总经理：林	地址：福建省福州市连江县凤城镇文山北路5号太一新天地1#楼14店面
福州丰畅购物中心有限公司	总经理：张	地址：连江县潘渡乡贵安村科技大楼
高明实业（福建）有限公司	总经理：赖	地址：连江县凤城镇文明东路1号
连江县卓创企业管理咨询有限公司	总经理：林	地址：福建省福州市连江县凤城镇文笔路6号凤翔国际二区17#楼1层20店面
连江县盛平企业管理咨询有限公司	总经理：张	地址：连江县凤城镇玉荷东路（台资大楼边）1#104
连江县雅顺广告工程有限公司凤城分公司	总经理：陈	地址：福建省福州市连江县凤城镇文山北路6号龙华花园3#楼1层3店面
福建省连江县世长水产养殖场	联系人：赵	地址：福建省福州市连江县筱埕镇定海村鲍鱼海区第一区
福建省连江县乾元水产品贸易有限公司	总经理：刘	地址：福建省福州市连江县苔?镇后湾村海滨路5号
福建连江恒欣村镇银行股份有限公司?头支行	联系人：陈	地址：福建省福州市连江县?头镇拱屿村开放路东川花园B#B单元
福建中永建设工程有限公司连江分公司	总经理：陈	地址：福建省福州市连江县凤城镇文山北路6号龙华花园16#楼2层202单元
福建兴坤达钢结构工程有限公司	总经理：陈	地址：福建省福州市连江县敖江镇浦下村原荷山造纸厂
福建永恒兴投资有限公司	总经理：陈	地址：福建省福州市连江县凤城镇文山北路6号龙华花园商业用房1层4店面
福建省连江县黄岐枝达海洋渔具制造厂	厂长：林	地址：福建省福州市连江县黄岐镇海建街畚箕山
福建省大众农业综合开发有限公司	总经理：黄	地址：福建省福州市连江县蓼沿乡定田村下岩路92号
福建省同友房地产开发有限公司	总经理：唐	地址：福建省福州市连江县凤城镇丹凤西路2号宏宇花园14-16#楼14号店
中国人寿保险股份有限公司连江县支公司第十营销服务部	老板：李	地址：福建省福州市连江县?头镇劳动路100号二层
福建聚磊建材有限公司	总经理：袁	地址：福建省福州市连江县江南乡境路村垅里工业区3号
福建宫福水产进出口有限公司	总经理：卓	地址：连江县晓沃镇道沃村1#楼
连江县东岱镇靓装建材店	老板：林	地址：连江县东岱镇东岱街邮电局对面
连江县北茭富源渔业有限公司	总经理：林	地址：福建省福州市连江县苔?镇北茭村吴城面14号
连江县大宇贸易有限公司	总经理：周	地址：福建省福州市连江县?头镇兰田村1#1层101室
福建源榕交通工程有限公司	总经理：林	地址：连江县经济开发区东湖园区福建富得巴机电实业有限公司内4号楼车间
连江县进翔水产有限公司	总经理：许	地址：连江县凤城镇玉山村观音阁2#3层
福建省连江冠羽房地产开发有限公司	总经理：倪	地址：连江县凤城镇江滨路景江花园二期F2一层
福州中通汇银投资管理有限公司	总经理：陈	地址：福建省福州市连江县贵安旅游区科技大楼
福州闽星海商贸有限公司	总经理：卢	地址：福建省福州市连江县凤城镇文笔西路龙华花园31号1店
福州志鹏沙石有限责任公司	总经理：高	地址：福建省福州市连江县凤城镇丹凤西路2号宏宇花园14-16#楼14号店
连江县益家人清洁服务有限公司	总经理：邱	地址：福建省福州市连江县凤城镇丹凤路北侧5号丹凤朝阳花园6#5号车库
福州已臻上乘建筑装饰工程有限公司	总经理：黄	地址：福建省福州市连江县凤城镇丹凤东路2号丹凤广场1#B座502房
连江县爱立养殖专业合作社	联系人：吴	地址：福建省福州市连江县安凯乡奇达村外澳路68号
连江县和煦阳光生态农业合作社	联系人：杜	地址：福建省福州市连江县丹阳镇松岭村桥头旁
连江县好来衣干洗店凤尾花园分店（普通合伙分支机构）	联系人：杨	地址：福建省福州市连江县凤城镇凤尾花园4#106店
连江县马鼻好家园便利店黄岐分店（普通合伙分支机构）	联系人：林	地址：福建省福州市连江县黄岐镇碧海蓝天3号楼1~2层店面
连江县黄岐镇林赛英鲍鱼养殖场	联系人：林	地址：福建省福州市连江县黄岐镇海丰街丰华路36号（养殖场所：大建村偏下海区）
连江县透堡益民药店	老板：章	地址：福建省福州市连江县透堡镇北街村
福州中闽祥贸易有限公司	总经理：杨	地址：连江县凤城镇华光西路2号凤凰城13#楼10层802单元
连江县苔?镇雄登水产养殖场	联系人：刘	地址：福建省福州市连江县苔?镇?邦村北澳四路70号（养殖场所：后湾海区）
连江县宝明水产养殖专业合作社	联系人：陈	地址：福建省福州市连江县筱埕镇大埕村沙边王显宫西侧
连江县苔?镇许林鲍鱼养殖场	联系人：王	地址：福建省福州市连江县苔?镇东洛村西富路19号（养殖场所：东洛村西壁湾）
连江县苔?镇何国新水产养殖场	联系人：何	地址：福建省福州市连江县苔?镇东洛村东兴弄21号（养殖场所：东洛村西壁湾）
连江县安凯乡恭英水产养殖场	联系人：吴	地址：福建省福州市连江县安凯乡奇达村宅里路26号（养殖场所：奇达洋仔里海区）
福州市茂鼎古建筑工程有限公司	总经理：黄	地址：连江县凤城镇丹凤东路2号丹凤广场1#楼B座701
连江县苔?镇何以远水产养殖场	联系人：何	地址：福建省福州市连江县苔?镇?邦村北澳三路24号（养殖场所：东洛村西壁湾）
连江县苔?镇海云水产养殖场	联系人：陈	地址：福建省福州市连江县苔?镇苔?村后港东北2号（养殖场所：东洛村西壁湾）
连江县苔?镇杨德耀水产养殖场	联系人：杨	地址：福建省福州市连江县苔?镇东洛村西富路8号（养殖场所：东洛村西壁湾）
连江县苔?镇建陈鲍鱼养殖场	联系人：吴	地址：福建省福州市连江县苔?镇东洛村西富路27号（养殖场所：东洛村海区）
连江县苔?镇谢章周水产养殖场	联系人：谢	地址：福建省福州市连江县苔?镇上塘村通达路27号（养殖场所：后湾海区）
连江县苔?镇克营鲍鱼养殖场	联系人：吴	地址：福建省福州市连江县苔?镇东洛村南强弄9号（养殖场所：东洛村西壁湾）
连江县苔?镇林子端鲍鱼养殖场	联系人：林	地址：福建省福州市连江县苔?镇东洛村南强弄31号（养殖场所：东洛村海区）
连江县黄岐镇允生海产品养殖场	联系人：吴	地址：福建省福州市连江县黄岐镇赤才村赤才路88号（养殖场所另设）
连江县苔?镇张建功鲍鱼养殖场	联系人：张	地址：福建省福州市连江县苔?镇东洛村北旺弄27号（养殖场所：东洛村西壁湾）
连江县苔?镇林金锋水产养殖场	联系人：林	地址：福建省福州市连江县苔?镇东洛村南强弄12号（养殖场所：东洛村西壁湾）
连江县苔?镇子兴鲍鱼养殖场	联系人：林	地址：福建省福州市连江县苔?镇东洛村北旺弄21号（养殖场所：东洛村海区）
连江县黄岐镇明文水产养殖场	联系人：吴	地址：福建省福州市连江县黄岐镇赤才村赤才273号（养殖场所：苔?镇东洛村西壁湾）
连江县苔?镇张唯松水产养殖场	联系人：张	地址：福建省福州市连江县苔?镇后湾村同心路47号（养殖场所：后湾海区）
连江县苔?镇何德惠水产养殖场	联系人：何	地址：福建省福州市连江县苔?镇?邦村北澳三路24号（养殖场所：东洛村西壁湾）
连江县苔?镇赛祯鲍鱼养殖场	联系人：吴	地址：福建省福州市连江县苔?镇东洛村南强弄3号（养殖场所：东洛村海区）
连江县苔?镇德好鲍鱼养殖场	联系人：杨	地址：福建省福州市连江县苔?镇东洛村北旺弄38号（养殖场所：东洛村西壁湾）
福州鸿创元投资有限公司	总经理：兰	地址：连江县凤城镇马祖西路2号上一日出东方8#楼1层03店面
连江县理计综合农场	联系人：张	地址：福建省福州市连江县敖江镇毗田屯村红星路33号
连江县苔?镇陈强鲍鱼养殖场	联系人：陈	地址：福建省福州市连江县苔?镇东洛村西富路2号（养殖场所：东洛村海区）
连江县苔?镇钦海鲍鱼养殖场	联系人：刘	地址：福建省福州市连江县苔?镇东洛村东兴弄22号（养殖场所：东洛村海区）
连江县苔?镇敬波水产养殖场	联系人：林	地址：福建省福州市连江县苔?镇北茭村吴城面8号（养殖场所：东洛村西壁湾）
连江县苔?镇吴青水产养殖场	联系人：卞	地址：福建省福州市连江县苔?镇?邦村龙井里2号（养殖场所：东洛村西壁湾）
福州云锦阁工艺有限公司	总经理：陈	地址：福建省福州市连江县凤城镇丹凤东路9#110店
连江县苔?镇杨德春鲍鱼养殖场	联系人：杨	地址：福建省福州市连江县苔?镇东洛村北旺弄38号（养殖场所：东洛村西壁湾）
连江县苔?镇林姗鲍鱼养殖场	联系人：王	地址：福建省福州市连江县苔?镇东洛村东兴弄29号（养殖场所：东洛海区）
连江县黄岐镇胜吉石料加工厂	厂长：江	地址：福建省福州市连江县连江县黄岐镇古石村蛤沙山隆尾
连江县安凯乡金财水产养殖场	联系人：王	地址：福建省福州市连江县安凯乡文湾村文湾路10号（养殖场所：文湾银屿海区）
连江县苔?镇李强鲍鱼养殖场	联系人：李	地址：福建省福州市连江县苔?镇上塘村建新路20号1（养殖场所另设）
连江县惠明综合农场	联系人：孙	地址：福建省福州市连江县东湖镇东塘村巷里11-2号
福州冠德酒店管理有限公司	总经理：吴	地址：福建省福州市连江县潘渡乡贵安村科技大楼
连江海峡温泉度假有限公司溪山温泉度假酒店	老板：林	地址：连江县潘渡乡贵安溪山路1号
连江县苔?镇何德飞水产养殖场	联系人：何	地址：福建省福州市连江县苔?镇?邦村安南角七2号（养殖场所：东洛村西壁湾）
连江县苔?镇方刚水产养殖场	联系人：方	地址：福建省福州市连江县苔?镇?邦村北街35号（养殖场所：东洛村西壁湾）
连江县苔?镇张建霆鲍鱼养殖场	联系人：张	地址：福建省福州市连江县苔?镇东洛村北旺弄29号（养殖场所：东洛村海区）
连江县苔?镇明华鲍鱼养殖场	联系人：吴	地址：福建省福州市连江县黄岐镇赤才村赤才273号（养殖场所另设）
连江县苔?镇李胜鲍鱼养殖场	联系人：李	地址：福建省福州市连江县苔?镇上塘村建新路20号2（养殖场所另设）
福建向阳坊食品有限公司连江北门分店	老板：何	地址：连江县凤城镇绿茵村北门路56号
连江县苔?镇张建同水产养殖场	联系人：张	地址：福建省福州市连江县苔?镇东洛村北旺弄29号（养殖场所：东洛村西壁湾）
连江县苔?镇德勇水产养殖场	联系人：何	地址：福建省福州市连江县苔?镇??村海滨路89号（养殖场所：东洛村西壁湾）
连江县万家文化传播有限公司	总经理：谢	地址：连江县文笔东路凤翔国际二区7#楼127店
连江县坑园镇南湖大家园养殖专业合作社	联系人：郑	地址：福建省福州市连江县坑园镇坑园村凤泰园路22号
连江溪山物业管理有限公司	总经理：林	地址：连江县潘渡乡贵安村溪山路3号
福州高洋生态旅游开发有限公司	总经理：陈	地址：福建省福州市连江县马鼻镇横厝村横厝街106之一
连江县安凯乡娟英水产养殖场	联系人：卢	地址：福建省福州市连江县安凯乡文湾村文湾路15号（养殖场所：文湾银屿海区）
连江县尚方装潢工程有限公司	总经理：夏	地址：福建省福州市连江县凤城镇马祖西路17号颐和家园2#楼703室
连江县苔?镇子慧水产养殖场	联系人：林	地址：福建省福州市连江县苔?镇东洛村北旺弄21号（养殖场所：东洛村西壁湾）
连江县东海岸假日酒店有限公司	总经理：陈	地址：连江县晓沃镇道沃村连江水产品加工基地建设发展有限公司内
连江县?头镇秦丰农民专业合作社	联系人：原	地址：连江县?头秦川村长乐坑
连江县泉恒建材有限责任公司	总经理：陈	地址：连江县潘渡乡朱步村村委会102室
福州建丰建材有限公司	总经理：肖	地址：连江县凤城镇丹凤东路（天福楼）21#楼707单元
连江县苔?镇李守杨鲍鱼养殖场	联系人：李	地址：福建省福州市连江县苔?镇东洛村北旺弄3号（养殖场所：东洛村西壁湾）
连江县苔?镇振强鲍鱼养殖场	联系人：王	地址：福建省福州市连江县苔?镇东洛村东西弄29号（养殖场所另设）
连江壹号开心家庭农场（普通合伙）	联系人：郑	地址：福建省福州市连江县丹阳镇丹阳村垅头坂
连江县连丰海产品有限公司	总经理：张	地址：连江县黄岐镇大青湾
连江县晓澳镇永洋塑胶雨具厂	厂长：赵	地址：连江县晓澳镇长沙村新兴路53-1号
连江县兴亿苗圃场	联系人：林	地址：福建省福州市连江县透堡镇旧粮站内
连江县苔?镇德雄鲍鱼养殖场	联系人：杨	地址：福建省福州市连江县苔?镇东洛村北旺路弄38号（养殖场所另设）
连江县浦口镇佳园保洁中心	联系人：滕	地址：连江县浦口镇浦江街过浦路131号
福建省春秋国际旅行社有限公司黄岐营业部	老板：邓	地址：连江县黄岐镇海建街海滨路刘必兴楼二扇一直
福建海晟连锁营销发展有限公司连江环岛店	老板：陈	地址：连江县凤城镇816北路18#1层2店面
福建省祺扬建筑工程有限公司	总经理：梁	地址：连江县丹凤东路15号丹凤花园23#楼6店面
连江县蓼沿乡赤南岗万达石材厂	厂长：郑	地址：福建省福州市连江县蓼沿乡赤南岗工业园区
连江县庄贵农庄	联系人：庄	地址：福建省福州市连江县黄岐镇海英街车堂尾
连江县凤都企业管理有限公司	总经理：黄	地址：连江县凤城镇莲荷西路11#6号店
连江县苔?镇旺东水产养殖场	联系人：林	地址：福建省福州市连江县苔?镇东洛村东兴弄21号
连江县苔?镇旺家水产养殖场	联系人：林	地址：福建省福州市连江县苔?镇东洛村北旺弄34号
连江县苔?镇兴岛水产养殖场	联系人：杨	地址：福建省福州市连江县苔?镇东洛村北弄旺38号
连江县聚鑫园农业综合场（普通合伙）	联系人：包	地址：福建省福州市连江县蓼沿乡利畲村西山自然村
连江县顺翔企业管理有限公司	总经理：卢	地址：福建省福州市连江县凤城镇马祖西路2号上一日出东方2#楼12店面
连江县五朵贸易有限公司	总经理：张	地址：福建省福州市连江县816南路39号连江百货公司三楼
连江县芊智美美容会所	所长：吴	地址：福建省福州市连江县凤城镇敖江路与丹凤路交叉东南角玉沙综合商场一层12#
连江县凤岗建设发展有限公司	总经理：雷	地址：福建省福州市连江县东湖镇人民政府大院内
连江庶农圃园林景观有限公司	总经理：刘	地址：福建省福州市连江县潘渡乡贵安科技大楼
福建省天都建筑工程有限公司	总经理：林	地址：连江县凤城镇东南街建国路77号
福建省连江县晟嘉贸易有限公司	总经理：周	地址：连江县凤城镇西北街北门路51号
福建闽福水产有限公司	总经理：林	地址：连江县苔?镇北茭村牛埠57号
福建汇榕物流有限公司	总经理：张	地址：连江县可门港经济开发区J区办公楼二楼
连江县通达路桥建筑工程有限公司	总经理：杨	地址：福建省福州市连江县凤城镇环城路1号办公楼第二层南侧二直
连江县腾飞石板材厂	厂长：张	地址：福建省福州市连江县丹阳镇坂顶村
连江县广诚砂石贸易有限公司	总经理：陈友国	地址：连江县凤城镇104国道边（招亮实业三层）
福建省连江县三洲船舶修造有限公司	总经理：吴振喜	地址：连江县筱埕镇定海长沃815路
福建省昊立建设工程有限公司连江分公司	总经理：张振霆	地址：连江县凤城镇玉山村陈第路和104国道交叉口
连江县江南乡魁岐村南宫自来水厂	厂长：郑其春	地址：连江县江南乡魁岐村南宫水库
福建永盛农牧发展有限公司书坪分公司	总经理：滕用柯	地址：连江县益砌村书坪山坳
福州奥士通环保工程有限公司	总经理：林赛铃	地址：连江县晓沃镇道澳村长乐路143号
福建省锦烨园艺建设有限公司	总经理：林银凤	地址：连江县凤城镇华光西路2号凤凰城12#楼13层1101单元
连江县苔?盛亚鲍鱼养殖场	联系人：何以兴	地址：连江县苔?镇横塍村后门山
福建省连江东?担保有限公司	总经理：刘昌荣	地址：连江县凤城镇丹凤东路14号绿茵花园4#楼8号、9号店
连江县玉泉温泉旅馆	联系人：陈华	地址：连江县凤城镇莲荷西路康耀公寓1#一、二层（14、15店，207、208房）
福建省连江县和永利贸易有限公司	总经理：林群	地址：连江县凤城镇八一六北路2号楼604
福州万里圆通速递有限公司连江分公司	总经理：何文静	地址：连江县凤城镇丹凤东路15号丹凤花园24座7号车库
福建和枫园林工程有限公司	总经理：邱吉强	地址：连江县凤城镇北门小区西渠路86号
连江县鼎晟食品有限公司	总经理：陈兴	地址：连江县敖江投资区上高路下山地段连黄公路南侧（福建永达建材开发有限公司内5#标准厂房）
连江县兴淼水产有限公司	总经理：林建荣	地址：连江县安凯乡奇达村软卷坛
福建连江县兰庭房地产有限公司	总经理：何振	地址：连江县筱埕镇官坞村老人会第四层
福建华美三鑫投资有限公司	总经理：陈积金	地址：连江县?头镇开放区104国道边2＃3楼
中国移动通信集团福建有限公司连江?头下塘口营业厅	联系人：洪勇	地址：连江县?头镇开发路凤仪楼5、6#店面
连江县福卡丹装饰材料厂	厂长：翁伟林	地址：连江县浦口镇浦升街阁山新村29座7DD8号店面
福建豪宸房地产开发有限公司	总经理：庄建兴	地址：连江县凤城镇816西路9号银河丽景2号楼204单元
连江安然燃气有限公司丹凤客户服务部	老板：何晓丹	地址：连江县丹凤路壹号楼A座一层东起第壹拾贰间
福州计联电脑有限公司连江分公司	总经理：齐峰	地址：连江县凤城镇凤园东路327号天和城1#05号车库
连江县丰收贸易有限公司	总经理：林建华	地址：连江县敖江镇投资区7#楼（青霞路8号）
连江县美芳贸易有限公司	总经理：邱浩	地址：连江县凤城镇文山北路5号太一新天地4#301
福建省连江县稣盛水产品综合加工厂	厂长：陈瑞碧	地址：连江县安凯乡安海村乌岗头
福建省连江县龙枫水产有限公司	总经理：林枫	地址：连江县筱埕镇官坞村临海南路1号
福建省连江县坑园下园兴利鳗场	联系人：王金乐	地址：连江县坑园镇坑园村
连江县欢乐营旅游开发有限公司	总经理：俞林	地址：连江县苔?镇苔?村后港东北路13号
连江县源亿农业开发有限公司	总经理：王官佃	地址：连江县浦口镇官岭村黄家坝
福州日春商贸有限责任公司连江分公司	总经理：王启阳	地址：连江县城关丹凤中路壹号楼A座一层东起第二、三间
中国邮政储蓄银行有限责任公司连江丹阳营业所	所长：黄丽芳	地址：连江县丹阳镇连罗路
连江县九鼎包装有限公司	总经理：赵德胜	地址：连江县?头镇阳岐村阳浦路3号
连江县供销再生资源有限公司上山回收点	联系人：黄业寿	地址：连江县敖江镇上山村沃中
连江县供销再生资源有限公司祠台回收点	联系人：江灼官	地址：连江县东湖镇祠台村村中路48号
福州派生特生物科技有限公司	总经理：刘友霖	地址：连江县江南乡复兴路8号科灵新天地6#楼1层1店面
福州合利食品有限公司	总经理：林细沌	地址：连江县丹阳镇新洋村委办公楼
福州诚建物业管理有限公司	总经理：王明?	地址：连江县凤城镇莲荷东路（连一中教师集资住宅1#楼）32#A705
福建省旅游有限公司连江?头营业部	老板：杨钟	地址：连江县?头镇开放西路78号
福建省乐鑫新型建材有限公司	总经理：陈勤德	地址：连江县坑园镇坑园村溪尾路58号管委会大楼
福建东方新天地投资发展有限公司	总经理：黄增流	地址：福建省连江县?头镇青芝大道6#天麟城5栋203房
连江县蓼沿乡下车林场	联系人：任本龙	地址：连江县蓼沿乡下车村
福州英辉机械有限公司	总经理：孙家辉	地址：连江县敖江投资区104国道边青塘口2#楼第一层
福州新山水科技农业有限公司连江分公司	总经理：傅海州	地址：连江县丹阳镇山边村太太岗
福建省连江县华海石油仓储有限公司	总经理：陈水平	地址：连江县?头镇门边新村21号
福建尼西亚木业有限公司	总经理：陈素琴	地址：连江县浦口镇浦西路178号
连江县福平日用品厂	厂长：黄福栋	地址：连江县东湖镇飞石苗圃
福建欢乐天地置业有限责任公司	总经理：黄如健	地址：连江县潘渡乡贵安村科技大楼
连江县丹阳镇新辉石子场	联系人：黄雪锋	地址：连江县丹阳镇坂顶村坂顶岗（104国道边）
福建省冠海黄岐旅游有限公司	总经理：林财龙	地址：连江县黄岐镇人民政府办公大楼办公室202、203室
连江县花园农业种植有限公司	总经理：林应明	地址：连江县蓼沿乡四定村旧厝17-1号
连江县?头镇新紫金平价大药房	联系人：吴飞	地址：连江县?头粮站1层店面
连江县罗马假日养生馆	联系人：刘必钦	地址：连江县凤城镇东渠路5号
连江县黄岐盛隆鲍鱼养殖场	联系人：林肇骥	地址：连江县黄岐镇农贸市场B座二楼第四间（养殖场另设）
连江县共和沙石厂	厂长：林英强	地址：连江县凤翔国际1号楼1103单元
福建省连江县百汇建材有限公司	总经理：林庆国	地址：连江县?头镇青芝大道6号
连江县甚奇文体用品有限公司	总经理：林棋	地址：连江县凤城镇江滨东路19傲江景城A3#楼601单元
连江县黄岐镇盛达鲍鱼养殖场	联系人：林本钦	地址：连江县黄岐镇海丰街丰恒路91号（养殖场所另设）
连江县黄岐宏昌鲍鱼养殖场	联系人：何鸿彦	地址：连江县黄岐镇海新街进步路80号（养殖场所另设）
福建蝶泉湾酒店有限公司	总经理：高雍	地址：连江县凤城镇凤园路327号天和城14幢404
连江县振良种植农民专业合作社	联系人：陈振	地址：连江县敖江镇幕浦村东门一排129号
福建省连江县健新贸易有限公司	总经理：陈滢华	地址：连江县筱埕镇东坪村潮江路
连江县黄岐古石先锋鲍鱼场	联系人：陈锋	地址：连江县古石村隆座
连江县黄岐福泰鲍鱼场	联系人：黄怀胜	地址：连江县黄岐镇海新街进步路71号（养殖场所另设）
中国邮政储蓄银行有限责任公司连江筱埕营业所	所长：黄玲	地址：连江县筱埕镇筱埕村东山路（筱埕邮政楼一楼）
连江县黄岐本营鲍鱼场	联系人：林本营	地址：连江县黄岐镇海丰街丰恒路180号（养殖场所另设）
连江县黄岐阿凯鲍鱼场	联系人：林凯	地址：连江县黄岐镇海丰街丰华路252号（养殖场所另设）
福建东?房地产开发有限公司	总经理：刘昌荣	地址：连江县凤城镇文山北路5号太一新天地4#楼1804单元
连江县黄岐统志鲍鱼场	联系人：卢统志	地址：连江县黄岐镇海丰街丰恒路103号（养殖场所另设）
连江县黄岐施恩鲍鱼场	联系人：施恩	地址：连江县黄岐镇海丰街丰恒路28号（养殖场所另设）
连江县黄岐品琴鲍鱼场	联系人：吴品琴	地址：连江县黄岐镇赤才村赤才129号（养殖场所另设）
连江县黄岐忠登鲍鱼场	联系人：肖忠登	地址：连江县黄岐镇后仑村西路10号（养殖场所另设）
福州天楹环保能源有限公司	总经理：严圣军	地址：连江县东湖镇飞石村
福建省连江县光金鞋材有限公司	总经理：陈桂光	地址：连江县筱埕镇人民政府办公楼二层
福建连江县天水水产有限公司	总经理：李依殿	地址：连江县筱埕镇逻?村中山路51号
福建省连江县定海长盛鲍鱼养殖场	联系人：赵世长	地址：连江县筱埕镇定海村可门东侧
福建省连江县海味食品厂	厂长：滕生淦	地址：连江县晓沃镇百胜工业区
福建省连江县育宸水产综合场	联系人：张承煜	地址：连江县浦口镇中麻村镜路
连江县海峰水产养殖试验场	联系人：单成宇	地址：连江县潘渡乡陀市村上社口
连江县蓼沿乡白沙村芹山天兴采石场	联系人：陈义银	地址：连江县潘渡乡高岳村存后1号
连江县马鼻镇兴利水产养殖场	联系人：杜邦佃	地址：连江县马鼻镇辰山村瓦窑村虾塘
连江县蓼沿乡仙屏村下沃采石场	联系人：郑永灼	地址：连江县蓼沿乡仙屏村下沃
连江县蓼沿乡兴枝采石场	联系人：黄兴枝、黄金途	地址：连江县蓼沿乡溪东村
连江县瑞丰石材厂	厂长：汤水官	地址：连江县蓼沿乡赤南岗工业区
连江县蓼沿大普顶银灰岩采石矿	联系人：蒋齐祯	地址：连江县蓼沿乡白沙村大普顶
连江县颜岐大青海带加工厂	厂长：颜龙甲	地址：连江县坑园镇颜岐村
连江县日盛渔业基地	联系人：颜台华	地址：连江县坑园镇红下村
连江县华海水产养殖场	联系人：林梦玉	地址：连江县坑园镇红下村
福建省连江县文笔山陈云农业综合开发场	联系人：陈云钦	地址：连江县江南乡已古村文华路17号
福建省连江县黄岐建隆水产养殖场	联系人：江依建	地址：连江县黄岐镇海英街后沙
连江县黄岐山海水产养殖场	联系人：林淑莺	地址：连江县黄岐镇海建街乌潭谷
连江县黄岐古石三兴鲍鱼场	联系人：吴明积	地址：连江县黄岐镇古石村隆座溪边
福建省连江县兴森海海洋生物开发有限公司	总经理：陈而兴	地址：连江县海峡西岸水产品加工基地管委会二层
福建省连江县福华环保机械研发厂	厂长：陈水华	地址：连江县?头镇后一西澳路132号
福州市多来多贸易有限公司	总经理：余修雄	地址：连江县凤城镇文山南路479号永得利花园6#-8#楼7号店面
连江县城建城市维护服务中心	联系人：黄增雄	地址：连江县凤城镇文明东路33号
福建省连江县依飞石料场	联系人：陈杏顺	地址：连江县凤城镇凤园路327路天和城5#10号车库
连江县永联贸易有限公司	总经理：颜草	地址：连江县凤城镇凤尾花园凤园村56#楼705
连江县亿用软件开发部	老板：林端森	地址：连江县凤城镇丹凤东路15号丹凤花园8#1号店
福州华祥农业综合开发有限公司	总经理：陈丹华	地址：连江县凤城镇丹凤东路（天福楼）21#楼902
连江县凤城镇永顺旅馆	联系人：陈祥其	地址：连江县凤城镇816北路42号
福建省连江县美加咨询有限责任公司	null	地址：福建省福州市连江县北岳宾馆一层大厅
福建省连江县马鼻浮曦水产综合养殖场	联系人：许在艺	地址：福建省福州市连江县马鼻镇浮曦村
福建省连江县绿洲园林工程有限公司	总经理：林世铭	地址：福建省福州市连江县凤城镇玉山村
福建省连江县绿亚环保工程公司	null	地址：福建省福州市连江县福州湖塍新村Ｂ3２０７室
福建省连江县绿清环境工程有限公司	null	地址：福建省福州市连江县黄岐镇文明东路８４号
福建省连江县绿会园林工程有限公司	null	地址：福建省福州市连江县凤城镇玉荷西路１１２号
福建省连江县龙眼示范场	null	地址：福建省福州市连江县农业局内
福建省连江县龙腾淡水养殖有限公司	null	地址：福建省福州市连江县潘渡塘板
福建省连江县林娟贸易有限公司	null	地址：福建省福州市连江县凤城镇文山路９２号
福建省连江县粮油食品公司	总经理：粱敬星	地址：福建省福州市连江县凤城镇东城路１４７号
福建省连江县粮油工业公司	null	地址：福建省福州市连江县凤城镇爱国路７５号
福建省连江县粮食经济开发总公司凤城公司	null	地址：福建省福州市连江县凤城镇八一六东路７６号
福建省连江县连兴围垦综合开发有限公司	总经理：黄满泉	地址：福建省福州市连江县马鼻镇浮唏村
福建省连江县矿产品工贸有限公司	null	地址：福建省福州市连江县凤城镇八一六北路４８号
福建省连江县坑园种养殖综合场	null	地址：福建省福州市连江县坑园乡坑园村
福建省连江县坑园乡三立水产综合场	null	地址：福建省福州市连江县坑园乡下与村
福建省连江县坑园乡企业办公室	null	地址：福建省福州市连江县坑园乡政府内
福建省连江县坑园文山水产品养殖综合场	null	地址：福建省福州市连江县坑园乡文山
福建省连江县坑园农业综合开发科技示范基地	联系人：黄财东	地址：福建省福州市连江县坑园乡前屿村
福建省连江县坑园家俱加工场	null	地址：福建省福州市连江县坑园乡坑园村溪尾路２号
福建省连江县坑园宏达特禽养殖场	null	地址：福建省福州市连江县坑园乡象讳村
福建省连江县坑园红下鱼钙饲料综合厂	厂长：黄家水	地址：福建省福州市连江县坑园乡红下村
福建省连江县坑园初芦海味经营部	null	地址：福建省福州市连江县下宫初芦村
福建省连江县康盛工业物资贸易有限公司	总经理：黄兆荣	地址：福建省福州市连江县敖江镇小湾村南路１９号
福建省连江县凯华基础工程有限公司	null	地址：福建省福州市连江县凤城镇文明东路２３６号
福建省连江县凯达轮船公司	总经理：林碧珠	地址：福建省福州市连江县安凯乡半山村
福建省连江县九星实业贸易有限公司	null	地址：福建省福州市连江县风城镇玉可东路1号楼119号
福建省连江县九龙巴士有限公司	总经理：邱健	地址：福建省连江县晓沃新区新锋路3号
福建省连江县景文贸易有限公司	null	地址：福建省福州市连江县凤城镇供销２＃１店
福建省连江县金盛水产食品精制厂	null	地址：福建省福州市连江县苔录镇后港码头
福建省连江县金盾打捞有限公司	总经理：张剑平	地址：福建省福州市连江县凤城镇爱国路１５６号
福建省连江县街岐综合林果场	联系人：黄应修	地址：福建省福州市连江县坑园乡红下村街岐山
福建省连江县教育服务公司经营部	null	地址：福建省福州市连江县凤城镇玉荷西路教育局楼下
福建省连江县交通运输管理所	null	地址：福建省福州市连江县凤城镇八一六北路１０３号
福建省连江县交通人民警察大队城关中队	null	地址：福建省福州市连江县北岳停车场
福建省连江县江南万胜商贸有限公司	总经理：张坤松	地址：福建省福州市连江县江南乡人民政府院内
福建省连江县建星鞋材厂	厂长：吴祥水	地址：福建省福州市连江县敖江工业区
福建省连江县建兴粮食有限公司	null	地址：福建省福州市连江县黄岐镇海丰街丰园路１８２号
福建省连江县黄岐镇赤沃海珍品养殖场	联系人：胡国福	地址：福建省福州市连江县黄岐镇赤沃村北路４１号
福建省连江县黄岐渔港经济开发有限公司	总经理：郑细弟	地址：福建省福州市连江县黄岐镇政府院内
福建省连江县黄岐鱼械修配厂	null	地址：福建省福州市连江县黄岐镇海建
福建省连江县环新实业有限公司	总经理：陈光剑	地址：连江县东湖乡
福建省连江县华荣实业有限公司	null	地址：福建省福州市连江县凤城镇新桥南面
福建省连江县华佳贸易有限公司	null	地址：福建省福州市连江县凤城镇民主巷６１号
福建省连江县华峰贸易有限公司	总经理：陈显燕	地址：连江县下宫乡新区一号
福建省连江县后湾海洋鱼业有限公司	null	地址：福建省福州市连江县苔录镇后湾村
福建省连江县鸿宇通信发展有限公司	总经理：张辛代	地址：福建省福州市连江县凤城镇八一六中路２３９号
福建省连江县鸿信邮政有限公司	总经理：郑为斌	地址：福建省福州市连江县凤城镇８１６中路１２９号
福建省连江县鸿昌钢制品有限公司	总经理：陈兆在	地址：福建省福州市连江县东湖头敖江工业小区
福建省连江县宏港冷冻有限公司	总经理：林文飞	地址：福建省福州市连江县苔录镇苔录村
福建省连江县宏帆交通服务有限公司	总经理：黄家钦	地址：福建省福州市连江县凤城镇西渠路８４８号
福建省连江县宏达水产品精制厂	null	地址：福建省福州市连江县苔录镇后港
福建省连江县红十字会	null	地址：福建省福州市连江县凤城镇八一六北路政府大楼
福建省连江县恒磊环保防腐有限公司	总经理：林枝芳	地址：福建省福州市连江县晓沃镇道沃村
福建省连江县恒磊花岗岩材料厂	null	地址：福建省福州市连江县东湖镇
福建省连江县禾顺育苗有限公司	总经理：黄高水	地址：福建省福州市连江县马鼻镇南门村青屿
福建省连江县海洋与水产局	局长：袁连兴	地址：福建省福州市连江县凤城镇新民路１４号
福建省连江县海天娱乐城	null	地址：福建省福州市连江县晓沃镇新区新兴路１号
福建省连江县国有资产营运有限公司	总经理：陈友枝	地址：福建省福州市连江县凤城镇玉荷东路４７号
福建省连江县桂林淡水养殖有限公司	null	地址：福建省福州市连江县丹阳桂林村
福建省连江县贵山淡水养殖有限公司	null	地址：福建省福州市连江县潘渡乡坡西村
福建省连江县贵龙鳖业有限公司	null	地址：福建省福州市连江县潘渡乡贵安村
福建省连江县贵安新明养殖有限公司	null	地址：福建省福州市连江县潘渡乡贵安村
福建省连江县贵安鳗鱼经营部	null	地址：福建省福州市连江县潘渡乡贵安村
福建省连江县贵安鳗业有限公司	null	地址：福建省福州市连江县潘渡乡贵安村
福建省连江县贵安鳗业服务部	null	地址：福建省福州市连江县潘渡乡贵安村宝光路５号
福建省连江县广厦贸易有限公司	null	地址：福建省福州市连江县凤城镇北岳大厦
福建省连江县官坞海珍品养殖场	联系人：董潮盛	地址：福建省福州市连江县筱埕镇官坞村工业小区
福建省连江县官乌海洋开发有限公司	总经理：林哲龙	地址：福建省福州市连江县筱埕镇官乌村
福建省连江县挂机厂	null	地址：福建省福州市连江县城关玉山县机械厂内
福建省连江县公路技术协作服务站	null	地址：福建省福州市连江县凤城镇八一六北路１０６号
福建省连江县工艺竹编厂	厂长：余昌兴	地址：福建省福州市连江县凤城镇八一六东路１０５号
福建省连江县工贸公司	总经理：缪仁第	地址：福建省福州市连江县东岱镇演宫路１号
福建省连江县工贸副食品公司	null	地址：福建省福州市连江县凤城镇８１６南路４３号
福建省连江县高翔实业有限公司	null	地址：福建省福州市连江县敖江镇工业小区
福建省连江县港航管理站	null	地址：福建省福州市连江县凤城镇八一六北路１０３号
福建省连江县富明实业有限公司	总经理：陈如明	地址：福建省福州市连江县浦口星辉工业区45号
福建省连江县福源首饰有限公司	null	地址：福建省福州市连江县凤城镇玉荷西路２７７号
福建省连江县福连贸易有限公司	null	地址：福建省福州市连江县防疫站综合楼１层
福建省连江县凤仙石材制品厂	null	地址：福建省福州市连江县蓼沿乡蓼沿村
福建省连江县凤康农工商发展有限公司	null	地址：福建省福州市连江县敖江镇（良种场边）
福建省连江县凤辉贸易有限责任公司	null	地址：福建省福州市连江县凤城镇北门西渠路１９２号
福建省连江县凤虹装璜装修公司	null	地址：福建省福州市连江县凤城镇八一六东路３６号
福建省连江县凤城镇保温车队	null	地址：福建省福州市连江县凤城镇玉荷路３号楼３０１房
福建省连江县凤城休闲中心	联系人：林家义	地址：福建省福州市连江县凤城水果场旁边
福建省连江县凤城新江海鲜楼	null	地址：福建省福州市连江县凤城镇文明路
福建省连江县凤城世厚锅店	null	地址：福建省福州市连江县八一六北路１７号
福建省连江县凤城食杂经营部	null	地址：福建省福州市连江县凤城镇１０４国道工业小区
福建省连江县凤城石材经营部	老板：邵依坦	地址：福建省福州市连江县凤城工业小区（１０４国道西侧）
福建省连江县凤城冷冻加工厂	厂长：黄家信	地址：福建省福州市连江县凤城镇玉荷东路１１８号
福建省连江县凤城佛榕陶瓷贸易部	null	地址：福建省福州市连江县蓬荷西路福来新村Ｂ座
福建省连江县凤城东北机械冷作厂	null	地址：福建省福州市连江县凤城八一六东路１３２号
福建省连江县凤城车行摩托经营部	null	地址：福建省福州市连江县敖江镇（县三建楼下）
福建省连江县凤城邦德车行	联系人：苏兰燕	地址：福建省福州市连江县城关莲荷东路２号楼
福建省连江县凤朝阳娱乐有限公司	null	地址：福建省福州市连江县城关莲荷东路２号楼
福建省连江县凤朝阳贸易有限公司	null	地址：福建省福州市连江县凤城镇莲荷东路二号楼三层
福建省连江县丰利水产综合场	联系人：黄应修	地址：福建省福州市连江县红下村三叉路３３号
福建省连江县非金属矿业厂	null	地址：福建省福州市连江县二轻局院内
福建省连江县飞达渔畜养殖业有限公司	null	地址：福建省福州市连江县东湖镇飞石村
福建省连江县二轻工贸有限公司	null	地址：福建省福州市连江县凤城镇八一六北路８号
连江县东岱镇交通服务有限公司	总经理：林国天	地址：福建省福州市连江县东岱镇演宫路一号
连江县东岱镇湖里村经济合作社	null	地址：福建省福州市连江县东岱镇湖里村
连江县东岱镇东水村经济联合社	联系人：林用民	地址：福建省福州市连江县东岱镇东水村
连江县东岱镇蝉步巧萍柴油店	老板：陈巧萍	地址：连江县东岱镇蝉步村
连江县东岱街企业办公室	null	地址：福建省福州市连江县东岱街开通路１号
连江县东岱湖里砖瓦二厂	null	地址：福建省福州市连江县东岱镇湖里村
连江县东岱废塑回收站	null	地址：福建省福州市连江县东岱镇东兴街
连江县东北线公路改建工程指挥部	老板：邱德平	地址：福建省福州市连江县交通局
连江县第一法律事务所	所长：李高雄	地址：福建省福州市连江县凤城镇八一六中路４９号县司法局大院内
连江县第五法律事务所	所长：叶世光	地址：福建省福州市连江县黄岐镇新兴路１２２号
连江县第三法律事务所	所长：李文英	地址：福建省福州市连江县晓沃镇政府机关大院内
连江县第六法律事务所	所长：翁贤亮	地址：福建省福州市连江县浦口镇政府
连江县第八法律事务所	所长：李金程	地址：福建省福州市连江县马鼻镇政府
连江县档案管理局	null	地址：福建省福州市连江县凤城镇八一六北路县委大院
连江县丹阳镇林果场	null	地址：福建省福州市连江县丹阳镇坂顶村
连江县丹阳镇粮食综合加工厂	null	地址：福建省福州市连江县丹阳镇
连江县丹阳镇法律服务所	所长：刘榕奇	地址：福建省福州市连江县丹阳镇政府
连江县丹阳镇村级主干福利基金会	null	地址：福建省福州市连江县丹阳镇人民政府院内
连江县丹阳镇城建指挥部	老板：孙祥光	地址：福建省福州市连江县丹阳镇新街丹兴路
连江县丹阳镇办企业退休基金会	null	地址：福建省福州市连江县丹阳镇政府办公大楼
连江县丹阳镇１０４国道拓宽工程指挥部	null	地址：福建省福州市连江县丹阳镇新街丹兴路
连江县丹阳交通管理站	null	地址：福建省福州市连江县丹阳镇
连江县丹阳个体基金会	null	地址：福建省福州市连江县丹阳镇新街３５号
连江县丹阳电力管理所	null	地址：福建省福州市连江县丹阳镇丹阳街丹只路
连江县大建海水种苗养殖场	联系人：程庆安	地址：福建省福州市连江县黄岐镇大建村
连江县大官坂垦区管理委员会	联系人：林瑞光	地址：福建省福州市连江县坑园乡坑园村溪尾路５８号
连江县大官坂垦区发包清债领导小组	null	地址：福建省福州市连江县坑园乡坑园村溪尾路１０号
连江县城综合管理委员会办公室	null	地址：福建省福州市连江县中共连江县委文明办
连江县城关旧城改造拆迁工程处	null	地址：福建省福州市连江县凤城镇文山路４５号
连江县成品水暖配件店	null	地址：福建省福州市连江县凤城八一六北路西侧２号
连江县潮声五金电器经营部	null	地址：福建省福州市连江县凤城８１６西路１０号
连江县朝顺车辆贸易商场	联系人：陈春玉	地址：福建省福州市连江县凤城八一六北路42号第一间店
连江县长龙镇岚下村经济合作社	联系人：陈学辉	地址：福建省福州市连江县长龙镇岚下村经济合作社
连江县长龙法律服务所	所长：刘俊毅	地址：福建省福州市连江县长龙镇政府
连江县贝苗试验场水产苗种基地	联系人：林秋太	地址：福建省福州市连江县坑园乡颜歧村
连江县敖江镇小湾村经济合作社	联系人：林振平	地址：福建省福州市连江县敖江镇小湾村
连江县敖江镇水利水电工作站	站长：陈祥官	地址：福建省福州市连江县凤尾花园２６座
连江县敖江镇毗屯村制种联合体	联系人：张学茂	地址：福建省福州市连江县敖江镇毗屯村
连江县敖江镇幕浦村经济合作社	null	地址：福建省福州市连江县敖江镇幕浦村
连江县敖江镇凤尾老人会	null	地址：福建省福州市连江县敖江镇凤尾老人会
连江县敖江镇岱云村经济合作社	联系人：魏盛华	地址：福建省福州市连江县敖江镇岱云村
连江县敖江镇敖北木材店	null	地址：福建省福州市连江县敖江镇北岳村北路５０号
连江县敖江学区	null	地址：福建省福州市连江县敖江镇江南村
连江县敖江乡连兴村	村长：林祚香	地址：福建省福州市连江县敖江乡连兴村
连江县敖江天雄水泥制品店	null	地址：福建省福州市连江县敖江供销社门市部
连江县敖江世美首饰加工店	null	地址：福建省福州市连江县玉荷东路８号
连江县敖江榕辉钢材店	null	地址：福建省福州市连江县凤城镇八一六北路
连江县敖江凤山石材加工厂	null	地址：福建省福州市连江县敖江镇下山村新建路１０８号
连江县敖江法律服务所	所长：林伙顺	地址：福建省福州市连江县敖江镇政府
连江县敖北秀英食杂店	null	地址：福建省福州市连江县三建公司门市部
连江县敖北财喜水泥店	null	地址：福建省福州市连江县三建公司门市部
连江县安凯乡农业机械管理站	null	地址：福建省福州市连江县安凯乡政府院内
连江县安凯水产生资供应站	null	地址：福建省福州市连江县安凯乡车站边
连江县安凯后才湾海珍养殖基地	联系人：杨明全	地址：福建省福州市连江县安凯乡沙沃村
连江县爱国卫生委员会	联系人：陈可思	地址：福建省福州市连江县凤城镇八一六北路政府大楼
连江温泉澡堂	null	地址：福建省福州市连江县汽车站
连江台马娱乐有限公司（工商已吊销）	联系人：姜伙生35	地址：福建省福州市连江县黄岐镇海滨路８２号
连江青芝乡讯社	联系人：高群	地址：连江县中旅社内
连江凯捷高科技农业有限公司	总经理：陈杭生	地址：福建省福州市连江县丹阳镇朱山（原八一茶场）　　法定代表人：陈杭生
连江百胜水产开发有限公司	null	地址：福建省福州市连江县晓沃镇百胜村
连江	联系人：陈	地址：福建省福州市连江县风
林娟食杂店	null	地址：福建省福州市连江县三建公司第三间
兰忠食杂店	null	地址：福建省福州市连江县凤城八一六路才溪水电站店面
连江雅柏农业综合开发有限公司	总经理：张朝贺	地址：福建省福州市连江县东岱镇演宫路１号　　法定代表人：
连江县?头镇水利水电工作站电力管理所	null	地址：福建省福州市连江县?头镇连江路１号
连江县职业技能鉴定站	null	地址：福建省福州市连江县城关北门外技校内
连江县职工学校	校长：邱吉发	地址：福建省福州市连江县凤城镇建国路２３号
连江县职工物价监督总站	null	地址：福建省福州市连江县总工会
连江县征地地产事务所	所长：陈德明	地址：福建省福州市连江县土地局
连江县新锋装饰材料供应站	null	地址：福建省福州市连江县晓沃新区新锋路１号
连江县筱埕镇企业管理站	站长：周玉平	地址：福建省福州市连江县筱埕镇龙舟路
连江县筱埕镇农业机械管理站	站长：林超凡	地址：福建省福州市连江县筱埕镇筱埕村龙舟路７６号
连江县筱埕镇计划生育服务队	null	地址：福建省福州市连江县筱埕镇筱埕村龙舟路７６号
连江县筱埕镇定海村围海工程指挥部	null	地址：福建省福州市连江县筱埕镇定海村
连江县筱埕水产品经营部	null	地址：福建省福州市连江县筱埕镇筱埕村
连江县筱埕南山青田坂果牧渔生态场	联系人：陈强	地址：福建省福州市连江县筱埕镇南山村
连江县筱埕逻回海产品加工厂	厂长：邱武其	地址：福建省福州市连江县筱埕镇逻回村
连江县筱埕经营管理站	站长：孙丽榕	地址：福建省福州市连江县筱埕镇人民政府
连江县筱埕供水站	null	地址：福建省福州市连江县筱埕镇供水站
连江县筱埕法律服务所	所长：江赐木	地址：福建省福州市连江县筱埕镇政府
连江县晓沃镇企业办公室	null	地址：福建省福州市连江县晓沃镇政府
连江县晓沃镇海外侨胞李氏接待站	站长：李旦华	地址：福建省福州市连江县晓沃镇晓江街
连江县晓沃镇供水站	null	地址：福建省福州市连江县晓沃镇晓兴街
连江县晓沃镇道沃村经济合作社	null	地址：福建省福州市连江县晓沃镇道沃村
连江县晓沃晓锋海味干菜制品厂	厂长：徐贞勇	地址：福建省福州市连江县晓沃镇晓锋街
连江县晓沃嘉盛养殖场	联系人：蒋启忠	地址：福建省福州市连江县晓沃长沙前斗６５号
连江县晓沃海产经营部	null	地址：福建省福州市连江县晓沃镇晓锋街团结路４４号
连江县小沦乡小沦村经济合作社	null	地址：福建省福州市连江县小沦乡小沦村
连江县小沧乡樟后村经济合作社	联系人：曾禄财	地址：福建省福州市连江县小沧乡樟后村
连江县小沧乡七里村经济合作社	null	地址：福建省福州市连江县小沧乡七里村
连江县小沧乡利洋村经济合作社	null	地址：福建省福州市连江县小沧香族乡人民政府利洋村委员会
连江县小沧畲族乡农业机械管理站	null	地址：福建省福州市连江县小沧畲族乡人民政府院内
连江县小沧畲族乡东风村经济联合社	联系人：兰仕仁	地址：福建省福州市连江县小沧畲族乡东风村
连江县厦宫水产干菜经营部	null	地址：福建省福州市连江县厦宫乡厦宫村
连江县下与水产综合场	null	地址：福建省福州市连江县坑园乡下与村
连江县下宫乡农业机械管理站	null	地址：福建省福州市连江县下宫乡人民政府院内
连江县下宫华佳贸易经销部	老板：吴祯焕	地址：连江县下宫乡下宫村
连江县下宫法律服务所	所长：陈钰	地址：福建省福州市连江县下宫乡政府大院
连江县下宫成秋海带加工厂	厂长：吴成秋风	地址：福建省福州市连江县厦宫乡厦宫村
连江县物资机电设备公司	null	地址：福建省福州市连江县凤城镇８１６北路９７号
福建省连江县新光造林工程有限公司	总经理：郑建新	地址：连江县东湖镇东湖村东湖北路123号
福建省连江县顺兴石材厂	厂长：易顺饮	地址：福建省福州市连江县丹阳镇花园开发区
福建省连江县黄岐永强制冰厂	厂长：胡国华	地址：福建省福州市连江县黄岐镇赤沃村
福建省边城投资发展有限公司	总经理：庄鹏勇	地址：福建省连江县?头镇东边村大众路边城大厦五层
福建省连江县百胜海味厂（普通合伙）	联系人：李承光	地址：连江县晓沃镇百胜工业区
福建省连江县庭春环保设备总厂	厂长：林庭春	地址：连江县晓沃镇殿下
福建省连江县亿源水产品精制有限公司	总经理：杨铭惠	地址：福建省福州市连江县安凯乡奇达村委会内
福建省连江共建船舶工程服务有限公司	总经理：林文华	地址：福建省福州市连江县?头龙城新村１３号楼底层第一间店面
福建省连江县福达礼品有限公司	总经理：董用连	地址：福建省福州市连江县东湖镇东湖村口食品站边
福建省连江县绿波成生态农业示范基地	联系人：林文成	地址：福建省福州市连江县潘渡乡坡西村
福建省连江县文笔山生态休闲农业综合开发有限公司	总经理：陈振春	地址：福建省福州市连江县江南乡塘村南东路８号（经营地址：江南乡横槎村）
福建省连江县祥和石业有限公司	总经理：谢忠梨	地址：连江县凤城镇丹西路2号宏宇花园9号楼305
福建省连江县正一装璜设计有限公司	总经理：刘用浩	地址：福建省福州市连江县丹凤东路１５号丹凤花园１５＃楼３＃店
福建省连江县新发利大洒店有限责任公司	总经理：王秀梅	地址：福建省福州市连江县凤城镇８１６北路铁竹篙公园前
福建省连江县华榕石业有限公司	总经理：任光榕	地址：连江县蓼沿乡溪东石板材集中区
福建省连江县新天地环保工程有限公司	总经理：林柏炎	地址：连江县凤城镇凤尾花园92#205
福建省连江县新绿洲能源有限公司	总经理：郑水清	地址：连江县江南乡镜路村24号
福建省连江县浦口舒鼎液化石油气灌瓶站(有限公司)	联系人：滕祖豪	地址：连江县浦口镇上元安浦宫
福建省连江县福源农林观光建设有限公司	总经理：彭秋海	地址：福建省福州市连江县凤城镇文明东路２８３号
福建中凯主地产开发有限公司	总经理：董茂星	地址：福建省福州市连江县８１６北路２１号县科技培训中心综合楼二层６号房
福州鑫辉盛业环境工程有限公司	总经理：张金光	地址：福建省福州市连江县凤城镇凤园东路１３７号
福建玉丰金属有限公司	总经理：黄玉良	地址：福建省福州市连江县敖江工业集中区
连江县蓼沿乡赤南岗新兴石板材厂（普通合伙）	联系人：黄通金	地址：福州市连江县蓼沿乡赤南岗
连江县江南阳光花圃	联系人：郑秀明	地址：福建省连江县江南乡江南村东山路
连江县朱公水电发展有限公司	总经理：林世铭	地址：福建省福州市连江县蓼沿乡朱公村
连江县拓新企业咨询服务有限公司	总经理：林克新	地址：连江县凤城镇西北街文明路3号
连江县山岗永城轻质隔墙板厂（普通合伙）	联系人：陈文雄	地址：连江县东湖镇飞石村山岗（原耐火保温厂）
连江可门港建设发展有限公司	总经理：孙发强	地址：福建省福州市连江县坑园镇坑园村溪尾路５８号
连江县雄港制冰厂	厂长：林先生	地址：福建省福州市连江县苔录村
连江县黄岐优忠渔机修配厂	厂长：尤忠	地址：福建省福州市连江县黄岐镇新城北区
福建红建工程有限公司连江分公司	总经理：李登官	地址：连江县东湖镇牛栏坪村
连江县敖江镇余靖电信特约服务部	老板：余靖	地址：福建省福州市连江县敖江镇幕蒲南北大街
连江县凤艺演出经纪有限公司	总经理：刘必宝	地址：福建省连江县凤城镇凤尾村城边路19号
连江兴隆工艺品有限公司	总经理：曾先生	地址：福建省福州市连江县敖江镇
福建嘉成高强紧固件有限公司	总经理：孙光前	地址：福建省福州市连江县?头园区
连江县正成电脑专卖店	老板：孙政	地址：连江县凤城镇温麻路153号
福建永盛农牧发展有限公司	总经理：滕连春	地址：连江县浦口镇邮电大楼边
连江县恒力工程机械服务部	老板：颜学连	地址：福建省福州市连江县坑园镇颜岐村
福州福晟农业综合开发有限公司	总经理：林斌	地址：连江县凤城镇816北路97号华星苑华隆楼603室
连江县金安印章刻制有限公司	总经理：程文生	地址：福建省福州市连江县凤城镇和平路１７号
连江县蓼沿乡秋兰仔花岗岩矿	联系人：林孝松	地址：连江县蓼沿乡蒲边村秋兰仔山上
福州牛角制品厂	厂长：代川生	地址：福建省连江县福州闽侯南屿
国华（福州）港口建设有限公司	总经理：陈怀林	地址：福建省福州市连江县可门经济开发区
福建省连江县顺丰源农业综合开发场	联系人：林友顺	地址：连江县江南乡劳动路58
福建省连江县可门供水有限公司	总经理：周友铭	地址：福建省福州市连江县凤城镇玉荷东路１１２号
福建省连江县瀚源科贸有限公司	总经理：孙丽明	地址：福建省福州市连江县凤城镇东北街文山路新村３号２０２室
福建省连江县宏源塑胶有限公司	总经理：刘用秋	地址：连江县凤城镇玉山西侧（原合成氨厂西区）
福州帮康山棕制品有限公司	总经理：翁振草	地址：福建省福州市连江县?头镇投资区
福州欧妮蒙化妆品有限公司	总经理：郭碧秀	地址：福建省福州市连江县敖江投资区
福州鼎业五金设备有限公司	总经理：刘第一	地址：福建省福州市连江县敖江投资区
福州可门港航务有限公司	总经理：黄荣先	地址：福建省福州市连江县可门港经济区
江阴市西郊华兴石材经营部	老板：郑华兴	地址：福建省连江县蓼沿乡溪东村横厝路11-1号
福州伟拓机械有限公司	总经理：李东庆	地址：福建省福州市连江县经济开发区敖江园区
福州四维联翼房产营销顾问有限公司连江分公司	总经理：邱胜松	地址：福建省福州市连江县凤城镇莲荷西路３＃５０４
兴博（福建）可门港码头有限公司	总经理：郑兴	地址：福建省福州市连江县丹凤西路１号温泉花园８＃
中国移动通信集团福建有限公司连江敖江投资区营业厅	联系人：陈嵩	地址：福建省福州市连江县敖江投资区青龙路中段海鑫阳光公寓Ｂ幢１０１、１０２店面
中国移动通信集团福建有限公司连江晓澳营业厅	联系人：陈嵩	地址：福建省福州市连江县晓澳镇新区环岛南面
中国移动通信集团福建有限公司连江文山北路营业厅	联系人：陈嵩	地址：福建省福州市连江县凤城镇荷东路百凤花园４＃－６＃１２号店
利农农业技术(福建)有限公司连江分公司	总经理：王志权	地址：连江县敖江镇幕浦村口连黄路168号
中国移动通信集团福建有限公司连江丹阳营业厅	联系人：陈嵩	地址：福建省福州市连江县丹阳镇丹凤小区１２＃楼店面
高邮市共享游戏厅	联系人：郑道锋	地址：福建省连江县潘渡乡坡西村坡西2号
中化化肥有限公司连江销售处	联系人：王铁林	地址：连江县凤城镇西南街玉荷西路1-121（586号）
福建省连江县海味食品厂（普通合伙）	联系人：滕生淦	地址：连江县晓沃镇百胜工业区
连江县凤城镇杭佳食品厂（普通合伙）	联系人：钱金香	地址：连江县凤城镇杭下老人会
福州市商业银行股份有限公司?头支行	联系人：陈捷	地址：福建省连江县?头镇拱屿村大众北路78号
福州八和贸易有限公司	总经理：张信华	地址：福建省连江县凤城镇丹凤路北侧５号丹凤朝阳花园１＃１１４号店
连江县闽杨贸易有限责任公司	总经理：张敏清	地址：连江县凤城镇莲荷西路45#楼10店面
连江县万嘉购物商场	联系人：许可贵	地址：福建省福州市连江县凤城镇玉荷西路河?花园购物中心６５、６７、７１、７２店
连江县启源渔需贸易中心	联系人：吴明金	地址：福建省福州市连江县苔?镇秀邦村
连江县宏信电子贸易有限公司	总经理：陈贵全	地址：连江县凤城镇凤园路327号天和城1#楼08车库
连江县联鑫贸易有限公司	总经理：黄开枢	地址：连江县凤城镇莲荷西路1幢4店
连江县康发顺贸易有限公司	总经理：林爱英	地址：福建省福州市连江县凤城镇文明东路１１幢２０１
连江县和源化工贸易有限公司	总经理：滕国炎	地址：福建省福州市连江县凤城镇西凤路１６号
福州中盛贸易有限公司	总经理：余宝英	地址：福建省福州市连江县凤城镇丹凤东路１５号丹凤花园１７＃３０５
福建省连江县炳榕贸易有限责任公司	总经理：陈俊炳	地址：福建省福州市连江县凤城镇莲荷东路９＃５层
福建省连江县枫叶贸易有限公司	总经理：余春用	地址：福建省福州市连江县凤城镇凤尾花园７６＃３０３
福建省连江县鑫宏金属矿石贸易有限公司	总经理：陈福	地址：福建省福州市连江县浦口镇浦升街阁山新村２９座７－８号
福建省连江县宏升贸易有限公司	总经理：林依增	地址：福建省连江县敖江投资区
福州龙宇祥贸易有限公司	总经理：叶诚龙	地址：福建省福州市连江县丹凤西路２号宏宇花园１１－１３号
福建省弘基建设工程有限公司	总经理：陈文松	地址：连江县凤城镇莲荷东路百凤花园9#楼204房
福建省燕城建设工程有限公司连江分公司	总经理：刘必木	地址：福建省连江县凤城镇凤尾花园２８＃１店
连江县红盛园林工程有限公司	总经理：林英群	地址：福建省福州市连江县陈弟公园内中国旅行社１号楼１层
连江县三禾园艺有限公司	总经理：陈华	地址：福建省福州市连江县凤城镇凤尾花园８＃４０２号
福建华江旅游开发有限公司	总经理：刘平山	地址：连江县潘渡乡贵安村科技大楼
连江县民情殡仪服务有限公司	总经理：黄盈	地址：福建省福州市连江县陀市国有林场山岗区（连江县殡仪馆
福建正阳饲料科技有限公司	总经理：薛威	地址：福建省连江县经济开发区管委会二楼
连江县飞狮岛广告工程有限公司	总经理：吴章伟	地址：福建省福州市连江县城关八一六北路（同人建设公司楼下）
中国邮政储蓄银行有限责任公司连江县支行	联系人：林杰	地址：连江县凤城镇816中路129号
福州德昌家具有限公司	总经理：赵德平	地址：福建省连江县敖江投资区富兴南路
连江县马鼻镇兴渌综合农场	联系人：陈务光	地址：连江县马鼻镇南门村庄边洋田片
连江县丰本农业开发有限公司	总经理：叶茂	地址：福建省连江县潘渡乡坡西村(村委会)
连江县齐和食品有限公司	总经理：林皓萍	地址：福建省连江县坑园镇坑园村（坑园对虾冷冻厂内）
连江县鑫讯捷网络科技有限公司	总经理：屈娜秀	地址：福建省连江县莲荷东路７＃楼９号店
连江县永新物业管理有限公司	总经理：谢永强	地址：福建省连江县816中路37号二楼A1-2室
连江县坑园镇红火海蚌养殖场	联系人：黄木伙	地址：连江县坑园镇大官坂垦区第五管理区
连江县安达建材有限公司	总经理：郑秋长	地址：福建省连江县凤城镇文明西路１５＃连接体一层
连江县创丰水产养殖场	联系人：姚朝文	地址：福建省连江县下宫乡可门村可门１号
连江县丹阳镇旺佳超市	联系人：黄孝安	地址：连江县丹阳镇丹枫路
连江县丹阳镇佳缘汽车租赁商行	联系人：余华	地址：连江县丹阳镇104国道边
连江县?头镇金城大酒店	老板：江素贞	地址：连江县?头镇东边村大众中路边城大厦四楼
连江县凤城莲荷油漆店	null	地址：福建省福州市连江县凤城莲荷路６号楼
连江县黄岐半岛加油站	null	地址：福建省福州市连江县黄岐海丰街水涸兜
敖江国友柴油供应站	null	地址：福建省福州市连江县敖江镇南塘村
福建省连江县潘渡贵安兴隆加油站	null	地址：福建省福州市连江县潘渡乡贵安村
留春圃照相器材商店	null	地址：福建省福州市连江县凤城文山路４１号
连江县凤城镇宜又佳医药商店	老板：林雪钦	地址：连江县凤城镇８１６南路６７号
国营福建省连江长龙华侨加油站	null	地址：福建省福州市连江县长龙华侨农场场部
连江县黄岐镇海岛规划建设指挥部	null	地址：福建省福州市连江县黄岐镇
中国人寿保险公司连江县支公司	总经理：张永先	地址：福建省福州市连江县八一六中路７号
连江县妈祖文化研究会	null	地址：福建省福州市连江县凤城镇东北街
平保福州分公司农业银行连江支行保险代理处	null	地址：福建省福州市连江县凤城镇玉荷东路４０号
中国人民保险公司连江县支公司丹阳镇保险代理站	null	地址：福建省福州市连江县丹阳镇
连江县浦口水产技术推广站	站长：蒋书华	地址：福建省福州市连江县浦口镇政府院内
连江县工商银行第一储蓄所	null	地址：福建省福州市连江县８１６北路４２号
福建省连江县工程造价咨询事务所	null	地址：福建省福州市连江县凤城镇文明路３３号
中国人民保险公司连江县支公司马鼻镇保险代理站	null	地址：福建省福州市连江县马鼻镇
连江县筱埕镇农业技术推广站	站长：林新昌	地址：福建省福州市连江县筱埕村龙舟路７６号
连江县土地测绘队	null	地址：福建省福州市连江县城关凤尾花园凤园路
连江县经济发展研究中心	联系人：张怀潮	地址：福建省福州市连江县政府大楼二层
中国工商银行连江县支行第二储蓄所	所长：裴颖华	地址：福建省连江县８１６东路
连江县筱埕镇水产技术推广站	站长：林大荣	地址：福建省福州市连江县筱埕镇政府内
连江县坑园乡水产技术推广站	null	地址：福建省福州市连江县坑园乡政府大院内
连江县敖江农业技术推广站	站长：;刘必胜	地址：福建省福州市连江县敖江镇人民政府
连江县东岱镇水产技术推广站	站长：谢先莲	地址：福建省福州市连江县东岱镇演宫路1号
福州市建银工程造价咨询中心连江办事处	联系人：黄祖健	地址：福建省福州市连江县凤城镇玉荷西路建行大楼二层
福建省连江县凤城农村信用合作社	联系人：邢世斌	地址：福建省福州市连江县凤城镇八一六东路８３号
连江县金凤城市信用合作社	null	地址：福建省福州市连江县凤城镇玉荷东路４７号
连江县凤城农村信用合作社凤尾信用分社	联系人：曾秀景	地址：福建省福州市连江县凤城镇莲荷东路８号楼
中国工商银行连江县支行玉荷储蓄所	所长：陈晓雯350122	地址：福建省福州市连江县玉荷东路50号
中国农业银行连江县支行丹阳储蓄所	所长：易雍飞	地址：福建省福州市连江县丹阳镇１０４国道左侧１２号
连江县凤城农村信用合作社８１６西路分社	联系人：张灵华	地址：福建省福州市连江县凤城镇８１６西路县供销社宿舍楼一
中国农业银行连江县支行官头中心街储蓄所	所长：黄奕文	地址：福建省福州市连江县中国农行银行连江县支行官头中心街
中国工商银行连江县支行莲荷储蓄所	所长：薛文希	地址：福建省连江县莲荷东路1号楼
中国人民银行连江县支行	联系人：邹积慧	地址：福建省福州市连江县凤城镇八一六北路１５６号
中国农业银行连江县支行黄岐营业所	所长：孙发明	地址：福建省福州市连江县黄岐镇海滨路108号
连江县农村信用合作社联合社营业部	null	地址：福建省福州市连江县凤城镇玉荷东路９６号
连江县丹阳镇文化站	null	地址：福建省福州市连江县丹阳镇丹阳街８６号
连江城市园林绿化管理所	null	地址：福建省福州市连江县凤城镇文明路３３号
连江县凤城镇文化站	null	地址：福建省福州市连江县凤城镇人民政府
连江县图书馆	null	地址：福建省福州市连江县凤城镇玉荷东路
福建省连江县晓沃镇百胜电影院	null	地址：福建省福州市连江县晓沃镇百胜村
连江县蓼沿乡文化站	null	地址：福建省福州市连江县蓼沿乡
连江县小沦畲族乡广播电视站	null	地址：福建省福州市连江县小沦畲族乡政府
连江县体育馆	null	地址：福建省福州市连江县凤城镇西北街县陈第公园内
连江县马鼻卫生院	null	地址：福建省福州市连江县马鼻镇
连江县坑园中心卫生院	null	地址：福建省福州市连江县坑园乡坑园村
连江县下宫卫生院	null	地址：福建省福州市连江县下宫乡下宫村
连江县东岱卫生院	null	地址：福建省福州市连江县东岱镇东岱街环岛
连江县机关事业单位社会保险公司	null	地址：福建省福州市连江县旧工商行二层
连江县马鼻镇文化站	null	地址：福建省福州市连江县马鼻镇政府
连江县音乐图书馆	null	地址：福建省福州市连江县城关八一六北路美食园一楼
连江县影剧院	院长：庄严	地址：福建省福州市连江县凤城镇八一六北路４４号
连江县乐都歌舞厅	null	地址：福建省福州市连江县第二干部招待所三层
连江县筱埕镇计划生育服务站	null	地址：福建省福州市连江县筱埕镇筱埕村龙舟路７６号
连江县浦口镇计划生育服务站	null	地址：福建省福州市连江县浦口镇政府大楼里面
福建省连江县海洋鱼业集团总公司	null	地址：福建省福州市连江县苔录乡秀邦村
凤城四通电脑打字复印店	老板：郑凤明	地址：福建省福州市连江县凤城八一六中路41号
连江县海运公司凤城办事处	null	地址：福建省福州市连江县城关文山路１７号
福建省连江县北交鱼业开发集团公司	null	地址：福建省福州市连江县台录镇北交村
福建省连江县二轻工贸总公司	总经理：周孝治	地址：福建省福州市连江县凤城镇八一六南路４３号
福建岱江集团公司	null	地址：福建省福州市连江县东岱开通路１号
福建省连江县东湖企业集团	null	地址：福建省福州市连江县东湖镇东湖口
福建省连江县粮食经济开发总公司	总经理：陈木兰	地址：福建省福州市连江县凤城镇８１６西路３号
连江县外商投资管理服务中心	联系人：刘胜	地址：福建省福州市连江县金凤酒店一楼
福建省连江畲山湖旅游有限公司	总经理：林善标	地址：福建省福州市连江县小沧乡新区
福建省连江县商业贸易总公司	总经理：李惠明	地址：福建省福州市连江县莲荷东路1号楼308号房
福建省连江方辉建材包装制品有限公司	null	地址：福建省福州市连江县连江良种场内
福建省连江县电影院	null	地址：福建省福州市连江县凤城镇八一六东路３２号
福州龙健有限责任会计师事务所连江业务部	老板：吴吉朝	地址：福建省福州市连江县凤城镇玉荷东路台资大楼二层
连江县农村社会经济调查队	null	地址：福建省福州市连江县政府大楼
福建省连江国达广告有限公司	null	地址：福建省福州市连江县凤城镇八一六北路１４４号
福建省连江方圆广告有限公司	总经理：邱亮	地址：福建省福州市连江县北岳大厦一层
福建省连江八闽塑纸包装总厂	厂长：郑祯佃	地址：福建省福州市连江县晓沃镇福兴北路２７９号
连江县黄岐镇市场管理委员会	null	地址：福建省福州市连江县黄岐镇
连江县电力总站劳动服务公司电工器材门市部	null	地址：福建省福州市连江县凤城镇八一六西路７号
连江县农民技术人员职称评定工作领导小组办公室	null	地址：福建省福州市连江县县委大院
中国人民解放军３２３６２部队劳动服务公司	null	地址：福建省福州市连江县东湖镇官地
连江县晓沃镇文化站	null	地址：福建省福州市连江县晓沃镇晓江街和平路１５９号
连江县东湖镇文化站	站长：吴美标	地址：福建省福州市连江县东湖镇政府
苔录镇文化站	null	地址：福建省福州市连江县苔录镇苔录村后港路
福建省连江县闽申文化发展有限公司	null	地址：福建省福州市连江县东湖镇
连江县博物馆	null	地址：福建省福州市连江县陈弟公园内
连江县黄岐镇文化站	null	地址：福建省福州市连江县黄岐镇
连江人民广播电台	null	地址：福建省福州市连江县凤城镇八一六北路５２号
福建省连江县税务师事务所	null	地址：福建省福州市连江县凤城镇莲荷东路２１号
连江县坑园乡广播电视站	null	地址：福建省福州市连江县坑园乡政府
连江县地方志编纂委员会办公室	联系人：张平官	地址：福建省福州市连江县人民政府大院内
福建省连江县凤凰酒楼	null	地址：福建省福州市连江县凤城镇西北街经济巷
福建省连江县凤城学耀酒店	老板：张学耀	地址：福建省福州市连江县凤城镇莲荷西路１号楼９店
连江县融凤经济技术开发服务公司银鹰酒楼	联系人：陈峰	地址：福建省福州市连江县凤城镇８１６中路５号
福建省连江县闽运酒店	老板：吴为光	地址：福建省福州市连江县凤城镇８１６北路新车站内
连江陈峰酒店	null	地址：福建省福州市连江县凤城莲荷东路１号楼
福建省连江县贵安温泉饭店	null	地址：福建省福州市连江县潘渡乡贵安村
凤城时代冷饮店	null	地址：福建省福州市连江县凤城八一六北路１２８号
福建省连江县北岳宾馆客房部	null	地址：福建省福州市连江县凤城镇莲荷西路
连江县凤城红楼酒家	联系人：钟宝灯	地址：福建省福州市连江县凤城镇西渠路６号
连江县凤城金星酒家	联系人：陈友忠	地址：福建省福州市连江县凤城８１６北路西侧（北门新区２＃楼）
福建省连江县发利大酒店有限公司	总经理：陈发	地址：福建省福州市连江县凤城镇八一六北路铁竹篙公园前
连江县小沧乡下东山养路班	null	地址：福建省福州市连江县小沧乡下东山村
敖江镇公路管理站	null	地址：福建省福州市连江县凤城镇经济巷３１号
